,w_elo,b_elo,res,av,dif
0,1936,2402,0.0,2169.0,-466
1,2428,2763,0.0,2595.5,-335
2,2785,2322,1.0,2553.5,463
3,2312,2730,0.5,2521.0,-418
4,2722,2289,1.0,2505.5,433
5,2734,2314,1.0,2524.0,420
6,2360,2709,0.0,2534.5,-349
7,2693,2329,1.0,2511.0,364
8,2282,2706,0.0,2494.0,-424
9,2471,2698,1.0,2584.5,-227
10,2687,2345,1.0,2516.0,342
11,2282,2693,0.0,2487.5,-411
12,2661,2171,1.0,2416.0,490
13,2713,2360,0.5,2536.5,353
14,2283,2698,0.0,2490.5,-415
15,2685,2365,0.5,2525.0,320
16,2195,2668,0.0,2431.5,-473
17,2392,2746,0.0,2569.0,-354
18,2666,2373,1.0,2519.5,293
19,2244,2617,0.0,2430.5,-373
20,2598,2244,1.0,2421.0,354
21,2726,2382,1.0,2554.0,344
22,2347,2685,0.5,2516.0,-338
23,2695,2256,1.0,2475.5,439
24,2180,2665,0.0,2422.5,-485
25,2475,2788,0.0,2631.5,-313
26,2620,2280,1.0,2450.0,340
27,2261,2729,0.0,2495.0,-468
28,2634,2212,1.0,2423.0,422
29,2686,2454,1.0,2570.0,232
30,2390,2714,0.0,2552.0,-324
31,2652,2254,1.0,2453.0,398
32,2210,2644,0.0,2427.0,-434
33,2354,2691,1.0,2522.5,-337
34,2696,2287,1.0,2491.5,409
35,2258,2608,0.0,2433.0,-350
36,2630,2120,0.5,2375.0,510
37,2540,2653,0.5,2596.5,-113
38,2698,2291,1.0,2494.5,407
39,2193,2635,0.0,2414.0,-442
40,2555,2133,1.0,2344.0,422
41,2393,2685,0.0,2539.0,-292
42,2664,2237,1.0,2450.5,427
43,2259,2637,0.0,2448.0,-378
44,2550,2243,1.0,2396.5,307
45,2712,2334,1.0,2523.0,378
46,2255,2656,0.5,2455.5,-401
47,2653,2237,1.0,2445.0,416
48,2276,2610,0.0,2443.0,-334
49,2282,2725,0.0,2503.5,-443
50,2711,2316,1.0,2513.5,395
51,2211,2626,0.0,2418.5,-415
52,2583,2137,1.0,2360.0,446
53,2717,2416,1.0,2566.5,301
54,2249,2654,0.0,2451.5,-405
55,2635,2205,1.0,2420.0,430
56,2171,2594,0.0,2382.5,-423
57,2357,2683,0.0,2520.0,-326
58,2691,2305,1.0,2498.0,386
59,2214,2619,0.5,2416.5,-405
60,2569,2191,1.0,2380.0,378
61,2697,2377,1.0,2537.0,320
62,2308,2638,0.0,2473.0,-330
63,2601,2166,1.0,2383.5,435
64,2209,2581,0.5,2395.0,-372
65,2323,2638,0.5,2480.5,-315
66,2614,2251,1.0,2432.5,363
67,2247,2599,0.0,2423.0,-352
68,2616,2221,1.0,2418.5,395
69,2645,2398,0.5,2521.5,247
70,2174,2599,0.0,2386.5,-425
71,2614,2312,1.0,2463.0,302
72,2149,2549,0.0,2349.0,-400
73,2260,2606,0.0,2433.0,-346
74,2618,2304,1.0,2461.0,314
75,2255,2623,0.0,2439.0,-368
76,2589,2204,1.0,2396.5,385
77,2516,2293,1.0,2404.5,223
78,2349,2586,0.0,2467.5,-237
79,2542,2180,1.0,2361.0,362
80,2160,2520,0.0,2340.0,-360
81,2358,2734,0.5,2546.0,-376
82,2569,2190,1.0,2379.5,379
83,2062,2468,0.0,2265.0,-406
84,2396,2296,1.0,2346.0,100
85,2623,2429,1.0,2526.0,194
86,2242,2617,0.0,2429.5,-375
87,2582,2030,1.0,2306.0,552
88,2155,2593,1.0,2374.0,-438
89,2271,2618,0.0,2444.5,-347
90,2548,2264,1.0,2406.0,284
91,2155,2612,0.5,2383.5,-457
92,2554,2187,1.0,2370.5,367
93,2659,2363,1.0,2511.0,296
94,2585,2263,1.0,2424.0,322
95,2019,2575,0.0,2297.0,-556
96,2291,2693,0.0,2492.0,-402
97,2639,2211,1.0,2425.0,428
98,2155,2506,0.5,2330.5,-351
99,2505,2171,0.5,2338.0,334
100,2609,2250,0.5,2429.5,359
101,2221,2552,1.0,2386.5,-331
102,2554,2251,1.0,2402.5,303
103,2101,2552,0.0,2326.5,-451
104,2267,2606,1.0,2436.5,-339
105,2589,2037,1.0,2313.0,552
106,2133,2589,0.0,2361.0,-456
107,2482,2226,1.0,2354.0,256
108,2580,2178,1.0,2379.0,402
109,2209,2537,0.0,2373.0,-328
110,2404,2159,1.0,2281.5,245
111,2147,2494,1.0,2320.5,-347
112,2068,2599,0.0,2333.5,-531
113,2587,2139,1.0,2363.0,448
114,2270,2543,0.0,2406.5,-273
115,2435,2273,1.0,2354.0,162
116,2667,2352,1.0,2509.5,315
117,2092,2582,0.0,2337.0,-490
118,2528,2139,1.0,2333.5,389
119,2113,2523,0.0,2318.0,-410
120,2272,2617,0.0,2444.5,-345
121,2499,2205,1.0,2352.0,294
122,2081,2492,0.0,2286.5,-411
123,2454,2153,1.0,2303.5,301
124,2562,2156,1.0,2359.0,406
125,2129,2576,0.0,2352.5,-447
126,2511,2173,1.0,2342.0,338
127,2185,2503,0.0,2344.0,-318
128,2259,2652,0.0,2455.5,-393
129,2554,1977,1.0,2265.5,577
130,2211,2508,0.0,2359.5,-297
131,2428,2179,1.0,2303.5,249
132,2670,2222,1.0,2446.0,448
133,2206,2498,0.0,2352.0,-292
134,2545,2103,1.0,2324.0,442
135,2067,2400,0.0,2233.5,-333
136,2136,2643,0.0,2389.5,-507
137,2453,2133,0.5,2293.0,320
138,2068,2429,0.0,2248.5,-361
139,2448,2089,1.0,2268.5,359
140,2579,2206,1.0,2392.5,373
141,2088,2553,0.0,2320.5,-465
142,2532,2066,1.0,2299.0,466
143,2030,2481,0.0,2255.5,-451
144,2187,2577,0.0,2382.0,-390
145,2516,2094,1.0,2305.0,422
146,2040,2496,0.0,2268.0,-456
147,2594,2046,1.0,2320.0,548
148,2110,2525,0.5,2317.5,-415
149,2471,2137,1.0,2304.0,334
150,2060,2494,0.0,2277.0,-434
151,2543,2556,1.0,2549.5,-13
152,2084,2509,0.0,2296.5,-425
153,2448,2143,1.0,2295.5,305
154,2529,2108,1.0,2318.5,421
155,1827,2508,0.0,2167.5,-681
156,2486,1938,1.0,2212.0,548
157,2064,2442,0.0,2253.0,-378
158,2030,2595,0.0,2312.5,-565
159,2513,2185,1.0,2349.0,328
160,1975,2459,0.0,2217.0,-484
161,2469,1981,1.0,2225.0,488
162,2523,2072,1.0,2297.5,451
163,2065,2514,0.0,2289.5,-449
164,2479,2082,0.5,2280.5,397
165,2151,2526,0.0,2338.5,-375
166,2503,2458,1.0,2480.5,45
167,1966,2049,0.0,2007.5,-83
168,2472,2477,1.0,2474.5,-5
169,2575,2068,1.0,2321.5,507
170,2099,2144,0.0,2121.5,-45
171,2417,2533,1.0,2475.0,-116
172,1893,2066,0.0,1979.5,-173
173,2118,2402,0.0,2260.0,-284
174,2481,2521,1.0,2501.0,-40
175,2127,2493,0.0,2310.0,-366
176,2500,1956,1.0,2228.0,544
177,2516,2104,1.0,2310.0,412
178,2014,2514,0.0,2264.0,-500
179,2480,1941,1.0,2210.5,539
180,2091,2462,0.0,2276.5,-371
181,2448,2494,1.0,2471.0,-46
182,1810,1958,0.0,1884.0,-148
183,2418,2461,1.0,2439.5,-43
184,2551,2120,1.0,2335.5,431
185,2007,2499,0.0,2253.0,-492
186,2495,1987,1.0,2241.0,508
187,1823,2423,0.0,2123.0,-600
188,2084,2515,0.0,2299.5,-431
189,2511,2016,1.0,2263.5,495
190,1983,2506,0.0,2244.5,-523
191,2426,1725,1.0,2075.5,701
192,2448,1903,1.0,2175.5,545
193,1947,2429,0.0,2188.0,-482
194,2431,1965,1.0,2198.0,466
195,2024,2350,0.0,2187.0,-326
196,2088,2448,0.0,2268.0,-360
197,2472,1973,1.0,2222.5,499
198,1964,2472,0.0,2218.0,-508
199,2418,1812,1.0,2115.0,606
200,2498,1944,1.0,2221.0,554
201,1923,2469,0.0,2196.0,-546
202,2473,1893,1.0,2183.0,580
203,1848,2420,0.0,2134.0,-572
204,2126,2437,0.0,2281.5,-311
205,2419,1861,1.0,2140.0,558
206,1730,2406,0.0,2068.0,-676
207,2370,1719,1.0,2044.5,651
208,2446,2002,1.0,2224.0,444
209,1861,2493,0.0,2177.0,-632
210,2394,1929,1.0,2161.5,465
211,1678,2358,0.0,2018.0,-680
212,2257,2437,1.0,2347.0,-180
213,2402,2120,1.0,2261.0,282
214,2041,2411,0.0,2226.0,-370
215,2627,1790,1.0,2208.5,837
216,1830,2415,0.0,2122.5,-585
217,2374,1851,1.0,2112.5,523
218,1912,2345,0.0,2128.5,-433
219,2116,2548,0.0,2332.0,-432
220,2424,2100,0.5,2262.0,324
221,2045,2365,0.0,2205.0,-320
222,1831,2354,0.0,2092.5,-523
223,2357,1719,1.0,2038.0,638
224,2034,2190,0.0,2112.0,-156
225,2411,2397,0.0,2404.0,14
226,2021,2166,0.0,2093.5,-145
227,2360,2378,1.0,2369.0,-18
228,2538,1883,1.0,2210.5,655
229,2061,2437,1.0,2249.0,-376
230,1788,2400,0.0,2094.0,-612
231,2507,2533,1.0,2520.0,-26
232,1910,2025,0.0,1967.5,-115
233,2323,2303,1.0,2313.0,20
234,2395,2027,1.0,2211.0,368
235,1986,1915,0.0,1950.5,71
236,2338,2417,0.5,2377.5,-79
237,2186,2354,0.0,2270.0,-168
238,2424,2421,1.0,2422.5,3
239,1765,2332,0.5,2048.5,-567
240,2360,1596,1.0,1978.0,764
241,2542,1875,1.0,2208.5,667
242,2393,2517,1.0,2455.0,-124
243,1922,1663,0.0,1792.5,259
244,2443,2346,1.0,2394.5,97
245,2378,2344,1.0,2361.0,34
246,2529,1834,1.0,2181.5,695
247,2149,2115,0.0,2132.0,34
248,2361,2384,1.0,2372.5,-23
249,2086,2398,0.0,2242.0,-312
250,2362,1907,1.0,2134.5,455
251,2153,2338,1.0,2245.5,-185
252,2344,2420,0.0,2382.0,-76
253,2218,1967,1.0,2092.5,251
254,1995,2181,0.5,2088.0,-186
255,1740,2487,0.0,2113.5,-747
256,2359,1659,1.0,2009.0,700
257,1542,2283,0.0,1912.5,-741
258,2423,2362,0.0,2392.5,61
259,2387,2317,0.0,2352.0,70
260,2227,2414,0.0,2320.5,-187
261,2363,2046,0.0,2204.5,317
262,2306,2397,1.0,2351.5,-91
263,2469,2372,0.5,2420.5,97
264,2196,2260,1.0,2228.0,-64
265,2322,2072,1.0,2197.0,250
266,2245,2285,0.5,2265.0,-40
267,2366,2326,1.0,2346.0,40
268,2278,2413,1.0,2345.5,-135
269,2088,2405,0.0,2246.5,-317
270,2342,2234,0.0,2288.0,108
271,2682,2390,1.0,2536.0,292
272,2228,2681,0.5,2454.5,-453
273,2596,2298,0.5,2447.0,298
274,2265,2563,0.5,2414.0,-298
275,2687,2399,0.0,2543.0,288
276,2333,2642,0.5,2487.5,-309
277,2638,2162,1.0,2400.0,476
278,2121,2605,0.0,2363.0,-484
279,2542,2769,1.0,2655.5,-227
280,2709,2517,1.0,2613.0,192
281,2393,2693,0.0,2543.0,-300
282,2706,2178,1.0,2442.0,528
283,2778,2451,1.0,2614.5,327
284,2346,2746,0.0,2546.0,-400
285,2617,2443,0.5,2530.0,174
286,2378,2598,0.0,2488.0,-220
287,2620,2459,1.0,2539.5,161
288,2398,2729,0.0,2563.5,-331
289,2634,2362,0.5,2498.0,272
290,2153,2613,0.0,2383.0,-460
291,2487,2686,0.0,2586.5,-199
292,2714,2359,1.0,2536.5,355
293,2283,2652,0.5,2467.5,-369
294,2644,2383,1.0,2513.5,261
295,2707,2423,1.0,2565.0,284
296,2362,2664,0.5,2513.0,-302
297,2637,2387,1.0,2512.0,250
298,2317,2550,0.5,2433.5,-233
299,2725,2434,1.0,2579.5,291
300,2405,2711,0.0,2558.0,-306
301,2626,2342,1.0,2484.0,284
302,2234,2569,0.5,2401.5,-335
303,2326,2654,0.0,2490.0,-328
304,2635,2366,1.0,2500.5,269
305,2413,2594,0.0,2503.5,-181
306,2594,2278,1.0,2436.0,316
307,2606,2797,0.5,2701.5,-191
308,2763,2618,1.0,2690.5,145
309,2623,2785,0.5,2704.0,-162
310,2722,2589,1.0,2655.5,133
311,2726,2773,1.0,2749.5,-47
312,2516,2685,0.0,2600.5,-169
313,2695,2586,0.5,2640.5,109
314,2542,2665,0.0,2603.5,-123
315,2722,2623,0.5,2672.5,99
316,2617,2653,0.5,2635.0,-36
317,2698,2582,1.0,2640.0,116
318,2511,2635,0.5,2573.0,-124
319,2712,2659,1.0,2685.5,53
320,2578,2656,0.5,2617.0,-78
321,2648,2585,0.5,2616.5,63
322,2575,2653,0.5,2614.0,-78
323,2599,2683,0.5,2641.0,-84
324,2691,2577,0.5,2634.0,114
325,2587,2595,0.5,2591.0,-8
326,2569,2543,0.5,2556.0,26
327,2697,2667,0.5,2682.0,30
328,2582,2638,0.5,2610.0,-56
329,2601,2528,1.0,2564.5,73
330,2523,2575,0.5,2549.0,-52
331,2617,2638,1.0,2627.5,-21
332,2614,2499,0.5,2556.5,115
333,2492,2599,0.5,2545.5,-107
334,2616,2454,1.0,2535.0,162
335,2645,2562,0.0,2603.5,83
336,2570,2599,0.5,2584.5,-29
337,2614,2576,0.5,2595.0,38
338,2503,2549,0.0,2526.0,-46
339,2652,2734,0.5,2693.0,-82
340,2569,2554,0.5,2561.5,15
341,2508,2468,0.5,2488.0,40
342,2396,2428,0.0,2412.0,-32
343,2614,2670,1.0,2642.0,-56
344,2498,2548,0.5,2523.0,-50
345,2612,2545,0.0,2578.5,67
346,2400,2554,0.0,2477.0,-154
347,2643,2579,0.0,2611.0,64
348,2553,2602,0.0,2577.5,-49
349,2429,2532,0.5,2480.5,-103
350,2481,2448,1.0,2464.5,33
351,2577,2594,0.5,2585.5,-17
352,2525,2516,1.0,2520.5,9
353,2517,2471,0.0,2494.0,46
354,2484,2498,0.0,2491.0,-14
355,2556,2523,0.5,2539.5,33
356,2514,2543,0.5,2528.5,-29
357,2509,2479,0.5,2494.0,30
358,2526,2375,1.0,2450.5,151
359,2548,2532,0.0,2540.0,16
360,2529,2424,1.0,2476.5,105
361,2365,2508,0.0,2436.5,-143
362,2486,2370,1.0,2428.0,116
363,2595,2495,1.0,2545.0,100
364,2395,2469,1.0,2432.0,-74
365,2459,2417,1.0,2438.0,42
366,2338,2469,0.5,2403.5,-131
367,2579,2446,1.0,2512.5,133
368,2421,2503,0.0,2462.0,-82
369,2477,2424,0.5,2450.5,53
370,2332,2472,0.0,2402.0,-140
371,2529,2575,0.5,2552.0,-46
372,2533,2384,1.0,2458.5,149
373,2361,2498,0.0,2429.5,-137
374,2521,2536,0.0,2528.5,-15
375,2344,2481,0.0,2412.5,-137
376,2493,2420,0.0,2456.5,73
377,2218,2500,0.0,2359.0,-282
378,2816,2516,1.0,2666.0,300
379,2514,2687,0.0,2600.5,-173
380,2693,2480,1.0,2586.5,213
381,2462,2661,0.0,2561.5,-199
382,2566,2737,0.0,2651.5,-171
383,2698,2494,0.5,2596.0,204
384,2461,2685,0.5,2573.0,-224
385,2668,2418,0.5,2543.0,250
386,2693,2551,1.0,2622.0,142
387,2499,2639,1.0,2569.0,-140
388,2506,2495,0.5,2500.5,11
389,2418,2505,1.0,2461.5,-87
390,2515,2589,0.0,2552.0,-74
391,2570,2511,1.0,2540.5,59
392,2506,2589,0.5,2547.5,-83
393,2482,2426,0.5,2454.0,56
394,2706,2638,1.0,2672.0,68
395,2448,2580,0.0,2514.0,-132
396,2537,2429,0.5,2483.0,108
397,2431,2494,0.5,2462.5,-63
398,2523,2516,1.0,2519.5,7
399,2437,2448,0.5,2442.5,-11
400,2472,2402,0.5,2437.0,70
401,2397,2472,0.0,2434.5,-75
402,2507,2498,1.0,2502.5,9
403,2469,2397,0.5,2433.0,72
404,2378,2473,0.5,2425.5,-95
405,2348,2360,1.0,2354.0,-12
406,2595,2414,0.0,2504.5,181
407,2397,2437,0.0,2417.0,-40
408,2419,2306,0.5,2362.5,113
409,2284,2370,1.0,2327.0,-86
410,2546,2519,1.0,2532.5,27
411,2493,2322,1.0,2407.5,171
412,2285,2394,0.5,2339.5,-109
413,2358,2245,0.5,2301.5,113
414,2691,2627,0.5,2659.0,64
415,2415,2696,0.5,2555.5,-281
416,2608,2374,0.0,2491.0,234
417,2345,2630,0.5,2487.5,-285
418,2752,2610,0.5,2681.0,142
419,2378,2682,0.0,2530.0,-304
420,2681,2354,1.0,2517.5,327
421,2357,2563,0.0,2460.0,-206
422,2738,2538,1.0,2638.0,200
423,2437,2687,0.0,2562.0,-250
424,2642,2061,1.0,2351.5,581
425,2400,2605,0.5,2502.5,-205
426,2533,2640,0.5,2586.5,-107
427,2609,2507,1.0,2558.0,102
428,2323,2552,0.0,2437.5,-229
429,2554,2174,1.0,2364.0,380
430,2354,2372,1.0,2363.0,-18
431,2203,2260,1.0,2231.5,-57
432,2416,2354,1.0,2385.0,62
433,2287,2249,1.0,2268.0,38
434,2205,2297,0.0,2251.0,-92
435,2120,2207,0.5,2163.5,-87
436,2250,2429,0.0,2339.5,-179
437,2242,2221,1.0,2231.5,21
438,2251,2030,0.0,2140.5,221
439,2155,2101,0.0,2128.0,54
440,2243,2363,0.0,2303.0,-120
441,2004,2263,0.5,2133.5,-259
442,2068,2196,0.0,2132.0,-128
443,2345,2471,1.0,2408.0,-126
444,2273,2139,0.0,2206.0,134
445,2180,2282,1.0,2231.0,-102
446,2360,2352,0.0,2356.0,8
447,2092,2283,0.0,2187.5,-191
448,2365,2139,1.0,2252.0,226
449,2113,2195,0.0,2154.0,-82
450,2272,2291,1.0,2281.5,-19
451,2155,2205,0.5,2180.0,-50
452,2081,2171,0.0,2126.0,-90
453,2129,2153,1.0,2141.0,-24
454,2156,2267,1.0,2211.5,-111
455,2133,2129,0.0,2131.0,4
456,2173,2226,0.0,2199.5,-53
457,2151,2153,0.0,2152.0,-2
458,2178,2259,1.0,2218.5,-81
459,1977,2209,0.5,2093.0,-232
460,2159,2211,1.0,2185.0,-52
461,2179,2147,0.0,2163.0,32
462,2222,2257,0.0,2239.5,-35
463,2120,2206,1.0,2163.0,-86
464,2103,2041,1.0,2072.0,62
465,2206,2067,0.0,2136.5,139
466,2166,2034,0.5,2100.0,132
467,2066,2088,0.0,2077.0,-22
468,2046,2227,1.0,2136.5,-181
469,2084,2075,0.0,2079.5,9
470,2072,2143,0.0,2107.5,-71
471,1938,2108,0.5,2023.0,-170
472,2205,2064,1.0,2134.5,141
473,2030,2322,0.5,2176.0,-292
474,2312,2185,1.0,2248.5,127
475,1975,2297,0.5,2136.0,-322
476,2289,2089,0.0,2189.0,200
477,2382,2151,1.0,2266.5,231
478,2049,2347,0.0,2198.0,-298
479,2256,1966,1.0,2111.0,290
480,1938,2180,0.0,2059.0,-242
481,2144,2540,0.5,2342.0,-396
482,2291,2099,0.5,2195.0,192
483,2066,2193,1.0,2129.5,-127
484,2133,1893,1.0,2013.0,240
485,2334,2118,1.0,2226.0,216
486,2276,2237,0.0,2256.5,39
487,1897,2127,0.5,2012.0,-230
488,2104,2227,0.0,2165.5,-123
489,2305,2357,1.0,2331.0,-52
490,1941,2014,0.0,1977.5,-73
491,2191,2214,1.0,2202.5,-23
492,2377,2091,1.0,2234.0,286
493,1958,2308,0.5,2133.0,-350
494,2209,1810,1.0,2009.5,399
495,2007,2171,0.0,2089.0,-164
496,2247,2251,1.0,2249.0,-4
497,1823,1987,0.0,1905.0,-164
498,2144,2221,1.0,2182.5,-77
499,2398,1801,1.0,2099.5,597
500,1983,2016,0.0,1999.5,-33
501,2312,2174,1.0,2243.0,138
502,1818,1725,0.5,1771.5,93
503,1903,2149,0.0,2026.0,-246
504,2190,2358,1.0,2274.0,-168
505,2024,1947,1.0,1985.5,77
506,2296,2062,1.0,2179.0,234
507,2088,1895,1.0,1991.5,193
508,2264,2271,1.0,2267.5,-7
509,1964,1973,0.0,1968.5,-9
510,2187,2155,0.5,2171.0,32
511,1944,1812,0.0,1878.0,132
512,2133,2136,1.0,2134.5,-3
513,1893,1923,0.0,1908.0,-30
514,2026,2068,0.0,2047.0,-42
515,2046,1848,0.0,1947.0,198
516,1861,2126,0.0,1993.5,-265
517,2137,2110,1.0,2123.5,27
518,1719,1730,0.5,1724.5,-11
519,2072,2027,0.5,2049.5,45
520,1861,2002,0.5,1931.5,-141
521,1678,1929,0.5,1803.5,-251
522,1790,2032,1.0,1911.0,-242
523,2100,2116,1.0,2108.0,-16
524,1851,1830,0.0,1840.5,21
525,1915,1912,1.0,1913.5,3
526,1882,1986,1.0,1934.0,-104
527,1719,1831,1.0,1775.0,-112
528,2187,2186,0.0,2186.5,1
529,1874,2094,1.0,1984.0,-220
530,2115,1883,0.5,1999.0,232
531,1788,2149,1.0,1968.5,-361
532,1967,1910,1.0,1938.5,57
533,2314,1875,1.0,2094.5,439
534,2329,2360,1.0,2344.5,-31
535,1922,1663,0.0,1792.5,259
536,2373,2392,1.0,2382.5,-19
537,2244,2244,1.0,2244.0,0
538,2086,1834,0.0,1960.0,252
539,2280,2475,1.0,2377.5,-195
540,2158,2261,1.0,2209.5,-103
541,2454,1740,1.0,2097.0,714
542,1659,2390,0.0,2024.5,-731
543,2254,1542,1.0,1898.0,712
544,2237,2393,1.0,2315.0,-156
545,1712,2259,0.0,1985.5,-547
546,2088,2282,0.0,2185.0,-194
547,2316,2278,0.0,2297.0,38
548,2390,2260,1.0,2325.0,130
549,2304,2228,0.0,2266.0,76
550,2298,2255,0.0,2276.5,43
551,2204,2265,1.0,2234.5,-61
552,2399,2293,1.0,2346.0,106
553,2349,2333,1.0,2341.0,16
554,2162,2180,1.0,2171.0,-18
555,2160,2244,0.0,2202.0,-84
556,2532,2551,0.0,2541.5,-19
557,2499,2529,0.5,2514.0,-30
558,2508,2495,1.0,2501.5,13
559,2418,2486,0.5,2452.0,-68
560,2627,2778,0.5,2702.5,-151
561,2746,2415,1.0,2580.5,331
562,2374,2666,0.0,2520.0,-292
563,2598,2345,1.0,2471.5,253
564,2469,2788,0.0,2628.5,-319
565,2620,2372,0.5,2496.0,248
566,2354,2634,0.0,2494.0,-280
567,2613,2260,1.0,2436.5,353
568,2686,2752,1.0,2719.0,-66
569,2681,2714,0.5,2697.5,-33
570,2644,2596,0.5,2620.0,48
571,2563,2682,0.5,2622.5,-119
572,2722,2725,1.0,2723.5,-3
573,2711,2653,0.5,2682.0,58
574,2698,2626,1.0,2662.0,72
575,2569,2635,0.5,2602.0,-66
576,2769,2738,0.5,2753.5,31
577,2642,2734,0.0,2688.0,-92
578,2709,2638,1.0,2673.5,71
579,2605,2693,1.0,2649.0,-88
580,2816,2697,1.0,2756.5,119
581,2638,2698,0.5,2668.0,-60
582,2693,2601,0.5,2647.0,92
583,2581,2661,0.5,2621.0,-80
584,2640,2707,0.5,2673.5,-67
585,2685,2609,1.0,2647.0,76
586,2552,2637,0.0,2594.5,-85
587,2550,2552,0.5,2551.0,-2
588,2579,2656,0.0,2617.5,-77
589,2648,2458,1.0,2553.0,190
590,2503,2653,0.0,2578.0,-150
591,2610,2472,1.0,2541.0,138
592,2614,2685,0.0,2649.5,-71
593,2695,2618,0.0,2656.5,77
594,2548,2670,0.0,2609.0,-122
595,2665,2554,1.0,2609.5,111
596,2525,2652,0.0,2588.5,-127
597,2554,2471,1.0,2512.5,83
598,2494,2508,0.0,2501.0,-14
599,2428,2484,1.0,2456.0,-56
600,2606,2523,0.0,2564.5,83
601,2448,2570,0.5,2509.0,-122
602,2589,2472,1.0,2530.5,117
603,2418,2482,0.5,2450.0,-64
604,2797,2706,0.5,2751.5,91
605,2580,2763,0.5,2671.5,-183
606,2730,2537,0.5,2633.5,193
607,2404,2722,0.0,2563.0,-318
608,2737,2595,0.5,2666.0,142
609,2513,2713,0.5,2613.0,-200
610,2698,2469,1.0,2583.5,229
611,2459,2685,0.0,2572.0,-226
612,2579,2523,0.5,2551.0,56
613,2514,2553,1.0,2533.5,-39
614,2532,2526,0.5,2529.0,6
615,2438,2481,0.0,2459.5,-43
616,2717,2575,1.0,2646.0,142
617,2533,2654,0.5,2593.5,-121
618,2594,2498,0.5,2546.0,96
619,2417,2594,0.0,2505.5,-177
620,2414,2599,0.5,2506.5,-185
621,2577,2363,1.0,2470.0,214
622,2306,2587,1.0,2446.5,-281
623,2543,2284,1.0,2413.5,259
624,2683,2617,1.0,2650.0,66
625,2499,2691,0.5,2595.0,-192
626,2619,2492,0.5,2555.5,127
627,2454,2595,0.5,2524.5,-141
628,2638,2562,0.5,2600.0,76
629,2570,2614,0.0,2592.0,-44
630,2599,2576,1.0,2587.5,23
631,2511,2616,1.0,2563.5,-105
632,2521,2645,0.5,2583.0,-124
633,2599,2481,1.0,2540.0,118
634,2500,2549,0.0,2524.5,-49
635,2579,2398,1.0,2488.5,181
636,2469,2536,0.5,2502.5,-67
637,2344,2473,0.5,2408.5,-129
638,2420,2420,1.0,2420.0,0
639,2181,2348,0.0,2264.5,-167
640,2519,2507,1.0,2513.0,12
641,2397,2446,0.0,2421.5,-49
642,2493,2378,0.5,2435.5,115
643,2360,2394,1.0,2377.0,-34
644,2623,2546,0.5,2584.5,77
645,2285,2582,0.0,2433.5,-297
646,2593,2245,0.5,2419.0,348
647,2228,2511,0.5,2369.5,-283
648,2659,2691,0.5,2675.0,-32
649,2696,2578,0.5,2637.0,118
650,2575,2608,0.5,2591.5,-33
651,2630,2569,0.0,2599.5,61
652,2667,2514,1.0,2590.5,153
653,2480,2582,1.0,2531.0,-102
654,2523,2462,1.0,2492.5,61
655,2448,2485,0.0,2466.5,-37
656,2516,2670,0.5,2593.0,-154
657,2498,2437,0.0,2467.5,61
658,2402,2545,1.0,2473.5,-143
659,2442,2411,1.0,2426.5,31
660,2446,2577,1.0,2511.5,-131
661,2516,2421,1.0,2468.5,95
662,2332,2517,1.0,2424.5,-185
663,2496,2360,1.0,2428.0,136
664,2556,2326,1.0,2441.0,230
665,2366,2509,0.5,2437.5,-143
666,2448,2413,0.0,2430.5,35
667,2278,2375,0.5,2326.5,-97
668,2314,2566,0.0,2440.0,-252
669,2494,2360,1.0,2427.0,134
670,2329,2448,0.0,2388.5,-119
671,2418,2282,0.5,2350.0,136
672,2360,2595,0.0,2477.5,-235
673,2437,2283,0.0,2360.0,154
674,2365,2419,1.0,2392.0,-54
675,2406,2195,0.0,2300.5,211
676,2734,2454,1.0,2594.0,280
677,2390,2569,1.0,2479.5,-179
678,2468,2254,0.5,2361.0,214
679,2153,2396,0.5,2274.5,-243
680,2354,2643,1.0,2498.5,-289
681,2602,2287,0.0,2444.5,315
682,2258,2453,0.0,2355.5,-195
683,2429,2120,1.0,2274.5,309
684,2495,2398,0.5,2446.5,97
685,2174,2395,0.0,2284.5,-221
686,2417,2312,1.0,2364.5,105
687,2149,2338,0.0,2243.5,-189
688,2548,2529,0.5,2538.5,19
689,2384,2424,1.0,2404.0,-40
690,2365,2370,0.0,2367.5,-5
691,2136,2693,0.0,2414.5,-557
692,2639,2133,1.0,2386.0,506
693,2068,2506,0.0,2287.0,-438
694,2518,2026,1.0,2272.0,492
695,2280,2606,0.0,2443.0,-326
696,2618,2261,1.0,2439.5,357
697,2212,2623,0.0,2417.5,-411
698,2574,2158,1.0,2366.0,416
699,2393,2515,0.5,2454.0,-122
700,2506,2259,1.0,2382.5,247
701,2243,2426,0.0,2334.5,-183
702,2375,2104,1.0,2239.5,271
703,2638,2282,1.0,2460.0,356
704,2316,2429,0.5,2372.5,-113
705,2431,2278,0.0,2354.5,153
706,2211,2350,0.5,2280.5,-139
707,2517,2542,1.0,2529.5,-25
708,1995,2393,0.0,2194.0,-398
709,2423,2392,0.5,2407.5,31
710,2373,2362,0.5,2367.5,11
711,2317,2244,1.0,2280.5,73
712,2160,2299,0.5,2229.5,-139
713,2471,2377,0.5,2424.0,94
714,2308,2345,0.5,2326.5,-37
715,2282,2166,0.0,2224.0,116
716,2171,2171,1.0,2171.0,0
717,2227,2358,0.0,2292.5,-131
718,2190,2046,1.0,2118.0,144
719,2296,2062,0.0,2179.0,234
720,2108,2209,0.0,2158.5,-101
721,2159,1827,1.0,1993.0,332
722,2064,2147,1.0,2105.5,-83
723,2213,2205,0.5,2209.0,8
724,2610,2166,1.0,2388.0,444
725,2021,2378,0.0,2199.5,-357
726,2354,2190,0.0,2272.0,164
727,2773,2291,1.0,2532.0,482
728,2211,2586,0.0,2398.5,-375
729,2542,2155,1.0,2348.5,387
730,2129,2520,0.0,2324.5,-391
731,2538,1915,1.0,2226.5,623
732,1986,2437,1.0,2211.5,-451
733,2061,2292,0.5,2176.5,-231
734,2334,2533,0.0,2433.5,-199
735,2507,2255,1.0,2381.0,252
736,2237,2303,0.0,2270.0,-66
737,2323,2227,1.0,2275.0,96
738,2451,2271,1.0,2361.0,180
739,2264,2443,0.0,2353.5,-179
740,2344,2155,1.0,2249.5,189
741,2187,2378,0.5,2282.5,-191
742,2242,2459,0.0,2350.5,-217
743,2398,2030,1.0,2214.0,368
744,2155,2362,0.0,2258.5,-207
745,2338,2081,1.0,2209.5,257
746,2156,2487,0.0,2321.5,-331
747,2359,2129,1.0,2244.0,230
748,2185,2283,0.5,2234.0,-98
749,2383,2153,0.5,2268.0,230
750,2434,2110,1.0,2272.0,324
751,2137,2405,0.5,2271.0,-268
752,2342,2060,1.0,2201.0,282
753,2027,2234,0.5,2130.5,-207
754,2002,2382,0.0,2192.0,-380
755,2347,1861,1.0,2104.0,486
756,1929,2256,0.0,2092.5,-327
757,2252,1678,1.0,1965.0,574
758,2357,2115,1.0,2236.0,242
759,2149,2305,0.5,2227.0,-156
760,2214,2191,0.0,2202.5,23
761,2363,2323,1.0,2343.0,40
762,2247,2243,0.5,2245.0,4
763,2263,2221,0.5,2242.0,42
764,2144,2004,0.0,2074.0,140
765,2257,2030,1.0,2143.5,227
766,2185,2120,0.5,2152.5,65
767,2041,2089,0.0,2065.0,-48
768,2428,2144,1.0,2286.0,284
769,2099,2322,0.5,2210.5,-223
770,2312,2066,1.0,2189.0,246
771,1893,2297,0.0,2095.0,-404
772,2540,2222,0.0,2381.0,318
773,2103,2193,0.0,2148.0,-90
774,2133,2067,1.0,2100.0,66
775,2067,2090,0.0,2078.5,-23
776,2260,2255,0.0,2257.5,5
777,2204,2111,0.5,2157.5,93
778,1903,2196,0.5,2049.5,-293
779,2221,2250,1.0,2235.5,-29
780,2024,1947,0.5,1985.5,77
781,2081,2101,1.0,2091.0,-20
782,2133,2037,1.0,2085.0,96
783,1719,2226,0.0,1972.5,-507
784,1944,2072,1.0,2008.0,-128
785,1893,1923,0.5,1908.0,-30
786,2186,1848,0.0,2017.0,338
787,1765,2259,0.0,2012.0,-494
788,2179,1977,1.0,2078.0,202
789,2126,1596,1.0,1861.0,530
790,2014,2104,1.0,2059.0,-90
791,1730,1861,1.0,1795.5,-131
792,1883,1790,0.0,1836.5,93
793,1987,2007,0.5,1997.0,-20
794,1801,1823,0.5,1812.0,-22
795,2072,1788,0.5,1930.0,284
796,2139,2068,1.0,2103.5,71
797,2082,2065,0.0,2073.5,17
798,2273,2270,0.5,2271.5,3
799,2293,2032,1.0,2162.5,261
800,1907,2086,0.0,1996.5,-179
801,2160,2349,1.0,2254.5,-189
802,2352,2025,1.0,2188.5,327
803,1542,1740,0.5,1641.0,-198
804,2139,2092,0.5,2115.5,47
805,2091,2113,1.0,2102.0,-22
806,1958,1712,0.0,1835.0,246
807,2084,1810,0.0,1947.0,274
808,2249,2416,0.0,2332.5,-167
809,1725,1983,0.0,1854.0,-258
810,2207,2171,0.5,2189.0,36
811,2205,2272,1.0,2238.5,-67
812,2025,2081,0.0,2053.0,-56
813,2153,2027,0.5,2090.0,126
814,1992,2088,0.5,2040.0,-96
815,1834,1824,0.0,1829.0,10
816,2151,2088,1.0,2119.5,63
817,1973,2049,1.0,2011.0,-76
818,2068,1964,1.0,2016.0,104
819,1812,1938,1.0,1875.0,-126
820,1875,1790,0.0,1832.5,85
821,1663,1912,0.0,1787.5,-249
822,1784,1922,1.0,1853.0,-138
823,2075,2127,0.5,2101.0,-52
824,1956,2084,1.0,2020.0,-128
825,2143,1897,1.0,2020.0,246
826,2275,2088,1.0,2181.5,187
827,2390,2044,0.5,2217.0,346
828,2094,2187,0.0,2140.5,-93
829,2298,2228,1.0,2263.0,70
830,2100,2231,0.5,2165.5,-131
831,2162,2333,1.0,2247.5,-171
832,2121,2244,1.0,2182.5,-123
833,2778,2707,1.0,2742.5,71
834,2685,2746,1.0,2715.5,-61
835,2666,2664,0.5,2665.0,2
836,2637,2617,0.5,2627.0,20
837,2797,2726,0.5,2761.5,71
838,2685,2763,0.0,2724.0,-78
839,2785,2670,0.5,2727.5,115
840,2665,2722,0.0,2693.5,-57
841,2788,2712,1.0,2750.0,76
842,2656,2620,0.5,2638.0,36
843,2729,2648,0.5,2688.5,81
844,2653,2613,1.0,2633.0,40
845,2686,2722,0.5,2704.0,-36
846,2653,2714,0.5,2683.5,-61
847,2652,2698,0.5,2675.0,-46
848,2635,2682,0.5,2658.5,-47
849,2652,2816,0.5,2734.0,-164
850,2698,2554,0.5,2626.0,144
851,2508,2687,0.5,2597.5,-179
852,2693,2428,1.0,2560.5,265
853,2769,2717,1.0,2743.0,52
854,2654,2734,0.0,2694.0,-80
855,2709,2635,1.0,2672.0,74
856,2594,2706,1.0,2650.0,-112
857,2532,2737,0.5,2634.5,-205
858,2713,2529,1.0,2621.0,184
859,2508,2698,0.5,2603.0,-190
860,2685,2442,1.0,2563.5,243
861,2683,2498,1.0,2590.5,185
862,2469,2691,0.0,2580.0,-222
863,2619,2420,1.0,2519.5,199
864,2348,2569,0.0,2458.5,-221
865,2523,2519,0.0,2521.0,4
866,2446,2472,0.0,2459.0,-26
867,2472,2493,1.0,2482.5,-21
868,2358,2418,0.5,2388.0,-60
869,2606,2579,0.5,2592.5,27
870,2553,2570,0.5,2561.5,-17
871,2589,2532,0.5,2560.5,57
872,2481,2482,0.0,2481.5,-1
873,2599,2638,0.5,2618.5,-39
874,2614,2577,0.5,2595.5,37
875,2543,2599,0.5,2571.0,-56
876,2587,2435,1.0,2511.0,152
877,2551,2645,1.0,2598.0,-94
878,2599,2499,1.0,2549.0,100
879,2495,2614,0.5,2554.5,-119
880,2549,2418,0.5,2483.5,131
881,2523,2606,0.5,2564.5,-83
882,2618,2514,0.5,2566.0,104
883,2479,2623,1.0,2551.0,-144
884,2589,2526,0.0,2557.5,63
885,2469,2659,0.5,2564.0,-190
886,2578,2372,1.0,2475.0,206
887,2354,2585,0.5,2469.5,-231
888,2569,2203,1.0,2386.0,366
889,2377,2752,0.0,2564.5,-375
890,2682,2308,1.0,2495.0,374
891,2166,2596,0.0,2381.0,-430
892,2563,2209,0.5,2386.0,354
893,2738,2594,0.5,2666.0,144
894,2525,2687,1.0,2606.0,-162
895,2642,2471,1.0,2556.5,171
896,2484,2605,0.0,2544.5,-121
897,2363,2697,0.0,2530.0,-334
898,2638,2243,1.0,2440.5,395
899,2263,2581,0.0,2422.0,-318
900,2575,2004,1.0,2289.5,571
901,2566,2706,0.5,2636.0,-140
902,2537,2494,0.5,2515.5,43
903,2448,2404,1.0,2426.0,44
904,2494,2461,0.5,2477.5,33
905,2725,2579,0.5,2652.0,146
906,2503,2711,0.5,2607.0,-208
907,2626,2477,0.5,2551.5,149
908,2472,2583,1.0,2527.5,-111
909,2640,2495,0.5,2567.5,145
910,2395,2552,0.0,2473.5,-157
911,2554,2338,0.5,2446.0,216
912,2354,2552,0.5,2453.0,-198
913,2414,2617,0.5,2515.5,-203
914,2582,2363,1.0,2472.5,219
915,2397,2593,0.5,2495.0,-196
916,2511,2306,0.5,2408.5,205
917,2595,2542,0.0,2568.5,53
918,2517,2513,1.0,2515.0,4
919,2469,2393,0.5,2431.0,76
920,2178,2459,0.0,2318.5,-281
921,2575,2773,0.5,2674.0,-198
922,2516,2533,0.5,2524.5,-17
923,2498,2542,0.0,2520.0,-44
924,2520,2402,0.5,2461.0,118
925,2693,2529,1.0,2611.0,164
926,2384,2639,0.0,2511.5,-255
927,2506,2361,0.5,2433.5,145
928,2487,2505,1.0,2496.0,-18
929,2528,2582,0.5,2555.0,-54
930,2283,2359,0.5,2321.0,-76
931,2485,2523,0.5,2504.0,-38
932,2533,2383,1.0,2458.0,150
933,2618,2614,0.5,2616.0,4
934,2303,2507,0.5,2405.0,-204
935,2554,2612,0.5,2583.0,-58
936,2511,2323,1.0,2417.0,188
937,2387,2362,1.0,2374.5,25
938,2426,2506,1.0,2466.0,-80
939,2299,2317,0.5,2308.0,-18
940,2451,2375,1.0,2413.0,76
941,2283,2360,0.5,2321.5,-77
942,2443,2346,0.0,2394.5,97
943,2195,2365,1.0,2280.0,-170
944,2459,2344,0.0,2401.5,115
945,2415,2627,0.0,2521.0,-212
946,2362,2398,1.0,2380.0,-36
947,2198,2374,0.0,2286.0,-176
948,2382,2338,0.0,2360.0,44
949,2437,2538,0.0,2487.5,-101
950,2180,2347,1.0,2263.5,-167
951,2292,2400,1.0,2346.0,-108
952,2434,2252,0.0,2343.0,182
953,2378,2610,0.0,2494.0,-232
954,2342,2405,0.0,2373.5,-63
955,2190,2357,0.0,2273.5,-167
956,2437,2197,0.0,2317.0,240
957,2305,2357,1.0,2331.0,-52
958,2411,2402,1.0,2406.5,9
959,2191,2214,0.0,2202.5,-23
960,2734,2397,1.0,2565.5,337
961,2322,2428,0.0,2375.0,-106
962,2569,2645,1.0,2607.0,-76
963,2297,2312,0.0,2304.5,-15
964,2536,2468,0.0,2502.0,68
965,2499,2617,0.5,2558.0,-118
966,2420,2344,0.0,2382.0,76
967,2454,2492,0.5,2473.0,-38
968,2562,2218,0.0,2390.0,344
969,2322,2546,0.0,2434.0,-224
970,2511,2570,0.5,2540.5,-59
971,2228,2245,1.0,2236.5,-17
972,2358,2503,0.5,2430.5,-145
973,2411,2507,0.5,2459.0,-96
974,2062,2190,0.5,2126.0,-128
975,2360,2378,1.0,2369.0,-18
976,2446,2296,0.5,2371.0,150
977,2543,2556,0.5,2549.5,-13
978,2332,2424,0.0,2378.0,-92
979,2375,2448,0.5,2411.5,-73
980,2643,2360,1.0,2501.5,283
981,2390,2454,0.0,2422.0,-64
982,2429,2602,0.0,2515.5,-173
983,2153,2254,0.0,2203.5,-101
984,2516,2448,0.5,2482.0,68
985,2413,2366,0.5,2389.5,47
986,2496,2517,0.0,2506.5,-21
987,2239,2278,0.5,2258.5,-39
988,2354,2498,0.5,2426.0,-144
989,2448,2638,1.0,2543.0,-190
990,2258,2287,0.0,2272.5,-29
991,2350,2431,1.0,2390.5,-81
992,2540,2297,1.0,2418.5,243
993,2046,2227,1.0,2136.5,-181
994,2133,2291,0.0,2212.0,-158
995,2260,2090,0.0,2175.0,170
996,2481,2521,1.0,2501.0,-40
997,2255,2304,0.0,2279.5,-49
998,2500,2493,1.0,2496.5,7
999,2670,2204,0.5,2437.0,466
1000,1975,2185,0.0,2080.0,-210
1001,2545,2498,1.0,2521.5,47
1002,1981,2089,0.0,2035.0,-108
1003,2280,2442,1.0,2361.0,-162
1004,2208,2275,1.0,2241.5,-67
1005,2691,2046,1.0,2368.5,645
1006,2110,2696,0.0,2403.0,-586
1007,2608,2060,1.0,2334.0,548
1008,2027,2630,0.0,2328.5,-603
1009,2595,2352,1.0,2473.5,243
1010,2092,2437,0.0,2264.5,-345
1011,2406,2139,1.0,2272.5,267
1012,2113,2370,0.5,2241.5,-257
1013,2471,2156,0.5,2313.5,315
1014,2173,2345,0.0,2259.0,-172
1015,2282,2185,0.5,2233.5,97
1016,2153,2180,1.0,2166.5,-27
1017,2172,2250,0.5,2211.0,-78
1018,2251,2271,1.0,2261.0,-20
1019,2264,2101,0.5,2182.5,163
1020,2081,2155,0.0,2118.0,-74
1021,2034,1915,0.5,1974.5,119
1022,1882,2021,1.0,1951.5,-139
1023,2267,2206,1.0,2236.5,61
1024,2088,2037,1.0,2062.5,51
1025,2226,2066,1.0,2146.0,160
1026,2030,2151,0.0,2090.5,-121
1027,2272,2116,1.0,2194.0,156
1028,2100,2205,1.0,2152.5,-105
1029,2081,2153,0.0,2117.0,-72
1030,2323,1827,1.0,2075.0,496
1031,1938,2251,0.0,2094.5,-313
1032,2221,2064,1.0,2142.5,157
1033,2205,2144,1.0,2174.5,61
1034,2392,2136,0.5,2264.0,256
1035,2133,2373,0.0,2253.0,-240
1036,2244,2068,1.0,2156.0,176
1037,2089,2160,0.0,2124.5,-71
1038,2259,2548,0.0,2403.5,-289
1039,2424,1977,1.0,2200.5,447
1040,2211,2365,1.0,2288.0,-154
1041,2370,2179,1.0,2274.5,191
1042,2237,2255,1.0,2246.0,-18
1043,2227,2276,1.0,2251.5,-49
1044,2398,2068,0.5,2233.0,330
1045,2139,2174,1.0,2156.5,-35
1046,2312,2270,1.0,2291.0,42
1047,2273,2149,1.0,2211.0,124
1048,2075,2205,0.0,2140.0,-130
1049,2084,2207,0.0,2145.5,-123
1050,1967,2514,0.0,2240.5,-547
1051,2480,1995,1.0,2237.5,485
1052,2293,2448,1.0,2370.5,-155
1053,2160,2349,0.0,2254.5,-189
1054,2291,2025,1.0,2158.0,266
1055,1830,1790,0.0,1810.0,40
1056,2171,2211,1.0,2191.0,-40
1057,1784,1912,0.5,1848.0,-128
1058,2115,2129,1.0,2122.0,-14
1059,2360,2314,1.0,2337.0,46
1060,2189,2282,0.5,2235.5,-93
1061,2002,2126,0.5,2064.0,-124
1062,1730,1861,0.5,1795.5,-131
1063,1929,1719,1.0,1824.0,210
1064,1790,1678,1.0,1734.0,112
1065,2429,2393,1.0,2411.0,36
1066,2237,2242,0.0,2239.5,-5
1067,2030,2243,0.5,2136.5,-213
1068,2104,2081,0.0,2092.5,23
1069,2187,2280,0.0,2233.5,-93
1070,2261,2094,0.0,2177.5,167
1071,1874,2212,0.0,2043.0,-338
1072,2007,2257,0.0,2132.0,-250
1073,2120,1987,1.0,2053.5,133
1074,1823,2041,0.5,1932.0,-218
1075,2144,1801,1.0,1972.5,343
1076,2066,2099,1.0,2082.5,-33
1077,1973,2088,1.0,2030.5,-115
1078,1812,1964,0.5,1888.0,-152
1079,2222,2151,1.0,2186.5,71
1080,1966,2206,0.0,2086.0,-240
1081,2103,2068,0.5,2085.5,35
1082,1938,2067,0.0,2002.5,-129
1083,1831,2186,1.0,2008.5,-355
1084,1596,1765,0.0,1680.5,-169
1085,2065,2072,1.0,2068.5,-7
1086,1910,2025,0.5,1967.5,-115
1087,2032,2027,1.0,2029.5,5
1088,2104,2014,0.0,2059.0,90
1089,1788,2118,0.0,1953.0,-330
1090,2127,1712,1.0,1919.5,415
1091,1897,1956,1.0,1926.5,-59
1092,1740,1944,0.5,1842.0,-204
1093,1923,1659,0.0,1791.0,264
1094,1542,1893,1.0,1717.5,-351
1095,1875,2084,0.0,1979.5,-209
1096,1663,1983,0.5,1823.0,-320
1097,1818,1922,1.0,1870.0,-104
1098,2086,1903,1.0,1994.5,183
1099,1965,1907,0.0,1936.0,58
1100,1895,2024,1.0,1959.5,-129
1101,1992,1952,0.0,1972.0,40
1102,2282,2390,1.0,2336.0,-108
1103,2228,2316,0.0,2272.0,-88
1104,2278,2265,0.0,2271.5,13
1105,2231,2137,1.0,2184.0,94
1106,2399,2178,0.0,2288.5,221
1107,2209,2162,1.0,2185.5,47
1108,2244,2159,1.0,2201.5,85
1109,2147,2121,0.0,2134.0,26
1110,2816,2769,1.0,2792.5,47
1111,2734,2698,0.5,2716.0,36
1112,2687,2709,0.5,2698.0,-22
1113,2693,2693,0.5,2693.0,0
1114,2737,2797,0.5,2767.0,-60
1115,2763,2713,1.0,2738.0,50
1116,2698,2785,0.5,2741.5,-87
1117,2730,2668,0.5,2699.0,62
1118,2712,2523,0.0,2617.5,189
1119,2514,2648,0.5,2581.0,-134
1120,2653,2479,1.0,2566.0,174
1121,2526,2610,0.5,2568.0,-84
1122,2638,2686,0.5,2662.0,-48
1123,2652,2614,0.5,2633.0,38
1124,2587,2644,0.5,2615.5,-57
1125,2682,2616,0.0,2649.0,66
1126,2778,2683,0.5,2730.5,95
1127,2691,2746,0.5,2718.5,-55
1128,2666,2619,0.5,2642.5,47
1129,2595,2598,0.5,2596.5,-3
1130,2523,2788,0.0,2655.5,-265
1131,2729,2448,1.0,2588.5,281
1132,2472,2634,0.0,2553.0,-162
1133,2613,2472,0.5,2542.5,141
1134,2707,2722,0.5,2714.5,-15
1135,2653,2685,0.5,2669.0,-32
1136,2664,2698,0.5,2681.0,-34
1137,2555,2637,0.5,2596.0,-82
1138,2717,2606,0.5,2661.5,111
1139,2589,2635,0.5,2612.0,-46
1140,2594,2570,0.5,2582.0,24
1141,2589,2594,0.0,2591.5,-5
1142,2726,2579,1.0,2652.5,147
1143,2503,2695,0.0,2599.0,-192
1144,2670,2477,0.5,2573.5,193
1145,2472,2665,0.0,2568.5,-193
1146,2697,2533,1.0,2615.0,164
1147,2507,2601,0.0,2554.0,-94
1148,2581,2303,1.0,2442.0,278
1149,2323,2575,0.5,2449.0,-252
1150,2752,2487,1.0,2619.5,265
1151,2359,2682,1.0,2520.5,-323
1152,2681,2283,1.0,2482.0,398
1153,2383,2596,0.5,2489.5,-213
1154,2459,2687,0.0,2573.0,-228
1155,2642,2398,0.0,2520.0,244
1156,2362,2638,0.0,2500.0,-276
1157,2605,2338,0.5,2471.5,267
1158,2515,2652,0.5,2583.5,-137
1159,2554,2511,1.0,2532.5,43
1160,2426,2469,0.5,2447.5,-43
1161,2508,2375,1.0,2441.5,133
1162,2623,2566,1.0,2594.5,57
1163,2494,2617,0.5,2555.5,-123
1164,2582,2448,0.0,2515.0,134
1165,2461,2593,0.5,2527.0,-132
1166,2659,2693,0.5,2676.0,-34
1167,2639,2578,0.5,2608.5,61
1168,2575,2505,0.5,2540.0,70
1169,2518,2569,0.5,2543.5,-51
1170,2599,2640,0.5,2619.5,-41
1171,2609,2614,1.0,2611.5,-5
1172,2549,2554,0.5,2551.5,-5
1173,2552,2579,0.5,2565.5,-27
1174,2542,2551,0.5,2546.5,-9
1175,2499,2517,1.0,2508.0,-18
1176,2393,2495,0.5,2444.0,-102
1177,2418,2178,1.0,2298.0,240
1178,2773,2283,1.0,2528.0,490
1179,2365,2516,0.5,2440.5,-151
1180,2586,2195,1.0,2390.5,391
1181,2245,2542,0.0,2393.5,-297
1182,2684,2357,1.0,2520.5,327
1183,2305,2499,0.0,2402.0,-194
1184,2492,2214,1.0,2353.0,278
1185,2191,2454,1.0,2322.5,-263
1186,2538,2599,0.5,2568.5,-61
1187,2577,2061,1.0,2319.0,516
1188,2400,2543,0.0,2471.5,-143
1189,2435,2292,1.0,2363.5,143
1190,2178,2579,0.0,2378.5,-401
1191,2553,2209,0.5,2381.0,344
1192,2147,2532,0.0,2339.5,-385
1193,2481,2213,1.0,2347.0,268
1194,2519,2734,0.0,2626.5,-215
1195,2645,2446,1.0,2545.5,199
1196,2394,2569,0.0,2481.5,-175
1197,2468,2358,1.0,2413.0,110
1198,2556,2516,0.0,2536.0,40
1199,2437,2543,0.5,2490.0,-106
1200,2509,2411,0.5,2460.0,98
1201,2397,2448,0.0,2422.5,-51
1202,2546,2643,0.0,2594.5,-97
1203,2602,2322,1.0,2462.0,280
1204,2285,2453,0.5,2369.0,-168
1205,2448,2245,0.5,2346.5,203
1206,2507,2382,1.0,2444.5,125
1207,2347,2397,0.0,2372.0,-50
1208,2411,2256,0.0,2333.5,155
1209,2180,2360,0.5,2270.0,-180
1210,2610,2498,1.0,2554.0,112
1211,2473,2378,0.5,2425.5,95
1212,2354,2420,0.5,2387.0,-66
1213,2348,2357,0.5,2352.5,-9
1214,2638,2434,0.0,2536.0,204
1215,2405,2448,0.5,2426.5,-43
1216,2431,2234,1.0,2332.5,197
1217,2197,2350,0.0,2273.5,-153
1218,2227,2481,0.0,2354.0,-254
1219,2493,2046,0.5,2269.5,447
1220,2398,2500,1.0,2449.0,-102
1221,2366,2670,1.0,2518.0,-304
1222,2545,2413,0.5,2479.0,132
1223,2278,2400,0.0,2339.0,-122
1224,2442,2239,1.0,2340.5,203
1225,2706,2293,1.0,2499.5,413
1226,2349,2580,0.5,2464.5,-231
1227,2404,2160,1.0,2282.0,244
1228,2025,2494,0.0,2259.5,-469
1229,2627,2725,0.0,2676.0,-98
1230,2711,2415,1.0,2563.0,296
1231,2374,2626,0.0,2500.0,-252
1232,2569,2345,1.0,2457.0,224
1233,2068,2363,0.5,2215.5,-295
1234,2397,2139,1.0,2268.0,258
1235,2270,2306,0.5,2288.0,-36
1236,2284,2273,1.0,2278.5,11
1237,2606,2548,1.0,2577.0,58
1238,2424,2618,0.0,2521.0,-194
1239,2623,2370,1.0,2496.5,253
1240,2262,2574,0.0,2418.0,-312
1241,2384,2667,0.0,2525.5,-283
1242,2528,2361,0.5,2444.5,167
1243,2485,2523,0.5,2504.0,-38
1244,2513,2280,0.5,2396.5,233
1245,2275,2469,0.0,2372.0,-194
1246,2044,2469,0.0,2256.5,-425
1247,2423,2475,0.5,2449.0,-52
1248,2280,2387,0.0,2333.5,-107
1249,2317,2212,1.0,2264.5,105
1250,2158,2299,0.5,2228.5,-141
1251,2495,2282,1.0,2388.5,213
1252,2316,2395,1.0,2355.5,-79
1253,2417,2278,0.5,2347.5,139
1254,2211,2354,0.0,2282.5,-143
1255,2533,2272,1.0,2402.5,261
1256,2205,2498,0.0,2351.5,-293
1257,2417,2081,1.0,2249.0,336
1258,2153,2402,0.5,2277.5,-249
1259,2614,2211,1.0,2412.5,403
1260,2155,2618,0.0,2386.5,-463
1261,2548,2171,1.0,2359.5,377
1262,2129,2612,0.0,2370.5,-483
1263,2595,2469,1.0,2532.0,126
1264,2372,2437,0.0,2404.5,-65
1265,2419,2354,1.0,2386.5,65
1266,2203,2406,1.0,2304.5,-203
1267,2594,2451,0.5,2522.5,143
1268,2346,2525,0.5,2435.5,-179
1269,2471,2443,0.0,2457.0,28
1270,2378,2494,0.0,2436.0,-116
1271,2416,2711,0.0,2563.5,-295
1272,2691,2249,1.0,2470.0,442
1273,2205,2696,0.0,2450.5,-491
1274,2630,2171,1.0,2400.5,459
1275,2267,2377,1.0,2322.0,-110
1276,2308,2133,1.0,2220.5,175
1277,2226,2209,1.0,2217.5,17
1278,2171,2151,0.0,2161.0,20
1279,2323,2429,0.0,2376.0,-106
1280,2242,2251,0.5,2246.5,-9
1281,2247,2030,1.0,2138.5,217
1282,2081,2221,1.0,2151.0,-140
1283,2392,2363,1.0,2377.5,29
1284,2243,2373,0.0,2308.0,-130
1285,2244,2263,1.0,2253.5,-19
1286,2004,2244,0.0,2124.0,-240
1287,2314,2516,0.0,2415.0,-202
1288,2514,2360,1.0,2437.0,154
1289,2329,2480,0.0,2404.5,-151
1290,2462,2282,0.5,2372.0,180
1291,2562,2540,0.5,2551.0,22
1292,2291,2570,0.0,2430.5,-279
1293,2576,2193,1.0,2384.5,383
1294,2090,2511,0.0,2300.5,-421
1295,2144,2345,0.0,2244.5,-201
1296,2282,2099,1.0,2190.5,183
1297,2066,2180,0.5,2123.0,-114
1298,2171,1893,1.0,2032.0,278
1299,2129,2536,0.0,2332.5,-407
1300,2344,2173,1.0,2258.5,171
1301,2185,2420,0.0,2302.5,-235
1302,2218,2153,1.0,2185.5,65
1303,2030,2287,0.5,2158.5,-257
1304,2258,1975,1.0,2116.5,283
1305,2089,2297,0.5,2193.0,-208
1306,2120,1981,1.0,2050.5,139
1307,2250,2260,0.5,2255.0,-10
1308,2304,2221,1.0,2262.5,83
1309,2251,2255,1.0,2253.0,-4
1310,2204,2101,0.0,2152.5,103
1311,2034,2358,0.5,2196.0,-324
1312,2190,2166,0.5,2178.0,24
1313,2021,2062,0.5,2041.5,-41
1314,2222,2577,0.0,2399.5,-355
1315,2517,2206,1.0,2361.5,311
1316,2103,2496,0.0,2299.5,-393
1317,2498,2067,1.0,2282.5,431
1318,2428,2446,1.0,2437.0,-18
1319,2421,2312,1.0,2366.5,109
1320,2297,2424,0.5,2360.5,-127
1321,2360,2289,1.0,2324.5,71
1322,2257,2126,0.5,2191.5,131
1323,1861,2120,0.0,1990.5,-259
1324,2041,1719,0.5,1880.0,322
1325,1986,2002,1.0,1994.0,-16
1326,1861,1882,0.0,1871.5,-21
1327,1678,1929,1.0,1803.5,-251
1328,2454,2172,1.0,2313.0,282
1329,2264,2390,0.0,2327.0,-126
1330,2254,2155,1.0,2204.5,99
1331,2187,2153,1.0,2170.0,34
1332,2118,2127,0.5,2122.5,-9
1333,1956,1897,1.0,1926.5,59
1334,2352,2092,0.0,2222.0,260
1335,2196,2115,1.0,2155.5,81
1336,2108,1740,1.0,1924.0,368
1337,1659,1938,0.0,1798.5,-279
1338,2064,1542,1.0,1803.0,522
1339,2174,2398,1.0,2286.0,-224
1340,2211,1977,0.5,2094.0,234
1341,2149,2312,0.5,2230.5,-163
1342,2116,2179,1.0,2147.5,-63
1343,2065,2072,0.0,2068.5,-7
1344,2045,2100,1.0,2072.5,-55
1345,2032,2082,0.0,2057.0,-50
1346,2007,2149,0.5,2078.0,-142
1347,1823,1987,0.0,1905.0,-164
1348,2206,1801,1.0,2003.5,405
1349,1967,2088,1.0,2027.5,-121
1350,2066,1995,1.0,2030.5,71
1351,2075,1824,1.0,1949.5,251
1352,2084,2072,1.0,2078.0,12
1353,1790,2143,1.0,1966.5,-353
1354,1958,1830,0.0,1894.0,128
1355,1912,1810,0.0,1861.0,102
1356,2046,1784,0.0,1915.0,262
1357,2016,2084,0.0,2050.0,-68
1358,2060,2137,0.5,2098.5,-77
1359,1818,1725,0.0,1771.5,93
1360,1883,2027,1.0,1955.0,-144
1361,1719,1831,0.5,1775.0,-112
1362,2393,1788,1.0,2090.5,605
1363,2094,2187,0.5,2140.5,-93
1364,2259,2237,0.5,2248.0,22
1365,2068,2133,1.0,2100.5,-65
1366,1952,1992,0.0,1972.0,-40
1367,2026,2089,0.5,2057.5,-63
1368,2088,2086,0.5,2087.0,2
1369,1907,1973,0.0,1940.0,-66
1370,1964,1812,0.0,1888.0,152
1371,2049,1903,1.0,1976.0,146
1372,1947,1966,1.0,1956.5,-19
1373,2068,1965,1.0,2016.5,103
1374,2024,1938,1.0,1981.0,86
1375,1923,1944,0.0,1933.5,-21
1376,1848,1893,1.0,1870.5,-45
1377,2186,1875,0.5,2030.5,311
1378,1922,1663,1.0,1792.5,259
1379,2104,1596,1.0,1850.0,508
1380,1941,2014,1.0,1977.5,-73
1381,2025,1712,1.0,1868.5,313
1382,2027,1910,1.0,1968.5,117
1383,2228,2334,0.5,2281.0,-106
1384,2255,2298,0.5,2276.5,-43
1385,2265,2237,1.0,2251.0,28
1386,2276,2231,0.0,2253.5,45
1387,2399,2532,0.5,2465.5,-133
1388,2529,2333,1.0,2431.0,196
1389,2244,2508,1.0,2376.0,-264
1390,2442,2121,1.0,2281.5,321
1391,2549,2002,1.0,2275.5,547
1392,1987,2528,0.0,2257.5,-541
1393,2449,2008,1.0,2228.5,441
1394,1827,2424,0.0,2125.5,-597
1395,2055,2530,0.0,2292.5,-475
1396,2507,1977,1.0,2242.0,530
1397,2026,2489,0.0,2257.5,-463
1398,2509,2062,1.0,2285.5,447
1399,1885,2458,0.0,2171.5,-573
1400,2444,2035,1.0,2239.5,409
1401,1721,2432,0.0,2076.5,-711
1402,2139,2466,0.0,2302.5,-327
1403,2442,1992,1.0,2217.0,450
1404,1939,2433,0.5,2186.0,-494
1405,2404,1782,1.0,2093.0,622
1406,2512,1987,1.0,2249.5,525
1407,1786,2467,0.0,2126.5,-681
1408,2356,1788,1.0,2072.0,568
1409,2117,2341,0.0,2229.0,-224
1410,1978,2503,0.0,2240.5,-525
1411,2371,1939,1.0,2155.0,432
1412,1828,2379,0.0,2103.5,-551
1413,2271,1655,1.0,1963.0,616
1414,2467,1954,1.0,2210.5,513
1415,1933,2412,0.0,2172.5,-479
1416,2377,1844,1.0,2110.5,533
1417,1834,2375,0.0,2104.5,-541
1418,1687,2454,0.0,2070.5,-767
1419,2349,1923,0.0,2136.0,426
1420,1997,2338,0.0,2167.5,-341
1421,2203,1927,1.0,2065.0,276
1422,2173,2402,0.0,2287.5,-229
1423,2352,2035,0.5,2193.5,317
1424,1755,2372,0.0,2063.5,-617
1425,2246,1788,1.0,2017.0,458
1426,2422,2121,0.5,2271.5,301
1427,1911,2417,0.5,2164.0,-506
1428,2276,1819,1.0,2047.5,457
1429,1830,2252,0.0,2041.0,-422
1430,1970,2385,0.5,2177.5,-415
1431,1881,2306,0.0,2093.5,-425
1432,2302,1942,1.0,2122.0,360
1433,2015,2442,0.0,2228.5,-427
1434,2284,1836,1.0,2060.0,448
1435,1894,2261,0.0,2077.5,-367
1436,2253,1863,1.0,2058.0,390
1437,2344,2101,1.0,2222.5,243
1438,1995,2345,0.0,2170.0,-350
1439,2355,1693,1.0,2024.0,662
1440,1808,2296,0.0,2052.0,-488
1441,2095,2260,0.0,2177.5,-165
1442,2240,1918,1.0,2079.0,322
1443,1841,2211,0.0,2026.0,-370
1444,2048,1673,0.5,1860.5,375
1445,2351,1840,1.0,2095.5,511
1446,1889,2305,0.0,2097.0,-416
1447,2235,1949,0.5,2092.0,286
1448,1727,2151,0.0,1939.0,-424
1449,1890,2457,0.0,2173.5,-567
1450,2336,1843,1.0,2089.5,493
1451,1738,2256,1.0,1997.0,-518
1452,2215,1828,1.0,2021.5,387
1453,2392,1997,1.0,2194.5,395
1454,1728,2304,0.0,2016.0,-576
1455,2277,1952,1.0,2114.5,325
1456,1774,2300,0.0,2037.0,-526
1457,1882,2280,0.0,2081.0,-398
1458,2353,1910,1.0,2131.5,443
1459,1885,2305,0.0,2095.0,-420
1460,2241,1834,0.5,2037.5,407
1461,2311,1993,1.0,2152.0,318
1462,1864,2232,1.0,2048.0,-368
1463,2167,1845,0.5,2006.0,322
1464,1806,2146,0.0,1976.0,-340
1465,2057,2291,0.0,2174.0,-234
1466,2346,1697,1.0,2021.5,649
1467,1940,2267,0.0,2103.5,-327
1468,2216,1810,1.0,2013.0,406
1469,1967,2276,0.0,2121.5,-309
1470,2241,1914,1.0,2077.5,327
1471,1541,2267,0.0,1904.0,-726
1472,1909,2251,0.0,2080.0,-342
1473,2306,2023,1.0,2164.5,283
1474,1705,2226,0.0,1965.5,-521
1475,2203,1762,1.0,1982.5,441
1476,2295,1924,1.0,2109.5,371
1477,1915,2317,0.0,2116.0,-402
1478,2266,1546,1.0,1906.0,720
1479,1943,2202,0.0,2072.5,-259
1480,2313,2270,0.0,2291.5,43
1481,2237,2218,0.0,2227.5,19
1482,1916,2285,0.0,2100.5,-369
1483,2324,1810,1.0,2067.0,514
1484,1820,2245,0.0,2032.5,-425
1485,2205,1753,1.0,1979.0,452
1486,2393,1985,1.0,2189.0,408
1487,1818,2212,0.0,2015.0,-394
1488,1565,2228,0.0,1896.5,-663
1489,2164,2351,0.5,2257.5,-187
1490,1731,2160,0.5,1945.5,-429
1491,2258,2171,0.5,2214.5,87
1492,1779,2297,0.0,2038.0,-518
1493,2185,1597,1.0,1891.0,588
1494,1638,2258,0.0,1948.0,-620
1495,2239,2327,1.0,2283.0,-88
1496,1682,1838,0.0,1760.0,-156
1497,2048,2087,1.0,2067.5,-39
1498,2384,1713,1.0,2048.5,671
1499,1796,1946,0.0,1871.0,-150
1500,2163,2242,1.0,2202.5,-79
1501,1667,1657,0.5,1662.0,10
1502,1760,2132,0.0,1946.0,-372
1503,2118,2520,1.0,2319.0,-402
1504,1581,1782,0.0,1681.5,-201
1505,2053,2052,1.0,2052.5,1
1506,2228,1694,1.0,1961.0,534
1507,1742,2050,0.5,1896.0,-308
1508,2253,2170,1.0,2211.5,83
1509,1760,1605,0.0,1682.5,155
1510,2147,2178,1.0,2162.5,-31
1511,2143,2185,1.0,2164.0,-42
1512,2261,1923,1.0,2092.0,338
1513,1950,2130,0.0,2040.0,-180
1514,2058,1796,1.0,1927.0,262
1515,1988,2057,0.0,2022.5,-69
1516,2169,2413,1.0,2291.0,-244
1517,1566,1536,0.0,1551.0,30
1518,2160,2030,1.0,2095.0,130
1519,2211,1542,1.0,1876.5,669
1520,1705,2197,0.0,1951.0,-492
1521,2101,2057,0.0,2079.0,44
1522,1688,2319,0.0,2003.5,-631
1523,2280,1646,1.0,1963.0,634
1524,1583,2066,0.0,1824.5,-483
1525,2036,1575,1.0,1805.5,461
1526,2235,1634,1.0,1934.5,601
1527,1627,2230,0.0,1928.5,-603
1528,2235,1547,1.0,1891.0,688
1529,1839,1861,0.0,1850.0,-22
1530,2186,2199,1.0,2192.5,-13
1531,2102,2156,1.0,2129.0,-54
1532,2337,1482,1.0,1909.5,855
1533,2097,2181,1.0,2139.0,-84
1534,1520,1533,0.0,1526.5,-13
1535,2103,2066,1.0,2084.5,37
1536,1794,1892,0.0,1843.0,-98
1537,2165,2234,1.0,2199.5,-69
1538,2254,1516,1.0,1885.0,738
1539,1756,1707,0.0,1731.5,49
1540,2090,2120,1.0,2105.0,-30
1541,2341,2294,1.0,2317.5,47
1542,1689,1772,0.0,1730.5,-83
1543,1876,1974,1.0,1925.0,-98
1544,2179,1550,1.0,1864.5,629
1545,1594,1720,0.0,1657.0,-126
1546,2037,2074,1.0,2055.5,-37
1547,1523,1968,0.0,1745.5,-445
1548,2187,2231,1.0,2209.0,-44
1549,1484,1836,0.0,1660.0,-352
1550,1996,2033,1.0,2014.5,-37
1551,2346,2026,1.0,2186.0,320
1552,1763,2128,0.0,1945.5,-365
1553,1998,1952,0.0,1975.0,46
1554,2028,2164,1.0,2096.0,-136
1555,2042,2014,1.0,2028.0,28
1556,2004,1806,1.0,1905.0,198
1557,2105,1990,1.0,2047.5,115
1558,1818,2104,0.0,1961.0,-286
1559,2091,2132,0.5,2111.5,-41
1560,1747,2012,0.0,1879.5,-265
1561,2178,1834,0.0,2006.0,344
1562,2152,2116,1.0,2134.0,36
1563,1638,1927,0.5,1782.5,-289
1564,1956,2193,0.0,2074.5,-237
1565,2067,1490,1.0,1778.5,577
1566,2036,2050,1.0,2043.0,-14
1567,2218,1825,1.0,2021.5,393
1568,1528,2162,0.0,1845.0,-634
1569,1816,2098,0.0,1957.0,-282
1570,2024,2040,0.0,2032.0,-16
1571,2061,2091,0.0,2076.0,-30
1572,2061,1670,1.0,1865.5,391
1573,2061,1991,1.0,2026.0,70
1574,2174,2011,0.0,2092.5,163
1575,2076,1647,1.0,1861.5,429
1576,2009,2158,1.0,2083.5,-149
1577,2009,1947,1.0,1978.0,62
1578,2075,2014,0.0,2044.5,61
1579,2072,1993,0.0,2032.5,79
1580,2043,2091,1.0,2067.0,-48
1581,1896,1927,1.0,1911.5,-31
1582,1957,1886,0.0,1921.5,71
1583,1832,1737,0.0,1784.5,95
1584,2483,2294,0.0,2388.5,189
1585,1994,2337,0.0,2165.5,-343
1586,2380,1837,1.0,2108.5,543
1587,1632,2301,0.0,1966.5,-669
1588,2317,2078,1.0,2197.5,239
1589,1797,2299,0.0,2048.0,-502
1590,2281,1761,1.0,2021.0,520
1591,1501,2313,0.0,1907.0,-812
1592,2220,2023,0.0,2121.5,197
1593,1949,2005,1.0,1977.0,-56
1594,2214,2087,0.0,2150.5,127
1595,2528,2549,1.0,2538.5,-21
1596,2074,2179,0.0,2126.5,-105
1597,2424,2449,1.0,2436.5,-25
1598,2507,2037,0.5,2272.0,470
1599,2187,2231,0.0,2209.0,-44
1600,2489,2524,1.0,2506.5,-35
1601,2006,2033,0.0,2019.5,-27
1602,2346,2448,0.0,2397.0,-102
1603,2458,2509,1.0,2483.5,-51
1604,1998,2128,0.0,2063.0,-130
1605,2432,2444,1.0,2438.0,-12
1606,2164,2467,0.0,2315.5,-303
1607,2356,2028,1.0,2192.0,328
1608,2014,2341,0.5,2177.5,-327
1609,2303,2042,1.0,2172.5,261
1610,2371,2204,1.0,2287.5,167
1611,1990,2379,0.0,2184.5,-389
1612,2396,2105,1.0,2250.5,291
1613,2104,2271,0.5,2187.5,-167
1614,2193,2467,0.0,2330.0,-274
1615,2412,2067,1.0,2239.5,345
1616,2050,2377,0.0,2213.5,-327
1617,2375,2036,1.0,2205.5,339
1618,2218,2317,1.0,2267.5,-99
1619,2299,2162,0.5,2230.5,137
1620,2143,2281,0.5,2212.0,-138
1621,2411,2098,1.0,2254.5,313
1622,2024,2284,0.0,2154.0,-260
1623,2261,2040,1.0,2150.5,221
1624,2061,2253,0.0,2157.0,-192
1625,2220,2344,0.5,2282.0,-124
1626,2345,2023,0.5,2184.0,322
1627,1949,2355,0.5,2152.0,-406
1628,2264,1891,0.5,2077.5,373
1629,2606,2091,1.0,2348.5,515
1630,2061,2260,0.0,2160.5,-199
1631,2240,1991,0.0,2115.5,249
1632,2061,2211,0.5,2136.0,-150
1633,2174,2392,0.0,2283.0,-218
1634,2304,2011,1.0,2157.5,293
1635,2076,2277,0.0,2176.5,-201
1636,2291,2158,1.0,2224.5,133
1637,2009,2267,0.0,2138.0,-258
1638,2216,2009,1.0,2112.5,207
1639,1999,2165,0.0,2082.0,-166
1640,2075,2259,0.5,2167.0,-184
1641,2276,2014,1.0,2145.0,262
1642,2072,2298,0.0,2185.0,-226
1643,2267,1993,1.0,2130.0,274
1644,2251,2091,1.0,2171.0,160
1645,2043,2315,0.0,2179.0,-272
1646,2306,1927,0.5,2116.5,379
1647,1896,2226,0.0,2061.0,-330
1648,2281,2295,0.5,2288.0,-14
1649,2174,1957,1.0,2065.5,217
1650,1886,2317,0.0,2101.5,-431
1651,2202,1832,1.0,2017.0,370
1652,2542,2313,1.0,2427.5,229
1653,2270,2442,0.0,2356.0,-172
1654,2433,2237,1.0,2335.0,196
1655,2218,2404,0.5,2311.0,-186
1656,2285,2402,0.5,2343.5,-117
1657,2380,2324,0.5,2352.0,56
1658,2245,2352,0.5,2298.5,-107
1659,2246,2208,1.0,2227.0,38
1660,2464,2393,1.0,2428.5,71
1661,2212,2385,0.0,2298.5,-173
1662,2289,2226,1.0,2257.5,63
1663,2228,2306,0.5,2267.0,-78
1664,2338,2411,0.5,2374.5,-73
1665,2351,2327,0.0,2339.0,24
1666,2239,2305,0.0,2272.0,-66
1667,2151,2048,1.0,2099.5,103
1668,2520,2280,0.5,2400.0,240
1669,2353,2216,1.0,2284.5,137
1670,2118,2305,0.0,2211.5,-187
1671,2222,2053,0.0,2137.5,169
1672,2329,2258,1.0,2293.5,71
1673,2297,2178,0.5,2237.5,119
1674,2147,2185,1.0,2166.0,-38
1675,2258,2185,1.0,2221.5,73
1676,2384,2342,1.0,2363.0,42
1677,2261,2242,0.5,2251.5,19
1678,2163,2130,0.0,2146.5,33
1679,2057,2109,0.5,2083.0,-52
1680,2413,2228,1.0,2320.5,185
1681,2170,2169,1.0,2169.5,1
1682,2030,2253,1.0,2141.5,-223
1683,2181,2160,1.0,2170.5,21
1684,2476,2211,1.0,2343.5,265
1685,2227,2454,0.0,2340.5,-227
1686,2338,2101,1.0,2219.5,237
1687,2057,2203,1.0,2130.0,-146
1688,2319,2483,0.0,2401.0,-164
1689,2356,2280,1.0,2318.0,76
1690,2066,2337,0.0,2201.5,-271
1691,2301,1981,1.0,2141.0,320
1692,2417,2235,1.0,2326.0,182
1693,2230,2355,0.0,2292.5,-125
1694,2276,2235,0.5,2255.5,41
1695,1954,2252,0.0,2103.0,-298
1696,2199,2457,0.0,2328.0,-258
1697,2336,2186,1.0,2261.0,150
1698,2156,2215,1.0,2185.5,-59
1699,2237,2102,0.0,2169.5,135
1700,2368,2337,0.5,2352.5,31
1701,2181,2351,0.5,2266.0,-170
1702,2164,2004,1.0,2084.0,160
1703,2097,2095,0.0,2096.0,2
1704,2066,2159,0.5,2112.5,-93
1705,2132,2234,0.0,2183.0,-102
1706,2088,2012,1.0,2050.0,76
1707,1983,2165,0.5,2074.0,-182
1708,2434,2254,1.0,2344.0,180
1709,2058,2232,0.0,2145.0,-174
1710,2167,2090,1.0,2128.5,77
1711,2103,2146,0.0,2124.5,-43
1712,2294,2178,0.5,2236.0,116
1713,2116,2341,0.0,2228.5,-225
1714,1974,2152,1.0,2063.0,-178
1715,1841,1876,0.0,1858.5,-35
1716,1993,1864,0.5,1928.5,129
1717,1762,1801,1.0,1781.5,-39
1718,1834,1924,0.0,1879.0,-90
1719,1915,1546,0.0,1730.5,369
1720,1943,1638,1.0,1790.5,305
1721,1916,1923,1.0,1919.5,-7
1722,1997,1810,1.0,1903.5,187
1723,1753,1927,0.0,1840.0,-174
1724,1921,1654,1.0,1787.5,267
1725,1838,1911,0.0,1874.5,-73
1726,1830,1682,1.0,1756.0,148
1727,1631,1732,0.5,1681.5,-101
1728,1782,1981,0.0,1881.5,-199
1729,1843,1581,1.0,1712.0,262
1730,1694,1738,0.0,1716.0,-44
1731,1828,1789,1.0,1808.5,39
1732,1788,1731,1.0,1759.5,57
1733,1923,1675,1.0,1799.0,248
1734,1988,1747,0.0,1867.5,241
1735,1992,2139,1.0,2065.5,-147
1736,1566,1536,0.0,1551.0,30
1737,1782,1939,0.0,1860.5,-157
1738,2035,2173,1.0,2104.0,-138
1739,1788,1755,0.5,1771.5,33
1740,1688,1970,0.5,1829.0,-282
1741,1881,1646,0.0,1763.5,235
1742,1942,1498,1.0,1720.0,444
1743,1840,1634,1.0,1737.0,206
1744,1627,1889,1.0,1758.0,-262
1745,1949,1586,1.0,1767.5,363
1746,1547,1727,0.5,1637.0,-180
1747,1839,1882,0.0,1860.5,-43
1748,1910,1798,1.0,1854.0,112
1749,1778,1885,1.0,1831.5,-107
1750,2171,1640,1.0,1905.5,531
1751,1684,1482,0.0,1583.0,202
1752,1635,1779,1.0,1707.0,-144
1753,1520,1533,0.0,1526.5,-13
1754,2050,1597,1.0,1823.5,453
1755,1892,1742,0.5,1817.0,150
1756,1605,1794,1.0,1699.5,-189
1757,1516,1760,0.0,1638.0,-244
1758,1946,1707,1.0,1826.5,239
1759,1756,1796,0.0,1776.0,-40
1760,1657,1716,0.0,1686.5,-59
1761,2002,1667,1.0,1834.5,335
1762,1772,1952,0.0,1862.0,-180
1763,1987,1689,1.0,1838.0,298
1764,1550,2008,0.0,1779.0,-458
1765,1720,2055,0.0,1887.5,-335
1766,1977,1594,0.0,1785.5,383
1767,2062,2026,0.0,2044.0,36
1768,1763,2026,1.0,1894.5,-263
1769,2035,1885,1.0,1960.0,150
1770,1987,1721,0.5,1854.0,266
1771,1788,1949,1.0,1868.5,-161
1772,1806,2117,0.0,1961.5,-311
1773,1939,2094,1.0,2016.5,-155
1774,1655,1828,1.0,1741.5,-173
1775,2070,1825,1.0,1947.5,245
1776,1528,1954,0.0,1741.0,-426
1777,1933,1844,0.0,1888.5,89
1778,1836,2015,1.0,1925.5,-179
1779,2005,1894,1.0,1949.5,111
1780,1670,1995,0.0,1832.5,-325
1781,1693,1918,0.0,1805.5,-225
1782,1841,1673,0.0,1757.0,168
1783,1730,1647,0.5,1688.5,83
1784,1997,1728,0.0,1862.5,269
1785,1952,1774,0.5,1863.0,178
1786,1940,1697,1.0,1818.5,243
1787,2022,1810,1.0,1916.0,212
1788,1914,1967,1.0,1940.5,-53
1789,1705,1909,1.0,1807.0,-204
1790,1762,1741,1.0,1751.5,21
1791,1999,1816,0.5,1907.5,183
1792,1797,2078,1.0,1937.5,-281
1793,2294,1761,1.0,2027.5,533
1794,1818,1985,0.0,1901.5,-167
1795,1837,1994,1.0,1915.5,-157
1796,2599,1632,1.0,2115.5,967
1797,2466,2542,1.0,2504.0,-76
1798,2528,2549,0.5,2538.5,-21
1799,2433,2442,0.5,2437.5,-9
1800,2547,2449,0.5,2498.0,98
1801,2356,2483,0.5,2419.5,-127
1802,2458,2509,1.0,2483.5,-51
1803,2380,2337,1.0,2358.5,43
1804,2467,2444,1.0,2455.5,23
1805,2385,2464,0.5,2424.5,-79
1806,2377,2412,1.0,2394.5,-35
1807,2302,2289,0.5,2295.5,13
1808,2066,2375,0.0,2220.5,-309
1809,2284,2411,1.0,2347.5,-127
1810,2234,2103,0.0,2168.5,131
1811,2253,2261,0.0,2257.0,-8
1812,2392,2088,1.0,2240.0,304
1813,2417,2422,0.0,2419.5,-5
1814,2277,2304,0.5,2290.5,-27
1815,2252,2355,0.0,2303.5,-103
1816,2606,2266,1.0,2436.0,340
1817,2346,2291,1.0,2318.5,55
1818,2240,2260,1.0,2250.0,-20
1819,2216,2267,1.0,2241.5,-51
1820,2530,2211,0.5,2370.5,319
1821,2311,2434,0.0,2372.5,-123
1822,2489,2524,1.0,2506.5,-35
1823,2167,2232,0.0,2199.5,-65
1824,2512,2448,1.0,2480.0,64
1825,2178,2329,1.0,2253.5,-151
1826,2341,2356,0.0,2348.5,-15
1827,2143,2147,0.0,2145.0,-4
1828,2476,2303,0.5,2389.5,173
1829,2371,2503,0.5,2437.0,-132
1830,2349,2454,0.0,2401.5,-105
1831,2396,2379,0.5,2387.5,17
1832,2402,2338,0.0,2370.0,64
1833,2298,2276,1.0,2287.0,22
1834,2372,2380,1.0,2376.0,-8
1835,2267,2241,0.5,2254.0,26
1836,2411,2246,1.0,2328.5,165
1837,2315,2251,1.0,2283.0,64
1838,2235,2305,0.5,2270.0,-70
1839,2203,2306,0.5,2254.5,-103
1840,2280,2151,0.5,2215.5,129
1841,2317,2174,0.5,2245.5,143
1842,2305,2353,1.0,2329.0,-48
1843,2202,2266,0.5,2234.0,-64
1844,2368,2241,1.0,2304.5,127
1845,2341,2294,1.0,2317.5,47
1846,2160,2351,1.0,2255.5,-191
1847,1938,1974,0.5,1956.0,-36
1848,2502,2095,1.0,2298.5,407
1849,1949,2023,0.5,1986.0,-74
1850,2281,2299,1.0,2290.0,-18
1851,1891,2087,0.0,1989.0,-196
1852,2344,2313,1.0,2328.5,31
1853,2162,2218,1.0,2190.0,-56
1854,2296,2345,1.0,2320.5,-49
1855,1818,2143,0.0,1980.5,-325
1856,2261,2264,1.0,2262.5,-3
1857,2170,2228,0.5,2199.0,-58
1858,2058,2130,1.0,2094.0,-72
1859,2181,2212,1.0,2196.5,-31
1860,2457,2057,1.0,2257.0,400
1861,2169,2413,0.5,2291.0,-244
1862,2256,2336,1.0,2296.0,-80
1863,2160,2030,0.0,2095.0,130
1864,2199,2237,1.0,2218.0,-38
1865,2242,2384,0.0,2313.0,-142
1866,2156,2186,0.0,2171.0,-30
1867,2109,2132,1.0,2120.5,-23
1868,2159,2102,0.0,2130.5,57
1869,2324,2285,1.0,2304.5,39
1870,2091,2132,0.0,2111.5,-41
1871,2208,2245,1.0,2226.5,-37
1872,2338,1983,1.0,2160.5,355
1873,2067,2193,0.0,2130.0,-126
1874,2087,2327,0.0,2207.0,-240
1875,1990,2050,0.5,2020.0,-60
1876,2098,2048,0.0,2073.0,50
1877,2118,2216,0.5,2167.0,-98
1878,2040,2024,0.0,2032.0,16
1879,2053,2052,1.0,2052.5,1
1880,2091,2115,1.0,2103.0,-24
1881,2011,2174,0.0,2092.5,-163
1882,2061,1991,0.0,2026.0,70
1883,2158,2022,0.0,2090.0,136
1884,2297,2258,0.5,2277.5,39
1885,1947,2009,0.0,1978.0,-62
1886,2160,2258,1.0,2209.0,-98
1887,2227,1999,1.0,2113.0,228
1888,1952,2002,0.5,1977.0,-50
1889,2101,2197,1.0,2149.0,-96
1890,2008,1987,1.0,1997.5,21
1891,2337,2057,1.0,2197.0,280
1892,1954,2070,0.5,2012.0,-116
1893,2004,2181,1.0,2092.5,-177
1894,1844,1933,0.0,1888.5,-89
1895,1693,1995,0.5,1844.0,-302
1896,2116,1788,1.0,1952.0,328
1897,1911,2121,0.0,2016.0,-210
1898,1927,2152,1.0,2039.5,-225
1899,1732,1830,1.0,1781.0,-98
1900,1981,1841,0.0,1911.0,140
1901,2035,2173,0.5,2104.0,-138
1902,1843,1890,1.0,1866.5,-47
1903,1788,1755,0.0,1771.5,33
1904,2313,1738,1.0,2025.5,575
1905,2023,1909,0.0,1966.0,114
1906,2249,2270,1.0,2259.5,-21
1907,1741,1705,0.0,1723.0,36
1908,1924,2218,1.0,2071.0,-294
1909,2212,2393,1.0,2302.5,-181
1910,1546,1915,0.0,1730.5,-369
1911,2172,2228,1.0,2200.0,-56
1912,2235,1521,0.5,1878.0,714
1913,1742,2050,0.0,1896.0,-308
1914,1954,2230,1.0,2092.0,-276
1915,1604,1760,0.5,1682.0,-156
1916,2231,1861,1.0,2046.0,370
1917,1992,2139,0.0,2065.5,-147
1918,1996,2187,0.5,2091.5,-191
1919,1782,1939,0.0,1860.5,-157
1920,1949,2006,0.0,1977.5,-57
1921,2189,2164,1.0,2176.5,25
1922,1788,1786,0.5,1787.0,2
1923,2014,2028,1.0,2021.0,-14
1924,2204,2117,1.0,2160.5,87
1925,1978,2094,1.0,2036.0,-116
1926,1990,2004,0.0,1997.0,-14
1927,1828,1939,0.5,1883.5,-111
1928,2091,2104,1.0,2097.5,-13
1929,1918,2095,0.5,2006.5,-177
1930,1927,2043,1.0,1985.0,-116
1931,1730,1673,0.0,1701.5,57
1932,2022,1896,0.0,1959.0,126
1933,1957,2281,1.0,2119.0,-324
1934,1914,1967,1.0,1940.5,-53
1935,1737,1886,1.0,1811.5,-149
1936,1882,1541,0.0,1711.5,341
1937,2026,2055,0.0,2040.5,-29
1938,1885,1910,1.0,1897.5,-25
1939,1970,1834,0.0,1902.0,136
1940,1779,2171,0.5,1975.0,-392
1941,1597,1635,0.0,1616.0,-38
1942,1840,1942,0.0,1891.0,-102
1943,2280,2319,1.0,2299.5,-39
1944,1949,1889,0.5,1919.0,60
1945,2036,2066,0.0,2051.0,-30
1946,1946,1898,0.0,1922.0,48
1947,2179,2214,1.0,2196.5,-35
1948,1657,1796,0.0,1726.5,-139
1949,1968,2037,1.0,2002.5,-69
1950,2254,1667,0.5,1960.5,587
1951,1697,2057,0.5,1877.0,-360
1952,2120,2058,1.0,2089.0,62
1953,1810,1940,1.0,1875.0,-130
1954,2015,2103,0.0,2059.0,-88
1955,2128,2346,1.0,2237.0,-218
1956,1863,1836,0.0,1849.5,27
1957,1993,1593,1.0,1793.0,400
1958,1728,1997,0.5,1862.5,-269
1959,1845,1864,1.0,1854.5,-19
1960,1774,1808,0.0,1791.0,-34
1961,1923,1762,1.0,1842.5,161
1962,2035,2062,0.5,2048.5,-27
1963,1796,1950,0.0,1873.0,-154
1964,1709,1721,0.0,1715.0,-12
1965,2026,1688,1.0,1857.0,338
1966,1646,1763,0.0,1704.5,-117
1967,1575,1583,1.0,1579.0,-8
1968,1634,1816,0.0,1725.0,-182
1969,1586,1627,1.0,1606.5,-41
1970,1707,1756,0.0,1731.5,-49
1971,1753,1834,1.0,1793.5,-81
1972,1927,1916,0.5,1921.5,11
1973,1810,2050,1.0,1930.0,-240
1974,1746,1820,0.0,1783.0,-74
1975,1720,1839,1.0,1779.5,-119
1976,1798,1631,1.0,1714.5,167
1977,1482,1684,0.0,1583.0,-202
1978,1838,1520,1.0,1679.0,318
1979,1689,1772,0.5,1730.5,-83
1980,1713,1682,1.0,1697.5,31
1981,1825,1631,0.0,1728.0,194
1982,1705,1528,1.0,1616.5,177
1983,1782,1760,0.5,1771.0,22
1984,2005,1581,1.0,1793.0,424
1985,1985,1988,1.0,1986.5,-3
1986,1566,1818,0.5,1692.0,-252
1987,1894,1522,0.0,1708.0,372
1988,1542,1565,1.0,1553.5,-23
1989,1670,1892,0.0,1781.0,-222
1990,1794,1516,0.0,1655.0,278
1991,1923,2294,0.0,2108.5,-371
1992,1994,1997,0.5,1995.5,-3
1993,1927,1837,1.0,1882.0,90
1994,1643,1921,0.5,1782.0,-278
1995,1999,2075,0.5,2037.0,-76
1996,2072,2078,1.0,2075.0,-6
1997,1797,1993,0.0,1895.0,-196
1998,1937,1761,0.5,1849.0,176
1999,2503,2392,0.5,2447.5,111
2000,2304,2371,1.0,2337.5,-67
2001,2379,2300,1.0,2339.5,79
2002,2266,2396,0.5,2331.0,-130
2003,2259,2530,0.5,2394.5,-271
2004,2507,2276,0.5,2391.5,231
2005,2298,2524,0.0,2411.0,-226
2006,2448,2267,1.0,2357.5,181
2007,2280,2467,0.0,2373.5,-187
2008,2412,2353,0.5,2382.5,59
2009,2305,2377,0.5,2341.0,-72
2010,2287,2222,0.0,2254.5,65
2011,2442,2368,0.5,2405.0,74
2012,2351,2411,0.0,2381.0,-60
2013,2284,2164,1.0,2224.0,120
2014,2160,2261,0.0,2210.5,-101
2015,2483,2599,0.5,2541.0,-116
2016,2549,2356,1.0,2452.5,193
2017,2380,2528,0.5,2454.0,-148
2018,2449,2301,1.0,2375.0,148
2019,2344,2547,0.0,2445.5,-203
2020,2509,2355,1.0,2432.0,154
2021,2296,2458,0.0,2377.0,-162
2022,2432,2264,1.0,2348.0,168
2023,2512,2606,0.5,2559.0,-94
2024,2260,2467,0.0,2363.5,-207
2025,2341,2240,0.0,2290.5,101
2026,2211,2303,0.5,2257.0,-92
2027,2251,2342,1.0,2296.5,-91
2028,2261,2315,0.0,2288.0,-54
2029,2226,2130,0.0,2178.0,96
2030,2058,2203,0.0,2130.5,-145
2031,2542,2411,1.0,2476.5,131
2032,2351,2466,0.0,2408.5,-115
2033,2442,2235,0.5,2338.5,207
2034,2151,2404,0.5,2277.5,-253
2035,2291,2457,0.5,2374.0,-166
2036,2336,2346,1.0,2341.0,-10
2037,2267,2256,0.0,2261.5,11
2038,2215,2165,0.0,2190.0,50
2039,2329,2502,0.5,2415.5,-173
2040,2317,2178,0.5,2247.5,139
2041,2147,2299,0.0,2223.0,-152
2042,2313,2185,0.5,2249.0,128
2043,2295,2380,1.0,2337.5,-85
2044,2352,2174,0.5,2263.0,178
2045,2266,2372,1.0,2319.0,-106
2046,2246,2202,0.0,2224.0,44
2047,2294,2384,0.0,2339.0,-90
2048,2242,2341,0.0,2291.5,-99
2049,1938,2163,0.5,2050.5,-225
2050,2132,1876,1.0,2004.0,256
2051,2285,2476,1.0,2380.5,-191
2052,2454,2324,1.0,2389.0,130
2053,2245,2349,1.0,2297.0,-104
2054,2338,2205,0.5,2271.5,133
2055,2464,2281,1.0,2372.5,183
2056,1957,2385,0.0,2171.0,-428
2057,2306,1886,0.5,2096.0,420
2058,1832,2302,0.0,2067.0,-470
2059,2258,2235,0.5,2246.5,23
2060,2230,2297,0.5,2263.5,-67
2061,2258,2235,0.5,2246.5,23
2062,1954,2160,0.5,2057.0,-206
2063,1910,2199,0.5,2054.5,-289
2064,2186,1885,1.0,2035.5,301
2065,1834,2156,0.5,1995.0,-322
2066,1931,1778,0.5,1854.5,153
2067,2422,2103,1.0,2262.5,319
2068,2234,2417,0.0,2325.5,-183
2069,2355,2088,1.0,2221.5,267
2070,2165,2276,0.5,2220.5,-111
2071,2393,2520,0.5,2456.5,-127
2072,2216,2212,0.5,2214.0,4
2073,2226,2118,1.0,2172.0,108
2074,2052,2228,0.0,2140.0,-176
2075,1981,2338,0.0,2159.5,-357
2076,2239,1890,0.5,2064.5,349
2077,1843,2087,1.0,1965.0,-244
2078,2048,1738,0.0,1893.0,310
2079,2434,2214,1.0,2324.0,220
2080,2179,2311,0.5,2245.0,-132
2081,2232,2074,1.0,2153.0,158
2082,1968,2146,0.0,2057.0,-178
2083,2346,2337,0.5,2341.5,9
2084,2181,1998,0.0,2089.5,183
2085,1952,2004,0.0,1978.0,-52
2086,2091,2075,1.0,2083.0,16
2087,2014,2061,1.0,2037.5,-47
2088,1991,1993,1.0,1992.0,-2
2089,1937,2022,0.0,1979.5,-85
2090,2211,2313,1.0,2262.0,-102
2091,2270,2227,0.0,2248.5,43
2092,2197,2249,0.5,2223.0,-52
2093,2218,2101,1.0,2159.5,117
2094,2319,2231,0.5,2275.0,88
2095,2033,2280,0.0,2156.5,-247
2096,2036,1996,1.0,2016.0,40
2097,2006,1981,0.5,1993.5,25
2098,2164,2178,1.0,2171.0,-14
2099,2116,2189,0.5,2152.5,-73
2100,2028,2152,1.0,2090.0,-124
2101,1927,2042,0.5,1984.5,-115
2102,2094,2091,0.5,2092.5,3
2103,2043,1978,1.0,2010.5,65
2104,1939,1927,1.0,1933.0,12
2105,1782,1828,1.0,1805.0,-46
2106,2218,2254,0.5,2236.0,-36
2107,2058,2162,0.5,2110.0,-104
2108,2143,2120,1.0,2131.5,23
2109,2090,1818,1.0,1954.0,272
2110,2228,2171,1.0,2199.5,57
2111,1779,2253,0.0,2016.0,-474
2112,2212,1635,1.0,1923.5,577
2113,1638,2181,0.0,1909.5,-543
2114,1687,1993,0.0,1840.0,-306
2115,1864,1997,0.0,1930.5,-133
2116,1927,1845,0.5,1886.0,82
2117,1801,1921,0.5,1861.0,-120
2118,2220,1923,1.0,2071.5,297
2119,1950,2023,0.0,1986.5,-73
2120,1949,1796,1.0,1872.5,153
2121,1970,2087,1.0,2028.5,-117
2122,1788,1942,0.5,1865.0,-154
2123,2057,2413,0.0,2235.0,-356
2124,2169,1940,1.0,2054.5,229
2125,1810,2030,0.0,1920.0,-220
2126,2026,2204,0.0,2115.0,-178
2127,2004,1763,0.5,1883.5,241
2128,2104,2105,1.0,2104.5,-1
2129,1818,1916,1.0,1867.0,-98
2130,1747,1820,0.0,1783.5,-73
2131,1753,1840,0.0,1796.5,-87
2132,1889,1949,0.0,1919.0,-60
2133,1898,1806,1.0,1852.0,92
2134,2173,1987,1.0,2080.0,186
2135,1949,2035,0.5,1992.0,-86
2136,1755,1786,0.5,1770.5,-31
2137,2117,1788,1.0,1952.5,329
2138,2121,1911,0.5,2016.0,210
2139,1762,1732,0.0,1747.0,30
2140,2095,2193,0.5,2144.0,-98
2141,2050,1918,1.0,1984.0,132
2142,1841,2036,0.0,1938.5,-195
2143,1990,1730,1.0,1860.0,260
2144,1909,2002,0.5,1955.5,-93
2145,1952,2023,0.0,1987.5,-71
2146,1705,2008,0.0,1856.5,-303
2147,1827,1741,1.0,1784.0,86
2148,2050,1756,0.0,1903.0,294
2149,1716,1742,0.5,1729.0,-26
2150,1605,1760,0.0,1682.5,-155
2151,1838,2011,0.0,1924.5,-173
2152,2076,1713,1.0,1894.5,363
2153,1924,1627,1.0,1775.5,297
2154,1586,1915,0.5,1750.5,-329
2155,1943,1547,0.0,1745.0,396
2156,1967,2022,1.0,1994.5,-55
2157,1541,1914,1.0,1727.5,-373
2158,2055,1946,0.5,2000.5,109
2159,1796,1977,0.5,1886.5,-181
2160,2026,1657,1.0,1841.5,369
2161,1997,2159,0.0,2078.0,-162
2162,2132,1728,1.0,1930.0,404
2163,1952,2091,0.0,2021.5,-139
2164,2012,1808,1.0,1910.0,204
2165,2139,1798,1.0,1968.5,341
2166,1939,1992,1.0,1965.5,-53
2167,1640,1782,0.0,1711.0,-142
2168,1753,2040,0.0,1896.5,-287
2169,1675,2115,0.0,1895.0,-440
2170,1954,1482,1.0,1718.0,472
2171,1684,1933,0.0,1808.5,-249
2172,1533,1834,0.0,1683.5,-301
2173,2158,1988,0.5,2073.0,170
2174,1536,2009,0.0,1772.5,-473
2175,1947,1522,1.0,1734.5,425
2176,1542,2009,0.0,1775.5,-467
2177,1894,2015,0.5,1954.5,-121
2178,1593,1863,1.0,1728.0,-270
2179,2062,2035,0.0,2048.5,27
2180,1721,1709,0.0,1715.0,12
2181,1638,2005,1.0,1821.5,-367
2182,1688,1760,1.0,1724.0,-72
2183,1782,1646,0.5,1714.0,136
2184,1583,1694,1.0,1638.5,-111
2185,1789,1575,1.0,1682.0,214
2186,1647,1927,0.0,1787.0,-280
2187,2050,1772,1.0,1911.0,278
2188,1689,1746,1.0,1717.5,-57
2189,1594,1720,1.0,1657.0,-126
2190,1985,1631,1.0,1808.0,354
2191,1492,1797,0.0,1644.5,-305
2192,2294,1565,1.0,1929.5,729
2193,1995,2101,0.0,2048.0,-106
2194,1632,1994,0.0,1813.0,-362
2195,2078,1999,0.5,2038.5,79
2196,1794,1892,1.0,1843.0,-98
2197,1501,1761,0.5,1631.0,-260
2198,2530,1516,0.5,2023.0,1014
2199,2411,2442,1.0,2426.5,-31
2200,2524,2507,1.0,2515.5,17
2201,2253,2284,0.0,2268.5,-31
2202,2392,2489,0.5,2440.5,-97
2203,2317,2502,0.0,2409.5,-185
2204,2277,2304,0.0,2290.5,-27
2205,2313,2281,0.0,2297.0,32
2206,2457,2266,0.5,2361.5,191
2207,2412,2467,0.5,2439.5,-55
2208,2256,2336,0.0,2296.0,-80
2209,2375,2377,0.5,2376.0,-2
2210,2547,2237,0.5,2392.0,310
2211,2466,2542,0.5,2504.0,-76
2212,2458,2509,0.5,2483.5,-51
2213,2404,2433,0.5,2418.5,-29
2214,2251,2444,0.5,2347.5,-193
2215,2353,2280,0.5,2316.5,73
2216,2306,2315,0.5,2310.5,-9
2217,2222,2305,1.0,2263.5,-83
2218,2599,2203,0.5,2401.0,396
2219,2371,2503,0.0,2437.0,-132
2220,2528,2549,1.0,2538.5,-21
2221,2396,2379,0.0,2387.5,17
2222,2186,2449,0.5,2317.5,-263
2223,2385,2464,1.0,2424.5,-79
2224,2102,2156,0.0,2129.0,-54
2225,2302,2289,1.0,2295.5,13
2226,2393,1931,1.0,2162.0,462
2227,2467,2512,1.0,2489.5,-45
2228,2226,2212,1.0,2219.0,14
2229,2303,2356,0.0,2329.5,-53
2230,2606,2172,0.5,2389.0,434
2231,2174,2295,0.5,2234.5,-121
2232,2211,2240,0.5,2225.5,-29
2233,2266,2317,0.5,2291.5,-51
2234,2384,2048,0.5,2216.0,336
2235,2276,2259,1.0,2267.5,17
2236,2132,2163,0.0,2147.5,-31
2237,2241,2298,1.0,2269.5,-57
2238,2319,2109,0.0,2214.0,210
2239,2355,2422,0.5,2388.5,-67
2240,2036,2280,0.0,2158.0,-244
2241,2252,2276,1.0,2264.0,-24
2242,2285,1981,0.5,2133.0,304
2243,2311,2434,0.0,2372.5,-123
2244,2245,2324,1.0,2284.5,-79
2245,2146,2167,0.0,2156.5,-21
2246,2091,2208,0.0,2149.5,-117
2247,1991,2091,0.5,2041.0,-100
2248,1896,2043,0.0,1969.5,-147
2249,2022,2061,0.5,2041.5,-39
2250,2337,1782,1.0,2059.5,555
2251,2227,2211,1.0,2219.0,16
2252,2004,2181,1.0,2092.5,-177
2253,2057,2197,0.0,2127.0,-140
2254,2164,2097,1.0,2130.5,67
2255,1890,1981,0.0,1935.5,-91
2256,2014,2189,1.0,2101.5,-175
2257,1738,1843,0.5,1790.5,-105
2258,2368,2042,1.0,2205.0,326
2259,2267,2346,1.0,2306.5,-79
2260,2164,2351,0.0,2257.5,-187
2261,2165,2216,1.0,2190.5,-51
2262,2483,2095,1.0,2289.0,388
2263,2345,2344,0.5,2344.5,1
2264,2337,2356,1.0,2346.5,-19
2265,2296,2355,0.0,2325.5,-59
2266,2170,2380,0.0,2275.0,-210
2267,2178,2329,0.5,2253.5,-151
2268,2212,2253,0.0,2232.5,-41
2269,2143,2185,0.5,2164.0,-42
2270,2411,2181,1.0,2296.0,230
2271,2023,2220,0.0,2121.5,-197
2272,2305,2351,1.0,2328.0,-46
2273,1891,1949,0.0,1920.0,-58
2274,2342,2235,1.0,2288.5,107
2275,2297,2258,0.0,2277.5,39
2276,2130,2261,1.0,2195.5,-131
2277,2258,2185,0.0,2221.5,73
2278,2413,2057,0.5,2235.0,356
2279,2230,2235,0.0,2232.5,-5
2280,2030,2169,0.0,2099.5,-139
2281,1861,2235,0.0,2048.0,-374
2282,2341,1858,1.0,2099.5,483
2283,1881,1970,0.5,1925.5,-89
2284,1938,1974,0.5,1956.0,-36
2285,1942,1876,0.0,1909.0,66
2286,2254,2476,0.0,2365.0,-222
2287,2454,2120,1.0,2287.0,334
2288,2090,2338,0.5,2214.0,-248
2289,2203,2103,0.0,2153.0,100
2290,2520,1840,1.0,2180.0,680
2291,1889,2216,1.0,2052.5,-327
2292,2052,1949,0.5,2000.5,103
2293,1898,2053,0.0,1975.5,-155
2294,2002,2162,0.0,2082.0,-160
2295,2143,1952,1.0,2047.5,191
2296,1987,1818,0.5,1902.5,169
2297,2402,2008,1.0,2205.0,394
2298,2004,2204,0.0,2104.0,-200
2299,2352,2380,1.0,2366.0,-28
2300,2105,1990,0.0,2047.5,115
2301,2101,2372,1.0,2236.5,-271
2302,1910,1882,0.0,1896.0,28
2303,1808,1693,1.0,1750.5,115
2304,1778,1834,1.0,1806.0,-56
2305,2338,2022,0.5,2180.0,316
2306,1967,2327,0.0,2147.0,-360
2307,2239,1914,1.0,2076.5,325
2308,2159,2087,0.0,2123.0,72
2309,2033,2187,0.0,2110.0,-154
2310,2091,2132,1.0,2111.5,-41
2311,2006,1996,0.0,2001.0,10
2312,1993,1983,0.0,1988.0,10
2313,1978,2094,0.5,2036.0,-116
2314,1806,1845,0.5,1825.5,-39
2315,1655,1939,1.0,1797.0,-284
2316,2281,1801,0.5,2041.0,480
2317,2128,2346,1.0,2237.0,-218
2318,1886,1957,0.0,1921.5,-71
2319,1952,1998,1.0,1975.0,-46
2320,2103,1737,1.0,1920.0,366
2321,1997,1923,0.0,1960.0,74
2322,2088,2234,0.0,2161.0,-146
2323,1921,1927,0.5,1924.0,-6
2324,2313,2165,1.0,2239.0,148
2325,1911,2121,0.0,2016.0,-210
2326,2249,2237,1.0,2243.0,12
2327,1830,1819,0.0,1824.5,11
2328,2178,2218,0.0,2198.0,-40
2329,2040,2024,0.0,2032.0,16
2330,1927,2116,1.0,2021.5,-189
2331,2115,2061,0.0,2088.0,54
2332,2067,1841,0.0,1954.0,226
2333,2009,2158,0.0,2083.5,-149
2334,2036,2050,0.0,2043.0,-14
2335,2009,1947,1.0,1978.0,62
2336,2014,1990,1.0,2002.0,24
2337,1836,2015,0.0,1925.5,-179
2338,1993,2072,0.5,2032.5,-79
2339,1863,1894,0.5,1878.5,-31
2340,2214,1937,0.5,2075.5,277
2341,1742,2050,0.0,1896.0,-308
2342,2037,2179,1.0,2108.0,-142
2343,1604,1605,0.0,1604.5,-1
2344,2055,1968,1.0,2011.5,87
2345,2011,2174,0.0,2092.5,-163
2346,2026,1977,1.0,2001.5,49
2347,1634,2076,1.0,1855.0,-442
2348,1954,2070,0.5,2012.0,-116
2349,1547,1586,1.0,1566.5,-39
2350,1844,1933,1.0,1888.5,-89
2351,1949,1987,0.0,1968.0,-38
2352,1731,1786,1.0,1758.5,-55
2353,1916,2173,0.0,2044.5,-257
2354,2035,1810,0.5,1922.5,225
2355,1820,1755,0.0,1787.5,65
2356,1788,1654,1.0,1721.0,134
2357,1747,1794,0.0,1770.5,-47
2358,2171,2026,0.5,2098.5,145
2359,1763,1779,1.0,1771.0,-16
2360,1635,1597,0.0,1616.0,38
2361,1885,2062,1.0,1973.5,-177
2362,2005,2035,0.0,2020.0,-30
2363,1923,1924,1.0,1923.5,-1
2364,1915,1950,0.5,1932.5,-35
2365,1521,1546,1.0,1533.5,-25
2366,1482,1688,0.5,1585.0,-206
2367,1646,1684,1.0,1665.0,-38
2368,1533,1583,0.5,1558.0,-50
2369,1498,1520,1.0,1509.0,-22
2370,1818,1985,0.0,1901.5,-167
2371,1946,1762,1.0,1854.0,184
2372,1657,1796,1.0,1726.5,-139
2373,1707,1667,0.0,1687.0,40
2374,1682,1716,1.0,1699.0,-34
2375,1631,1713,0.5,1672.0,-82
2376,1988,1909,1.0,1948.5,79
2377,2023,1566,1.0,1794.5,457
2378,1522,1705,0.0,1613.5,-183
2379,1741,1542,1.0,1641.5,199
2380,2095,1997,0.5,2046.0,98
2381,1728,1841,0.0,1784.5,-113
2382,1673,1952,0.5,1812.5,-279
2383,1774,1730,0.5,1752.0,44
2384,1839,1927,0.0,1883.0,-88
2385,2050,1640,0.0,1845.0,410
2386,1806,1705,0.5,1755.5,101
2387,1638,1670,1.0,1654.0,-32
2388,1631,1594,0.5,1612.5,37
2389,1782,1825,1.0,1803.5,-43
2390,1528,1581,0.0,1554.5,-53
2391,1694,1789,0.0,1741.5,-95
2392,1772,1689,0.0,1730.5,83
2393,2139,2294,0.0,2216.5,-155
2394,1994,1992,0.0,1993.0,2
2395,1939,1837,0.5,1888.0,102
2396,1643,1782,0.0,1712.5,-139
2397,1999,2057,0.5,2028.0,-58
2398,1697,2078,0.0,1887.5,-381
2399,1797,1940,0.5,1868.5,-143
2400,1810,1501,1.0,1655.5,309
2401,2018,1904,0.5,1961.0,114
2402,2778,2696,0.5,2737.0,82
2403,2713,2770,1.0,2741.5,-57
2404,2837,2739,1.0,2788.0,98
2405,2739,2778,1.0,2758.5,-39
2406,2696,2713,1.0,2704.5,-17
2407,2732,2778,0.0,2755.0,-46
2408,2696,2739,0.0,2717.5,-43
2409,2713,2837,0.5,2775.0,-124
2410,2778,2713,1.0,2745.5,65
2411,2837,2696,0.5,2766.5,141
2412,2739,2732,1.0,2735.5,7
2413,2696,2732,1.0,2714.0,-36
2414,2778,2837,0.5,2807.5,-59
2415,2713,2739,0.5,2726.0,-26
2416,2732,2837,0.0,2784.5,-105
2417,2696,2778,0.5,2737.0,-82
2418,2732,2713,0.5,2722.5,19
2419,2739,2837,0.0,2788.0,-98
2420,2254,2686,0.0,2470.0,-432
2421,2684,2251,1.0,2467.5,433
2422,2125,2569,0.0,2347.0,-444
2423,2216,2646,0.5,2431.0,-430
2424,2147,2631,0.5,2389.0,-484
2425,2615,2141,1.0,2378.0,474
2426,2599,2133,1.0,2366.0,466
2427,2674,2239,1.0,2456.5,435
2428,2653,2218,1.0,2435.5,435
2429,2644,2214,1.0,2429.0,430
2430,2174,2642,0.0,2408.0,-468
2431,2642,2166,1.0,2404.0,476
2432,2165,2639,0.0,2402.0,-474
2433,2140,2605,0.0,2372.5,-465
2434,2133,2579,0.0,2356.0,-446
2435,2573,2131,1.0,2352.0,442
2436,2638,2150,1.0,2394.0,488
2437,2235,2663,0.5,2449.0,-428
2438,2698,2261,1.0,2479.5,437
2439,2251,2681,1.0,2466.0,-430
2440,2506,2698,0.5,2602.0,-192
2441,2686,2475,1.0,2580.5,211
2442,2449,2674,0.0,2561.5,-225
2443,2547,2296,1.0,2421.5,251
2444,2299,2559,0.0,2429.0,-260
2445,2553,2312,1.0,2432.5,241
2446,2569,2319,1.0,2444.0,250
2447,2478,2684,0.0,2581.0,-206
2448,2435,2644,0.5,2539.5,-209
2449,2329,2599,0.0,2464.0,-270
2450,2579,2355,0.5,2467.0,224
2451,2642,2428,0.5,2535.0,214
2452,2374,2615,0.0,2494.5,-241
2453,2639,2416,1.0,2527.5,223
2454,2315,2573,0.0,2444.0,-258
2455,2416,2642,0.5,2529.0,-226
2456,2446,2653,0.5,2549.5,-207
2457,2282,2548,0.5,2415.0,-266
2458,2408,2638,0.0,2523.0,-230
2459,2605,2375,1.0,2490.0,230
2460,2599,2686,0.5,2642.5,-87
2461,2684,2573,0.5,2628.5,111
2462,2674,2569,0.0,2621.5,105
2463,2559,2639,0.5,2599.0,-80
2464,2638,2553,1.0,2595.5,85
2465,2615,2547,0.5,2581.0,68
2466,2531,2605,0.0,2568.0,-74
2467,2512,2646,0.5,2579.0,-134
2468,2698,2485,1.0,2591.5,213
2469,2663,2446,1.0,2554.5,217
2470,2653,2435,1.0,2544.0,218
2471,2644,2417,1.0,2530.5,227
2472,2642,2282,1.0,2462.0,360
2473,2416,2642,0.0,2529.0,-226
2474,2428,2631,0.5,2529.5,-203
2475,2279,2579,0.0,2429.0,-300
2476,2548,2416,0.5,2482.0,132
2477,2355,2530,0.5,2442.5,-175
2478,2270,2506,0.0,2388.0,-236
2479,2488,2277,1.0,2382.5,211
2480,2547,2644,0.5,2595.5,-97
2481,2569,2698,0.5,2633.5,-129
2482,2686,2615,0.5,2650.5,71
2483,2579,2663,0.5,2621.0,-84
2484,2478,2251,1.0,2364.5,227
2485,2506,2642,0.5,2574.0,-136
2486,2573,2653,0.5,2613.0,-80
2487,2553,2355,0.5,2454.0,198
2488,2631,2375,1.0,2503.0,256
2489,2642,2559,1.0,2600.5,83
2490,2408,2548,0.0,2478.0,-140
2491,2599,2684,0.0,2641.5,-85
2492,2416,2674,0.0,2545.0,-258
2493,2605,2638,0.0,2621.5,-33
2494,2646,2416,1.0,2531.0,230
2495,2315,2488,0.5,2401.5,-173
2496,2681,2428,1.0,2554.5,253
2497,2329,2531,0.0,2430.0,-202
2498,2530,2319,1.0,2424.5,211
2499,2639,2512,1.0,2575.5,127
2500,2355,2485,0.5,2420.0,-130
2501,2644,2530,1.0,2587.0,114
2502,2674,2579,0.5,2626.5,95
2503,2484,2277,1.0,2380.5,207
2504,2684,2569,0.5,2626.5,115
2505,2416,2553,0.0,2484.5,-137
2506,2512,2315,1.0,2413.5,197
2507,2686,2639,0.5,2662.5,47
2508,2559,2435,0.0,2497.0,124
2509,2475,2631,0.5,2553.0,-156
2510,2615,2506,0.5,2560.5,109
2511,2446,2599,0.5,2522.5,-153
2512,2642,2478,1.0,2560.0,164
2513,2531,2646,0.0,2588.5,-115
2514,2663,2573,1.0,2618.0,90
2515,2488,2282,1.0,2385.0,206
2516,2698,2605,1.0,2651.5,93
2517,2653,2547,0.5,2600.0,106
2518,2638,2642,0.0,2640.0,-4
2519,2548,2681,0.5,2614.5,-133
2520,2435,2615,0.5,2525.0,-180
2521,2642,2684,0.5,2663.0,-42
2522,2569,2644,0.5,2606.5,-75
2523,2579,2484,1.0,2531.5,95
2524,2642,2698,0.5,2670.0,-56
2525,2605,2355,1.0,2480.0,250
2526,2530,2296,1.0,2413.0,234
2527,2478,2279,1.0,2378.5,199
2528,2646,2638,1.0,2642.0,8
2529,2573,2375,1.0,2474.0,198
2530,2681,2512,0.5,2596.5,169
2531,2631,2488,1.0,2559.5,143
2532,2416,2599,0.0,2507.5,-183
2533,2506,2653,0.0,2579.5,-147
2534,2251,2531,0.0,2391.0,-280
2535,2639,2663,0.5,2651.0,-24
2536,2553,2475,0.5,2514.0,78
2537,2547,2674,0.0,2610.5,-127
2538,2485,2319,0.5,2402.0,166
2539,2548,2686,0.5,2617.0,-138
2540,2674,2631,0.5,2652.5,43
2541,2663,2569,0.5,2616.0,94
2542,2644,2681,0.5,2662.5,-37
2543,2559,2417,1.0,2488.0,142
2544,2531,2686,0.0,2608.5,-155
2545,2475,2573,1.0,2524.0,-98
2546,2312,2485,1.0,2398.5,-173
2547,2698,2639,0.5,2668.5,59
2548,2638,2530,1.0,2584.0,108
2549,2416,2547,0.0,2481.5,-131
2550,2599,2435,1.0,2517.0,164
2551,2446,2553,1.0,2499.5,-107
2552,2642,2646,0.5,2644.0,-4
2553,2615,2478,1.0,2546.5,137
2554,2374,2506,0.0,2440.0,-132
2555,2251,2548,0.5,2399.5,-297
2556,2684,2642,1.0,2663.0,42
2557,2512,2605,0.5,2558.5,-93
2558,2653,2579,0.5,2616.0,74
2559,2488,2299,0.5,2393.5,189
2560,1648,1673,1.0,1660.5,-25
2561,2592,2377,0.5,2484.5,215
2562,2490,2411,0.5,2450.5,79
2563,2563,2586,0.5,2574.5,-23
2564,2415,2340,0.5,2377.5,75
2565,2575,2482,0.5,2528.5,93
2566,2378,2382,0.0,2380.0,-4
2567,2334,2386,0.5,2360.0,-52
2568,2292,2361,0.5,2326.5,-69
2569,2440,2289,0.0,2364.5,151
2570,2319,2170,0.0,2244.5,149
2571,2367,2632,0.0,2499.5,-265
2572,2230,2533,0.5,2381.5,-303
2573,2392,2509,0.0,2450.5,-117
2574,2583,2318,1.0,2450.5,265
2575,2339,2474,0.0,2406.5,-135
2576,2419,2357,1.0,2388.0,62
2577,2565,2400,1.0,2482.5,165
2578,2421,2234,1.0,2327.5,187
2579,2254,2179,0.0,2216.5,75
2580,2256,2118,1.0,2187.0,138
2581,2370,2566,0.0,2468.0,-196
2582,2572,2441,1.0,2506.5,131
2583,2400,2647,0.5,2523.5,-247
2584,2518,2436,1.0,2477.0,82
2585,2425,2384,0.5,2404.5,41
2586,2376,2317,0.5,2346.5,59
2587,2315,2261,0.5,2288.0,54
2588,2365,2302,0.5,2333.5,63
2589,2204,2187,1.0,2195.5,17
2590,2352,2168,0.5,2260.0,184
2591,2318,2211,1.0,2264.5,107
2592,2421,2464,1.0,2442.5,-43
2593,2541,2152,1.0,2346.5,389
2594,2451,2248,1.0,2349.5,203
2595,2298,2250,0.5,2274.0,48
2596,2372,2362,1.0,2367.0,10
2597,2314,2398,1.0,2356.0,-84
2598,2420,2491,0.5,2455.5,-71
2599,2506,2312,1.0,2409.0,194
2600,2316,2301,1.0,2308.5,15
2601,2102,2343,0.5,2222.5,-241
2602,2453,2336,0.5,2394.5,117
2603,2363,2444,0.0,2403.5,-81
2604,2398,2243,0.5,2320.5,155
2605,2323,2415,0.0,2369.0,-92
2606,2297,2119,1.0,2208.0,178
2607,2109,2146,1.0,2127.5,-37
2608,2317,2189,0.0,2253.0,128
2609,2109,2114,0.5,2111.5,-5
2610,2429,2235,0.5,2332.0,194
2611,2192,2101,1.0,2146.5,91
2612,2752,2834,0.5,2793.0,-82
2613,2680,2718,0.0,2699.0,-38
2614,2787,2768,1.0,2777.5,19
2615,2655,2767,0.5,2711.0,-112
2616,2753,2804,0.5,2778.5,-51
2617,2743,2640,1.0,2691.5,103
2618,2811,2792,0.5,2801.5,19
2619,2834,2787,0.5,2810.5,47
2620,2640,2752,0.5,2696.0,-112
2621,2792,2655,1.0,2723.5,137
2622,2718,2753,0.5,2735.5,-35
2623,2804,2811,1.0,2807.5,-7
2624,2768,2680,1.0,2724.0,88
2625,2767,2743,0.5,2755.0,24
2626,2768,2834,0.5,2801.0,-66
2627,2752,2767,0.5,2759.5,-15
2628,2680,2753,0.5,2716.5,-73
2629,2743,2792,0.0,2767.5,-49
2630,2655,2804,0.0,2729.5,-149
2631,2787,2640,0.5,2713.5,147
2632,2811,2718,0.5,2764.5,93
2633,2834,2680,1.0,2757.0,154
2634,2792,2752,0.5,2772.0,40
2635,2718,2655,0.5,2686.5,63
2636,2753,2811,1.0,2782.0,-58
2637,2804,2743,1.0,2773.5,61
2638,2767,2787,0.0,2777.0,-20
2639,2640,2768,0.5,2704.0,-128
2640,2834,2640,1.0,2737.0,194
2641,2752,2804,1.0,2778.0,-52
2642,2680,2811,0.0,2745.5,-131
2643,2768,2767,0.5,2767.5,1
2644,2787,2792,0.5,2789.5,-5
2645,2655,2753,0.5,2704.0,-98
2646,2743,2718,0.5,2730.5,25
2647,2652,2489,1.0,2570.5,163
2648,2640,2599,0.5,2619.5,41
2649,2622,2671,0.5,2646.5,-49
2650,2607,2634,0.5,2620.5,-27
2651,2718,2497,1.0,2607.5,221
2652,2481,2693,1.0,2587.0,-212
2653,2634,2629,0.5,2631.5,5
2654,2497,2481,0.5,2489.0,16
2655,2599,2634,1.0,2616.5,-35
2656,2489,2607,0.5,2548.0,-118
2657,2671,2640,0.5,2655.5,31
2658,2693,2622,1.0,2657.5,71
2659,2629,2652,0.0,2640.5,-23
2660,2634,2718,0.5,2676.0,-84
2661,2607,2718,0.5,2662.5,-111
2662,2652,2599,1.0,2625.5,53
2663,2640,2693,0.5,2666.5,-53
2664,2481,2634,0.5,2557.5,-153
2665,2634,2671,0.5,2652.5,-37
2666,2622,2497,0.5,2559.5,125
2667,2489,2629,0.5,2559.0,-140
2668,2634,2622,0.5,2628.0,12
2669,2599,2489,1.0,2544.0,110
2670,2718,2481,0.5,2599.5,237
2671,2629,2607,0.5,2618.0,22
2672,2497,2640,0.0,2568.5,-143
2673,2693,2634,0.5,2663.5,59
2674,2671,2652,0.5,2661.5,19
2675,2652,2693,0.0,2672.5,-41
2676,2629,2599,1.0,2614.0,30
2677,2634,2497,0.5,2565.5,137
2678,2607,2481,1.0,2544.0,126
2679,2489,2671,0.0,2580.0,-182
2680,2640,2634,0.5,2637.0,6
2681,2622,2718,0.0,2670.0,-96
2682,2149,2314,0.0,2231.5,-165
2683,2560,2556,0.5,2558.0,4
2684,2549,2582,0.5,2565.5,-33
2685,2556,2574,0.0,2565.0,-18
2686,2556,2574,0.0,2565.0,-18
2687,2582,2556,1.0,2569.0,26
2688,2560,2549,1.0,2554.5,11
2689,2549,2556,0.5,2552.5,-7
2690,2556,2560,0.0,2558.0,-4
2691,2574,2582,1.0,2578.0,-8
2692,2556,2582,0.5,2569.0,-26
2693,2560,2574,0.5,2567.0,-14
2694,2549,2556,0.5,2552.5,-7
2695,2571,2021,0.5,2296.0,550
2696,2809,2735,0.5,2772.0,74
2697,2728,2800,0.5,2764.0,-72
2698,2775,2724,0.0,2749.5,51
2699,2707,2761,0.5,2734.0,-54
2700,2749,2703,0.5,2726.0,46
2701,2694,2742,0.5,2718.0,-48
2702,2739,2666,1.0,2702.5,73
2703,2654,2737,0.0,2695.5,-83
2704,2736,2638,1.0,2687.0,98
2705,2724,2739,1.0,2731.5,-15
2706,2737,2736,0.5,2736.5,1
2707,2703,2809,0.0,2756.0,-106
2708,2800,2707,1.0,2753.5,93
2709,2761,2694,1.0,2727.5,67
2710,2735,2749,0.5,2742.0,-14
2711,2742,2728,0.5,2735.0,14
2712,2638,2775,0.0,2706.5,-137
2713,2666,2654,0.5,2660.0,12
2714,2809,2724,0.5,2766.5,85
2715,2737,2800,0.5,2768.5,-63
2716,2736,2761,0.5,2748.5,-25
2717,2775,2735,0.5,2755.0,40
2718,2749,2728,0.5,2738.5,21
2719,2739,2742,1.0,2740.5,-3
2720,2707,2666,0.5,2686.5,41
2721,2694,2703,0.0,2698.5,-9
2722,2654,2638,0.5,2646.0,16
2723,2724,2737,0.5,2730.5,-13
2724,2761,2809,0.5,2785.0,-48
2725,2800,2739,0.5,2769.5,61
2726,2749,2736,1.0,2742.5,13
2727,2728,2775,0.5,2751.5,-47
2728,2735,2703,0.5,2719.0,32
2729,2742,2666,1.0,2704.0,76
2730,2654,2707,0.5,2680.5,-53
2731,2638,2694,1.0,2666.0,-56
2732,2800,2724,0.5,2762.0,76
2733,2809,2749,0.5,2779.0,60
2734,2739,2761,0.0,2750.0,-22
2735,2737,2742,0.5,2739.5,-5
2736,2736,2735,0.5,2735.5,1
2737,2703,2728,0.5,2715.5,-25
2738,2775,2654,0.5,2714.5,121
2739,2707,2638,0.5,2672.5,69
2740,2666,2694,0.0,2680.0,-28
2741,2273,2066,1.0,2169.5,207
2742,2325,2595,0.0,2460.0,-270
2743,2548,2404,1.0,2476.0,144
2744,2492,2402,0.5,2447.0,90
2745,2571,2290,1.0,2430.5,281
2746,2344,2381,0.0,2362.5,-37
2747,2179,2417,0.0,2298.0,-238
2748,2309,2373,0.0,2341.0,-64
2749,2119,2193,0.5,2156.0,-74
2750,2368,2499,0.0,2433.5,-131
2751,2350,2404,1.0,2377.0,-54
2752,2493,2615,0.5,2554.0,-122
2753,2485,2402,0.0,2443.5,83
2754,2383,2367,1.0,2375.0,16
2755,2446,2384,0.5,2415.0,62
2756,2364,2325,0.0,2344.5,39
2757,2417,2286,0.0,2351.5,131
2758,2292,2296,0.5,2294.0,-4
2759,2338,2324,1.0,2331.0,14
2760,2674,2534,0.5,2604.0,140
2761,2551,2511,0.5,2531.0,40
2762,2467,2250,1.0,2358.5,217
2763,2506,2397,1.0,2451.5,109
2764,2578,2184,1.0,2381.0,394
2765,2283,2435,0.5,2359.0,-152
2766,2444,2287,1.0,2365.5,157
2767,2234,2202,1.0,2218.0,32
2768,2266,2053,1.0,2159.5,213
2769,2230,2347,1.0,2288.5,-117
2770,2352,2351,0.5,2351.5,1
2771,2363,2622,1.0,2492.5,-259
2772,2480,2371,0.0,2425.5,109
2773,2205,2514,0.0,2359.5,-309
2774,2297,2577,0.0,2437.0,-280
2775,2028,2386,0.0,2207.0,-358
2776,2454,2401,0.5,2427.5,53
2777,2245,2409,1.0,2327.0,-164
2778,1943,2405,0.0,2174.0,-462
2779,2402,2393,1.0,2397.5,9
2780,2374,2548,0.0,2461.0,-174
2781,2571,2368,0.0,2469.5,203
2782,2213,2381,0.5,2297.0,-168
2783,2417,1929,0.5,2173.0,488
2784,1986,2404,0.0,2195.0,-418
2785,2381,1939,0.5,2160.0,442
2786,2193,2202,1.0,2197.5,-9
2787,2350,2190,0.5,2270.0,160
2788,2404,2459,0.5,2431.5,-55
2789,2296,2626,1.0,2461.0,-330
2790,2290,2388,0.0,2339.0,-98
2791,2338,2615,0.5,2476.5,-277
2792,2373,2492,1.0,2432.5,-119
2793,2417,2325,1.0,2371.0,92
2794,2225,2325,0.5,2275.0,-100
2795,1969,2499,0.0,2234.0,-530
2796,2179,2119,0.0,2149.0,60
2797,2662,2723,0.5,2692.5,-61
2798,2437,2516,0.5,2476.5,-79
2799,2497,2441,0.5,2469.0,56
2800,2430,2476,1.0,2453.0,-46
2801,2316,2391,0.0,2353.5,-75
2802,2523,2387,0.5,2455.0,136
2803,2301,2402,0.5,2351.5,-101
2804,2401,2141,0.0,2271.0,260
2805,2122,2019,0.0,2070.5,103
2806,2450,2236,0.5,2343.0,214
2807,2144,2415,0.5,2279.5,-271
2808,2385,2216,1.0,2300.5,169
2809,2186,2292,0.0,2239.0,-106
2810,2371,2348,0.5,2359.5,23
2811,2264,2363,0.0,2313.5,-99
2812,2415,2018,1.0,2216.5,397
2813,2015,2340,0.0,2177.5,-325
2814,2307,2183,0.5,2245.0,124
2815,2134,2204,0.0,2169.0,-70
2816,2168,2055,1.0,2111.5,113
2817,2031,2117,1.0,2074.0,-86
2818,2441,2073,1.0,2257.0,368
2819,2133,2309,0.0,2221.0,-176
2820,2257,2167,1.0,2212.0,90
2821,1801,2156,0.0,1978.5,-355
2822,2391,2168,1.0,2279.5,223
2823,2161,2279,0.0,2220.0,-118
2824,2356,2106,1.0,2231.0,250
2825,2009,2255,0.5,2132.0,-246
2826,2424,2313,0.5,2368.5,111
2827,2236,2374,0.0,2305.0,-138
2828,2308,2193,1.0,2250.5,115
2829,2105,2257,0.0,2181.0,-152
2830,2128,2266,0.5,2197.0,-138
2831,2241,2085,1.0,2163.0,156
2832,2005,2182,0.5,2093.5,-177
2833,2143,1982,1.0,2062.5,161
2834,2379,2300,1.0,2339.5,79
2835,2300,2378,0.5,2339.0,-78
2836,2219,2121,0.5,2170.0,98
2837,2055,1996,1.0,2025.5,59
2838,2321,2237,1.0,2279.0,84
2839,2197,2334,0.5,2265.5,-137
2840,2147,2211,1.0,2179.0,-64
2841,2099,2290,0.0,2194.5,-191
2842,2452,2170,1.0,2311.0,282
2843,2153,2423,0.0,2288.0,-270
2844,2091,2051,1.0,2071.0,40
2845,1866,1878,0.5,1872.0,-12
2846,2093,2100,1.0,2096.5,-7
2847,2301,1967,1.0,2134.0,334
2848,1957,2089,1.0,2023.0,-132
2849,2252,1981,0.5,2116.5,271
2850,2307,2353,1.0,2330.0,-46
2851,2075,2188,0.0,2131.5,-113
2852,2301,2268,1.0,2284.5,33
2853,2118,1931,0.0,2024.5,187
2854,2332,2407,1.0,2369.5,-75
2855,2000,2107,0.5,2053.5,-107
2856,1985,2182,1.0,2083.5,-197
2857,2090,1670,0.5,1880.0,420
2858,2272,2352,1.0,2312.0,-80
2859,1925,2017,0.0,1971.0,-92
2860,2036,2176,0.5,2106.0,-140
2861,1768,1765,0.0,1766.5,3
2862,1846,1958,1.0,1902.0,-112
2863,1575,1559,1.0,1567.0,16
2864,1547,1625,0.0,1586.0,-78
2865,2047,1777,0.0,1912.0,270
2866,1947,2022,1.0,1984.5,-75
2867,1785,1949,1.0,1867.0,-164
2868,1399,1435,0.0,1417.0,-36
2869,1896,1559,0.0,1727.5,337
2870,1969,2109,1.0,2039.0,-140
2871,2031,1743,0.5,1887.0,288
2872,1947,1978,0.5,1962.5,-31
2873,1719,1688,0.0,1703.5,31
2874,2045,2108,1.0,2076.5,-63
2875,1891,1944,0.0,1917.5,-53
2876,1745,1923,1.0,1834.0,-178
2877,1749,1549,0.0,1649.0,200
2878,2032,2164,1.0,2098.0,-132
2879,1718,1833,1.0,1775.5,-115
2880,1751,1960,1.0,1855.5,-209
2881,1802,1623,0.0,1712.5,179
2882,1976,2058,0.5,2017.0,-82
2883,1782,1780,0.0,1781.0,2
2884,1511,1925,0.0,1718.0,-414
2885,1760,1487,0.0,1623.5,273
2886,2051,2138,0.5,2094.5,-87
2887,1712,1806,0.0,1759.0,-94
2888,1679,2026,0.0,1852.5,-347
2889,1529,1524,0.0,1526.5,5
2890,1649,2027,0.5,1838.0,-378
2891,1539,1584,0.0,1561.5,-45
2892,1803,1730,0.5,1766.5,73
2893,1231,1846,1.0,1538.5,-615
2894,2147,2335,0.5,2241.0,-188
2895,2249,2004,0.0,2126.5,245
2896,2104,2158,0.0,2131.0,-54
2897,2039,1962,0.0,2000.5,77
2898,1668,1990,0.0,1829.0,-322
2899,1901,1406,1.0,1653.5,495
2900,1319,1849,0.0,1584.0,-530
2901,1827,1248,1.0,1537.5,579
2902,2450,2437,0.5,2443.5,13
2903,2441,2415,0.5,2428.0,26
2904,2385,2391,0.0,2388.0,-6
2905,2238,2292,0.5,2265.0,-54
2906,2391,2371,1.0,2381.0,20
2907,2363,2279,1.0,2321.0,84
2908,2356,2415,0.0,2385.5,-59
2909,2340,2255,1.0,2297.5,85
2910,2307,2441,0.5,2374.0,-134
2911,2309,2204,1.0,2256.5,105
2912,2168,2363,0.5,2265.5,-195
2913,2156,2117,0.0,2136.5,39
2914,2516,2387,0.5,2451.5,129
2915,2301,2497,0.0,2399.0,-196
2916,2476,2141,1.0,2308.5,335
2917,2122,2316,1.0,2219.0,-194
2918,2307,2424,0.0,2365.5,-117
2919,2374,2266,1.0,2320.0,108
2920,2241,2308,0.5,2274.5,-67
2921,2257,2143,0.5,2200.0,114
2922,2353,2390,0.5,2371.5,-37
2923,2402,2307,0.0,2354.5,95
2924,2268,2401,1.0,2334.5,-133
2925,2019,2301,0.0,2160.0,-282
2926,2300,2321,1.0,2310.5,-21
2927,2334,2300,0.0,2317.0,34
2928,2121,2294,0.0,2207.5,-173
2929,2147,2055,0.5,2101.0,92
2930,2348,2452,0.0,2400.0,-104
2931,2423,2264,1.0,2343.5,159
2932,2018,2091,1.0,2054.5,-73
2933,2210,2015,1.0,2112.5,195
2934,2161,2379,1.0,2270.0,-218
2935,2378,2106,1.0,2242.0,272
2936,2087,2219,1.0,2153.0,-132
2937,1996,2009,0.5,2002.5,-13
2938,2236,2093,1.0,2164.5,143
2939,1967,2144,0.0,2055.5,-177
2940,2186,1957,1.0,2071.5,229
2941,1981,2054,0.0,2017.5,-73
2942,2352,2255,1.0,2303.5,97
2943,2073,2272,0.0,2172.5,-199
2944,2291,2167,0.0,2229.0,124
2945,1801,2176,0.0,1988.5,-375
2946,2183,2313,0.5,2248.0,-130
2947,2236,2134,1.0,2185.0,102
2948,2055,2193,0.5,2124.0,-138
2949,2105,2031,0.5,2068.0,74
2950,2128,1929,0.5,2028.5,199
2951,1768,2080,0.0,1924.0,-312
2952,2085,1575,1.0,1830.0,510
2953,1777,1982,1.0,1879.5,-205
2954,2109,2335,0.0,2222.0,-226
2955,2249,1969,1.0,2109.0,280
2956,1978,2214,0.5,2096.0,-236
2957,2158,1947,0.5,2052.5,211
2958,2138,2100,0.0,2119.0,38
2959,2301,2051,1.0,2176.0,250
2960,2026,2360,0.0,2193.0,-334
2961,2089,1679,1.0,1884.0,410
2962,2108,2027,1.0,2067.5,81
2963,1649,2045,0.0,1847.0,-396
2964,1923,1803,1.0,1863.0,120
2965,1560,1850,0.5,1705.0,-290
2966,2237,2164,0.0,2200.5,73
2967,2032,2197,0.5,2114.5,-165
2968,2211,1960,1.0,2085.5,251
2969,1751,1889,0.0,1820.0,-138
2970,2047,2252,0.0,2149.5,-205
2971,2188,1949,1.0,2068.5,239
2972,1785,2075,0.0,1930.0,-290
2973,2170,1559,0.5,1864.5,611
2974,1976,2058,0.5,2017.0,-82
2975,2051,2153,0.0,2102.0,-102
2976,1734,1925,0.0,1829.5,-191
2977,2022,1866,0.5,1944.0,156
2978,2107,2118,0.5,2112.5,-11
2979,1435,1947,0.0,1691.0,-512
2980,1670,2000,0.5,1835.0,-330
2981,1958,1399,0.5,1678.5,559
2982,2090,2370,0.5,2230.0,-280
2983,1765,1925,0.5,1845.0,-160
2984,1947,1547,0.5,1747.0,400
2985,1944,1719,0.0,1831.5,225
2986,1743,1896,1.0,1819.5,-153
2987,1469,1891,0.0,1680.0,-422
2988,1990,1688,1.0,1839.0,302
2989,1584,1529,0.5,1556.5,55
2990,1914,1901,1.0,1907.5,13
2991,1607,1539,0.5,1573.0,68
2992,1846,1849,0.0,1847.5,-3
2993,1806,1760,1.0,1783.0,46
2994,1524,1696,1.0,1610.0,-172
2995,1802,1162,0.0,1482.0,640
2996,1732,1749,0.5,1740.5,-17
2997,1782,1780,0.0,1781.0,2
2998,1718,1833,1.0,1775.5,-115
2999,2407,1487,1.0,1947.0,920
3000,2004,2147,0.0,2075.5,-143
3001,2182,2332,1.0,2257.0,-150
3002,1694,1962,0.0,1828.0,-268
3003,1424,1985,1.0,1704.5,-561
3004,1319,1406,0.5,1362.5,-87
3005,2371,1248,0.5,1809.5,1123
3006,2441,2437,0.0,2439.0,4
3007,2415,2363,1.0,2389.0,52
3008,2391,2430,1.0,2410.5,-39
3009,2441,2340,0.5,2390.5,101
3010,2497,2516,1.0,2506.5,-19
3011,2363,2309,0.0,2336.0,54
3012,2110,2476,0.0,2293.0,-366
3013,2424,2257,0.5,2340.5,167
3014,2204,2307,0.5,2255.5,-103
3015,2308,2374,1.0,2341.0,-66
3016,2117,2168,0.0,2142.5,-51
3017,2387,2383,0.5,2385.0,4
3018,2415,2450,1.0,2432.5,-35
3019,2141,2301,1.0,2221.0,-160
3020,2292,2385,0.5,2338.5,-93
3021,2452,2122,1.0,2287.0,330
3022,2161,2168,0.5,2164.5,-7
3023,2210,2423,1.0,2316.5,-213
3024,2009,2087,1.0,2048.0,-78
3025,2353,1878,1.0,2115.5,475
3026,2144,2236,0.5,2190.0,-92
3027,2268,2307,1.0,2287.5,-39
3028,2186,2216,0.5,2201.0,-30
3029,2407,2301,0.5,2354.0,106
3030,2279,2391,0.5,2335.0,-112
3031,2182,2332,0.5,2257.0,-150
3032,2255,2356,1.0,2305.5,-101
3033,2300,1985,0.0,2142.5,315
3034,2272,2352,1.0,2312.0,-80
3035,2121,2300,1.0,2210.5,-179
3036,2036,2176,0.5,2106.0,-140
3037,2313,2055,0.5,2184.0,258
3038,2241,2307,0.5,2274.0,-66
3039,2193,2236,0.5,2214.5,-43
3040,2143,2182,1.0,2162.5,-39
3041,2390,2105,1.0,2247.5,285
3042,2080,2128,0.0,2104.0,-48
3043,2401,2402,1.0,2401.5,-1
3044,2005,2085,0.0,2045.0,-80
3045,2321,2019,1.0,2170.0,302
3046,2188,2252,0.0,2220.0,-64
3047,2147,2294,0.5,2220.5,-147
3048,2100,2290,0.5,2195.0,-190
3049,2045,2108,0.5,2076.5,-63
3050,2360,2301,1.0,2330.5,59
3051,1745,1850,0.0,1797.5,-105
3052,2255,2089,1.0,2172.0,166
3053,2378,2379,0.5,2378.5,-1
3054,2167,2133,0.0,2150.0,34
3055,1996,2219,1.0,2107.5,-223
3056,2335,1801,1.0,2068.0,534
3057,2134,2183,0.0,2158.5,-49
3058,2214,2249,0.0,2231.5,-35
3059,2031,2055,0.0,2043.0,-24
3060,2118,2158,0.5,2138.0,-40
3061,2211,2237,0.5,2224.0,-26
3062,2000,2107,0.0,2053.5,-107
3063,1889,2099,1.0,1994.0,-210
3064,2093,1670,0.5,1881.5,423
3065,2153,2170,0.0,2161.5,-17
3066,1981,1957,1.0,1969.0,24
3067,1866,2051,0.5,1958.5,-185
3068,1929,1875,1.0,1902.0,54
3069,1969,2109,0.5,2039.0,-140
3070,1559,1768,0.0,1663.5,-209
3071,1695,1978,0.0,1836.5,-283
3072,2058,1575,1.0,1816.5,483
3073,1846,1958,0.5,1902.0,-112
3074,1925,1976,1.0,1950.5,-51
3075,1625,1511,1.0,1568.0,114
3076,2370,1947,1.0,2158.5,423
3077,1743,2090,0.0,1916.5,-347
3078,1925,2031,1.0,1978.0,-106
3079,1688,1765,1.0,1726.5,-77
3080,2164,2022,0.5,2093.0,142
3081,1947,2032,0.5,1989.5,-85
3082,1960,1435,1.0,1697.5,525
3083,1399,1751,0.0,1575.0,-352
3084,1806,2047,0.5,1926.5,-241
3085,1949,1696,1.0,1822.5,253
3086,1712,1785,0.0,1748.5,-73
3087,1749,1524,0.5,1636.5,225
3088,1901,1990,1.0,1945.5,-89
3089,1833,1732,1.0,1782.5,101
3090,1827,1914,0.0,1870.5,-87
3091,2027,1623,0.0,1825.0,404
3092,2051,2138,1.0,2094.5,-87
3093,1730,1649,0.0,1689.5,81
3094,1679,2026,1.0,1852.5,-347
3095,1529,1560,0.5,1544.5,-31
3096,1668,1424,1.0,1546.0,244
3097,1539,1584,0.0,1561.5,-45
3098,1719,1406,1.0,1562.5,313
3099,1231,1846,0.0,1538.5,-615
3100,1891,1944,1.0,1917.5,-53
3101,1162,1469,0.5,1315.5,-307
3102,2147,2348,0.0,2247.5,-201
3103,2264,2004,1.0,2134.0,260
3104,2104,2018,1.0,2061.0,86
3105,2015,1694,0.5,1854.5,321
3106,1780,1802,1.0,1791.0,-22
3107,1487,1782,1.0,1634.5,-295
3108,2516,2424,1.0,2470.0,92
3109,2374,2497,0.5,2435.5,-123
3110,2476,2308,1.0,2392.0,168
3111,2257,2316,0.0,2286.5,-59
3112,2352,2371,0.0,2361.5,-19
3113,2363,2272,1.0,2317.5,91
3114,2291,2415,0.0,2353.0,-124
3115,2340,2176,1.0,2258.0,164
3116,2437,2452,0.0,2444.5,-15
3117,2423,2441,0.0,2432.0,-18
3118,2430,2091,1.0,2260.5,339
3119,2210,2238,1.0,2224.0,-28
3120,2391,2353,0.5,2372.0,38
3121,2307,2279,0.5,2293.0,28
3122,2356,2268,0.5,2312.0,88
3123,2301,2255,0.0,2278.0,46
3124,2450,2441,1.0,2445.5,9
3125,2309,2415,0.5,2362.0,-106
3126,2385,2363,0.0,2374.0,22
3127,2257,2292,0.5,2274.5,-35
3128,2307,2390,0.0,2348.5,-83
3129,2402,2204,1.0,2303.0,198
3130,2168,2401,0.0,2284.5,-233
3131,2019,2117,0.5,2068.0,-98
3132,2307,2387,1.0,2347.0,-80
3133,2301,2266,1.0,2283.5,35
3134,2241,2141,1.0,2191.0,100
3135,2122,2182,0.0,2152.0,-60
3136,2348,2321,0.5,2334.5,27
3137,2294,2264,0.0,2279.0,30
3138,2018,2147,0.0,2082.5,-129
3139,2290,2015,1.0,2152.5,275
3140,2237,2100,0.5,2168.5,137
3141,2301,2197,0.5,2249.0,104
3142,2211,2360,0.5,2285.5,-149
3143,2089,2099,0.5,2094.0,-10
3144,2236,2407,0.0,2321.5,-171
3145,2332,2144,1.0,2238.0,188
3146,2216,2182,0.0,2199.0,34
3147,1985,2186,0.5,2085.5,-201
3148,2379,1967,0.5,2173.0,412
3149,1957,2378,0.5,2167.5,-421
3150,2219,1981,1.0,2100.0,238
3151,1875,1996,1.0,1935.5,-121
3152,2335,2300,0.5,2317.5,35
3153,2300,2249,0.5,2274.5,51
3154,2158,2121,0.0,2139.5,37
3155,2055,2039,0.5,2047.0,16
3156,2168,1929,1.0,2048.5,239
3157,1768,2106,0.5,1937.0,-338
3158,2087,1559,1.0,1823.0,528
3159,1777,2009,0.0,1893.0,-232
3160,2313,2058,1.0,2185.5,255
3161,1976,2236,0.0,2106.0,-260
3162,2193,1925,1.0,2059.0,268
3163,1734,1848,0.5,1791.0,-114
3164,2128,2370,0.5,2249.0,-242
3165,2017,2080,0.0,2048.5,-63
3166,2005,1925,0.0,1965.0,80
3167,1765,1982,1.0,1873.5,-217
3168,2108,2073,1.0,2090.5,35
3169,2133,2045,0.5,2089.0,88
3170,1923,2167,0.5,2045.0,-244
3171,1801,1745,0.5,1773.0,56
3172,2252,2164,0.0,2208.0,88
3173,2032,2075,0.5,2053.5,-43
3174,1931,1960,0.5,1945.5,-29
3175,2183,1732,1.0,1957.5,451
3176,1833,2134,0.5,1983.5,-301
3177,2055,1718,0.5,1886.5,337
3178,1623,2031,0.5,1827.0,-408
3179,2138,2118,1.0,2128.0,20
3180,2107,2051,0.0,2079.0,56
3181,2026,2057,1.0,2041.5,-31
3182,2000,1679,1.0,1839.5,321
3183,2170,2109,0.0,2139.5,61
3184,1969,2153,0.5,2061.0,-184
3185,2051,1978,1.0,2014.5,73
3186,1947,1866,0.5,1906.5,81
3187,1846,1947,1.0,1896.5,-101
3188,1625,2031,0.0,1828.0,-406
3189,1688,1547,1.0,1617.5,141
3190,1990,1760,0.5,1875.0,230
3191,1696,1901,1.0,1798.5,-205
3192,1914,1712,1.0,1813.0,202
3193,1524,1849,0.0,1686.5,-325
3194,2022,1719,1.0,1870.5,303
3195,1944,1947,0.0,1945.5,-3
3196,1435,1891,0.0,1663.0,-456
3197,1549,1399,0.5,1474.0,150
3198,1424,1802,0.0,1613.0,-378
3199,1780,1406,0.0,1593.0,374
3200,1319,1782,0.0,1550.5,-463
3201,1487,1248,0.5,1367.5,239
3202,1846,2027,0.0,1936.5,-181
3203,1730,1231,1.0,1480.5,499
3204,1560,1803,1.0,1681.5,-243
3205,2047,1162,1.0,1604.5,885
3206,2104,2147,1.0,2125.5,-43
3207,1785,1949,0.0,1867.0,-164
3208,1694,1962,0.0,1828.0,-268
3209,1584,1529,1.0,1556.5,55
3210,1607,1539,1.0,1573.0,68
3211,2516,2391,0.5,2453.5,125
3212,2279,2497,0.5,2388.0,-218
3213,2476,2356,1.0,2416.0,120
3214,2255,2316,0.5,2285.5,-61
3215,2371,2307,1.0,2339.0,64
3216,2241,2363,0.5,2302.0,-122
3217,2415,2182,1.0,2298.5,233
3218,2143,2340,0.0,2241.5,-197
3219,2390,2437,1.0,2413.5,-47
3220,2441,2402,0.5,2421.5,39
3221,2401,2430,0.0,2415.5,-29
3222,2391,2019,1.0,2205.0,372
3223,2374,2452,1.0,2413.0,-78
3224,2423,2308,1.0,2365.5,115
3225,2383,2091,0.5,2237.0,292
3226,2210,2257,0.5,2233.5,-47
3227,2321,2168,0.5,2244.5,153
3228,2161,2334,1.0,2247.5,-173
3229,2294,2087,1.0,2190.5,207
3230,2009,2147,0.5,2078.0,-138
3231,2407,2450,0.5,2428.5,-43
3232,2415,2332,0.5,2373.5,83
3233,2182,2385,0.0,2283.5,-203
3234,2292,1985,1.0,2138.5,307
3235,2300,2353,1.0,2326.5,-53
3236,2307,2300,0.5,2303.5,7
3237,2121,2268,1.0,2194.5,-147
3238,2301,2055,0.5,2178.0,246
3239,2441,2352,1.0,2396.5,89
3240,2272,2363,0.0,2317.5,-91
3241,2257,2291,0.5,2274.0,-34
3242,2176,2156,1.0,2166.0,20
3243,2100,2307,0.5,2203.5,-207
3244,2204,2301,1.0,2252.5,-97
3245,2360,2168,0.5,2264.0,192
3246,2117,2089,0.5,2103.0,28
3247,1967,2313,1.0,2140.0,-346
3248,2236,1957,1.0,2096.5,279
3249,1981,2193,0.0,2087.0,-212
3250,2105,1875,0.0,1990.0,230
3251,2370,2379,0.0,2374.5,-9
3252,2378,2090,0.5,2234.0,288
3253,2017,2219,0.0,2118.0,-202
3254,1996,1925,0.0,1960.5,71
3255,2387,2237,1.0,2312.0,150
3256,2197,2301,0.0,2249.0,-104
3257,2141,2211,0.5,2176.0,-70
3258,2099,2122,0.0,2110.5,-23
3259,2045,2335,0.5,2190.0,-290
3260,2249,1923,1.0,2086.0,326
3261,1850,2214,0.0,2032.0,-364
3262,2158,1745,1.0,1951.5,413
3263,2183,2236,0.0,2209.5,-53
3264,2144,2134,1.0,2139.0,10
3265,2055,2186,0.0,2120.5,-131
3266,2054,2031,1.0,2042.5,23
3267,2164,2348,0.0,2256.0,-184
3268,2264,2032,0.5,2148.0,232
3269,1960,2018,0.0,1989.0,-58
3270,2015,1751,0.5,1883.0,264
3271,2058,2128,0.0,2093.0,-70
3272,2080,1976,1.0,2028.0,104
3273,1925,2085,0.0,2005.0,-160
3274,1982,1511,1.0,1746.5,471
3275,1929,2047,0.0,1988.0,-118
3276,1949,1559,1.0,1754.0,390
3277,1559,1777,0.5,1668.0,-218
3278,1802,2252,0.0,2027.0,-450
3279,2188,1780,1.0,1984.0,408
3280,1782,2075,0.0,1928.5,-293
3281,1931,1487,1.0,1709.0,444
3282,2255,1749,1.0,2002.0,506
3283,1732,2073,0.0,1902.5,-341
3284,2133,1718,1.0,1925.5,415
3285,1623,2167,0.0,1895.0,-544
3286,1896,2170,1.0,2033.0,-274
3287,2153,1743,0.0,1948.0,410
3288,2031,2051,1.0,2041.0,-20
3289,1866,1688,1.0,1777.0,178
3290,2118,1958,0.0,2038.0,160
3291,2057,2107,1.0,2082.0,-50
3292,1547,1625,0.5,1586.0,-78
3293,2027,2000,0.5,2013.5,27
3294,1901,1990,1.0,1945.5,-89
3295,1803,1730,0.0,1766.5,73
3296,1849,1914,1.0,1881.5,-65
3297,2109,1560,0.5,1834.5,549
3298,1947,2022,1.0,1984.5,-75
3299,1978,1969,1.0,1973.5,9
3300,1399,1435,0.0,1417.0,-36
3301,1529,1947,0.0,1738.0,-418
3302,1806,1760,1.0,1783.0,46
3303,1539,1584,0.0,1561.5,-45
3304,1712,1696,0.5,1704.0,16
3305,1846,1607,0.5,1726.5,239
3306,1668,1424,1.0,1546.0,244
3307,1248,1319,1.0,1283.5,-71
3308,2147,1162,1.0,1654.5,985
3309,2051,2138,1.0,2094.5,-87
3310,2104,2004,1.0,2054.0,100
3311,1679,2026,1.0,1852.5,-347
3312,1944,1962,1.0,1953.0,-18
3313,1469,1891,0.0,1680.0,-422
3314,2450,1549,0.5,1999.5,901
3315,2363,2371,0.5,2367.0,-8
3316,2385,2415,1.0,2400.0,-30
3317,2340,2415,0.5,2377.5,-75
3318,2452,2292,1.0,2372.0,160
3319,2497,2516,1.0,2506.5,-19
3320,2091,2423,0.0,2257.0,-332
3321,2316,2476,1.0,2396.0,-160
3322,2437,2210,1.0,2323.5,227
3323,2374,2424,0.5,2399.0,-50
3324,2430,2441,1.0,2435.5,-11
3325,2383,2308,0.0,2345.5,75
3326,2391,2391,0.5,2391.0,0
3327,2309,2441,0.5,2375.0,-132
3328,2356,2279,0.5,2317.5,77
3329,2257,2363,0.5,2310.0,-106
3330,2390,2255,1.0,2322.5,135
3331,2300,2300,0.5,2300.0,0
3332,2401,2402,0.5,2401.5,-1
3333,2055,2121,1.0,2088.0,-66
3334,2379,2019,1.0,2199.0,360
3335,2294,2321,0.5,2307.5,-27
3336,2219,2378,0.0,2298.5,-159
3337,2290,2147,0.0,2218.5,143
3338,2307,1996,0.5,2151.5,311
3339,2204,2307,0.5,2255.5,-103
3340,2241,2266,0.0,2253.5,-25
3341,2117,2168,1.0,2142.5,-51
3342,2168,2143,0.0,2155.5,25
3343,2301,2387,1.0,2344.0,-86
3344,2106,2161,0.0,2133.5,-55
3345,2122,2141,1.0,2131.5,-19
3346,2348,2009,0.0,2178.5,339
3347,2332,2407,0.5,2369.5,-75
3348,2018,2264,1.0,2141.0,-246
3349,1985,2182,0.5,2083.5,-197
3350,2335,2015,1.0,2175.0,320
3351,1967,2093,1.0,2030.0,-126
3352,2214,2249,0.0,2231.5,-35
3353,1875,1957,0.5,1916.0,-82
3354,2352,2158,0.0,2255.0,194
3355,2144,2236,0.5,2190.0,-92
3356,2176,2272,1.0,2224.0,-96
3357,2186,2216,0.0,2201.0,-30
3358,2353,2036,0.0,2194.5,317
3359,2236,2313,1.0,2274.5,-77
3360,2268,2307,1.0,2287.5,-39
3361,1848,2193,0.0,2020.5,-345
3362,2128,2301,0.5,2214.5,-173
3363,2301,2100,1.0,2200.5,201
3364,2085,2080,0.0,2082.5,5
3365,2089,2360,1.0,2224.5,-271
3366,2047,2005,0.5,2026.0,42
3367,2090,2370,0.5,2230.0,-280
3368,1765,2017,0.5,1891.0,-252
3369,2237,1559,0.5,1898.0,678
3370,2051,2138,0.0,2094.5,-87
3371,2099,2197,0.0,2148.0,-98
3372,1679,2026,0.5,1852.5,-347
3373,2252,1889,1.0,2070.5,363
3374,2045,2108,0.5,2076.5,-63
3375,2075,2188,1.0,2131.5,-113
3376,1850,1923,0.0,1886.5,-73
3377,2255,1931,1.0,2093.0,324
3378,1896,1947,1.0,1921.5,-51
3379,2133,2073,1.0,2103.0,60
3380,2031,1743,1.0,1887.0,288
3381,2109,1801,0.0,1955.0,308
3382,2134,2183,1.0,2158.5,-49
3383,1978,1969,0.0,1973.5,9
3384,2031,2055,1.0,2043.0,-24
3385,1958,1695,0.0,1826.5,263
3386,2032,2164,1.0,2098.0,-132
3387,1751,1960,0.0,1855.5,-209
3388,2058,1625,1.0,1841.5,433
3389,2107,2118,1.0,2112.5,-11
3390,1925,1976,1.0,1950.5,-51
3391,2000,2057,1.0,2028.5,-57
3392,1749,1734,1.0,1741.5,15
3393,1559,1768,1.0,1663.5,-209
3394,1718,1732,0.5,1725.0,-14
3395,1777,1575,0.0,1676.0,202
3396,2170,1623,1.0,1896.5,547
3397,1730,2027,0.0,1878.5,-297
3398,2051,2153,1.0,2102.0,-102
3399,1560,1803,0.0,1681.5,-243
3400,2022,1866,1.0,1944.0,156
3401,1584,1529,0.0,1556.5,55
3402,1435,1947,1.0,1691.0,-512
3403,1607,1539,1.0,1573.0,68
3404,1424,1399,0.0,1411.5,25
3405,1944,1719,1.0,1831.5,225
3406,1319,1668,0.0,1493.5,-349
3407,1469,1891,0.0,1680.0,-422
3408,1760,1248,1.0,1504.0,512
3409,1696,1806,1.0,1751.0,-110
3410,1990,1712,0.0,1851.0,278
3411,2004,2147,0.5,2075.5,-143
3412,1914,1901,0.0,1907.5,13
3413,1962,2104,1.0,2033.0,-142
3414,1802,1827,1.0,1814.5,-25
3415,1231,1846,0.0,1538.5,-615
3416,1782,1780,1.0,1781.0,2
3417,1162,1487,0.0,1324.5,-325
3418,2234,2425,0.0,2329.5,-191
3419,2677,2650,0.5,2663.5,27
3420,2546,2555,1.0,2550.5,-9
3421,2534,2455,0.5,2494.5,79
3422,2536,2345,1.0,2440.5,191
3423,2523,2266,0.0,2394.5,257
3424,2340,2282,1.0,2311.0,58
3425,2340,2256,0.0,2298.0,84
3426,2157,2253,0.0,2205.0,-96
3427,2185,2187,0.5,2186.0,-2
3428,2292,2217,0.5,2254.5,75
3429,2171,1909,1.0,2040.0,262
3430,2779,2842,0.5,2810.5,-63
3431,2822,2766,0.5,2794.0,56
3432,2801,2780,1.0,2790.5,21
3433,2777,2768,0.5,2772.5,9
3434,2767,2773,1.0,2770.0,-6
3435,2822,2767,0.5,2794.5,55
3436,2766,2801,0.5,2783.5,-35
3437,2842,2773,1.0,2807.5,69
3438,2768,2779,0.5,2773.5,-11
3439,2780,2777,0.5,2778.5,3
3440,2195,1907,0.5,2051.0,288
3441,2717,2762,1.0,2739.5,-45
3442,2762,2717,1.0,2739.5,45
3443,2717,2762,0.0,2739.5,-45
3444,2762,2717,0.5,2739.5,45
3445,2727,2762,1.0,2744.5,-35
3446,2762,2727,0.0,2744.5,35
3447,2727,2762,0.0,2744.5,-35
3448,2762,2727,1.0,2744.5,35
3449,2762,2727,1.0,2744.5,35
3450,2727,2762,1.0,2744.5,-35
3451,2762,2727,0.0,2744.5,35
3452,2727,2762,0.0,2744.5,-35
3453,2762,2727,1.0,2744.5,35
3454,2727,2762,0.0,2744.5,-35
3455,2532,2438,0.0,2485.0,94
3456,2727,2666,0.0,2696.5,61
3457,2734,2732,0.0,2733.0,2
3458,2715,2757,1.0,2736.0,-42
3459,2667,2862,0.0,2764.5,-195
3460,2820,2762,0.5,2791.0,58
3461,2673,2784,0.5,2728.5,-111
3462,2797,2744,0.5,2770.5,53
3463,2757,2667,0.5,2712.0,90
3464,2744,2820,1.0,2782.0,-76
3465,2732,2715,0.5,2723.5,17
3466,2762,2673,0.5,2717.5,89
3467,2784,2727,1.0,2755.5,57
3468,2862,2797,1.0,2829.5,65
3469,2666,2734,0.0,2700.0,-68
3470,2667,2797,0.5,2732.0,-130
3471,2727,2762,0.0,2744.5,-35
3472,2715,2666,0.5,2690.5,49
3473,2820,2862,0.0,2841.0,-42
3474,2673,2744,0.5,2708.5,-71
3475,2734,2784,0.5,2759.0,-50
3476,2757,2732,1.0,2744.5,25
3477,2666,2757,0.0,2711.5,-91
3478,2732,2667,1.0,2699.5,65
3479,2744,2727,0.0,2735.5,17
3480,2862,2673,1.0,2767.5,189
3481,2784,2715,0.5,2749.5,69
3482,2762,2734,0.5,2748.0,28
3483,2797,2820,0.5,2808.5,-23
3484,2673,2797,0.5,2735.0,-124
3485,2732,2666,1.0,2699.0,66
3486,2715,2762,0.0,2738.5,-47
3487,2727,2862,0.0,2794.5,-135
3488,2757,2784,1.0,2770.5,-27
3489,2667,2820,0.0,2743.5,-153
3490,2734,2744,1.0,2739.0,-10
3491,2511,2608,1.0,2559.5,-97
3492,2517,2603,0.0,2560.0,-86
3493,2652,2593,0.5,2622.5,59
3494,2291,2729,0.0,2510.0,-438
3495,2675,2538,1.0,2606.5,137
3496,2352,2615,0.0,2483.5,-263
3497,2613,2563,1.0,2588.0,50
3498,2603,2613,0.0,2608.0,-10
3499,2615,2652,0.0,2633.5,-37
3500,2563,2352,1.0,2457.5,211
3501,2538,2511,0.0,2524.5,27
3502,2608,2517,1.0,2562.5,91
3503,2593,2291,1.0,2442.0,302
3504,2729,2675,0.5,2702.0,54
3505,2291,2615,0.0,2453.0,-324
3506,2729,2593,1.0,2661.0,136
3507,2675,2511,1.0,2593.0,164
3508,2652,2563,1.0,2607.5,89
3509,2352,2603,0.5,2477.5,-251
3510,2613,2608,0.5,2610.5,5
3511,2517,2538,1.0,2527.5,-21
3512,2593,2675,0.0,2634.0,-82
3513,2538,2613,1.0,2575.5,-75
3514,2603,2652,0.5,2627.5,-49
3515,2608,2352,1.0,2480.0,256
3516,2563,2291,1.0,2427.0,272
3517,2511,2517,1.0,2514.0,-6
3518,2615,2729,0.0,2672.0,-114
3519,2352,2538,1.0,2445.0,-186
3520,2291,2603,0.0,2447.0,-312
3521,2729,2563,1.0,2646.0,166
3522,2675,2517,1.0,2596.0,158
3523,2593,2615,0.0,2604.0,-22
3524,2652,2608,0.5,2630.0,44
3525,2613,2511,0.5,2562.0,102
3526,2684,2571,0.0,2627.5,113
3527,2188,2516,0.0,2352.0,-328
3528,2497,2075,1.0,2286.0,422
3529,1931,2316,0.5,2123.5,-385
3530,2523,2183,1.0,2353.0,340
3531,2134,2402,0.0,2268.0,-268
3532,2401,2055,1.0,2228.0,346
3533,2031,2019,0.0,2025.0,12
3534,2370,2437,0.0,2403.5,-67
3535,2441,2090,1.0,2265.5,351
3536,2017,2430,0.0,2223.5,-413
3537,2391,1925,1.0,2158.0,466
3538,2424,2128,0.0,2276.0,296
3539,2080,2374,0.0,2227.0,-294
3540,2308,2085,1.0,2196.5,223
3541,1982,2257,0.0,2119.5,-275
3542,2118,2450,0.0,2284.0,-332
3543,2415,2107,0.5,2261.0,308
3544,2057,2385,0.0,2221.0,-328
3545,2061,2000,0.5,2030.5,61
3546,2441,2170,1.0,2305.5,271
3547,2153,2363,0.0,2258.0,-210
3548,2257,2051,1.0,2154.0,206
3549,1866,2156,0.0,2011.0,-290
3550,2321,2109,1.0,2215.0,212
3551,1969,2334,0.0,2151.5,-365
3552,2294,1978,1.0,2136.0,316
3553,1947,2147,0.0,2047.0,-200
3554,2093,2307,0.0,2200.0,-214
3555,2268,1967,1.0,2117.5,301
3556,1957,2301,1.0,2129.0,-344
3557,1999,1981,0.5,1990.0,18
3558,2452,2108,1.0,2280.0,344
3559,2045,2091,1.0,2068.0,-46
3560,2210,1923,1.0,2066.5,287
3561,1850,1878,0.0,1864.0,-28
3562,2164,2352,0.5,2258.0,-188
3563,2272,2032,1.0,2152.0,240
3564,1960,2291,1.0,2125.5,-331
3565,2036,1751,1.0,1893.5,285
3566,2371,2138,1.0,2254.5,233
3567,2051,2363,0.0,2207.0,-312
3568,2415,2026,1.0,2220.5,389
3569,1679,1998,0.0,1838.5,-319
3570,2058,2307,0.0,2182.5,-249
3571,2266,1976,1.0,2121.0,290
3572,1925,2241,0.5,2083.0,-316
3573,2143,1734,1.0,1938.5,409
3574,2379,1990,1.0,2184.5,389
3575,1901,2378,0.0,2139.5,-477
3576,2219,1914,1.0,2066.5,305
3577,1849,1996,0.0,1922.5,-147
3578,1947,2335,0.0,2141.0,-388
3579,2249,1896,1.0,2072.5,353
3580,1743,2214,0.0,1978.5,-471
3581,2158,2031,1.0,2094.5,127
3582,2301,2047,1.0,2174.0,254
3583,1949,2141,1.0,2045.0,-192
3584,2122,1785,1.0,1953.5,337
3585,2027,2029,0.0,2028.0,-2
3586,2332,2407,1.0,2369.5,-75
3587,1730,1649,0.0,1689.5,81
3588,1985,2182,1.0,2083.5,-197
3589,2360,1803,1.0,2081.5,557
3590,1944,1719,0.0,1831.5,225
3591,2100,2301,1.0,2200.5,-201
3592,1469,1891,0.0,1680.0,-422
3593,1929,2089,1.0,2009.0,-160
3594,2236,2313,1.0,2274.5,-77
3595,1559,1768,0.0,1663.5,-209
3596,2105,2193,1.0,2149.0,-88
3597,2307,1575,1.0,1941.0,732
3598,1732,1749,0.0,1740.5,-17
3599,2168,2204,1.0,2186.0,-36
3600,1718,1833,0.0,1775.5,-115
3601,1958,2117,0.0,2037.5,-159
3602,2216,2144,1.0,2180.0,72
3603,2054,2186,1.0,2120.0,-132
3604,2300,1625,1.0,1962.5,675
3605,1806,1760,0.5,1783.0,46
3606,2121,2300,1.0,2210.5,-179
3607,1524,1712,0.0,1618.0,-188
3608,1802,2055,0.0,1928.5,-253
3609,2197,2237,1.0,2217.0,-40
3610,1782,1780,0.0,1781.0,2
3611,2099,2211,1.0,2155.0,-112
3612,2348,1487,1.0,1917.5,861
3613,1947,2022,0.0,1984.5,-75
3614,2018,2264,1.0,2141.0,-246
3615,1399,1435,0.0,1417.0,-36
3616,1529,2015,0.0,1772.0,-486
3617,2133,2255,1.0,2194.0,-122
3618,1539,1584,0.0,1561.5,-45
3619,1801,2167,0.5,1984.0,-366
3620,2168,1607,1.0,1887.5,561
3621,1231,1846,0.0,1538.5,-615
3622,2106,2161,1.0,2133.5,-55
3623,1162,2009,0.0,1585.5,-847
3624,2147,2391,0.5,2269.0,-244
3625,2279,2004,1.0,2141.5,275
3626,2104,2356,0.0,2230.0,-252
3627,2255,1962,1.0,2108.5,293
3628,2307,2523,1.0,2415.0,-216
3629,2402,2266,1.0,2334.0,136
3630,2182,2401,0.5,2291.5,-219
3631,2019,2143,1.0,2081.0,-124
3632,2437,2100,1.0,2268.5,337
3633,2301,2441,0.0,2371.0,-140
3634,2430,2360,1.0,2395.0,70
3635,2089,2238,1.0,2163.5,-149
3636,2407,2371,0.0,2389.0,36
3637,2363,2332,1.0,2347.5,31
3638,2182,2415,0.0,2298.5,-233
3639,2340,1985,1.0,2162.5,355
3640,2313,2309,1.0,2311.0,4
3641,2363,2236,1.0,2299.5,127
3642,2193,2257,0.5,2225.0,-64
3643,2156,2105,0.5,2130.5,51
3644,2236,2321,1.0,2278.5,-85
3645,2334,2144,0.0,2239.0,190
3646,2216,2294,0.0,2255.0,-78
3647,2290,2186,0.5,2238.0,104
3648,2497,2379,1.0,2438.0,118
3649,2378,2476,0.0,2427.0,-98
3650,2316,2219,1.0,2267.5,97
3651,1996,2110,1.0,2053.0,-114
3652,2335,2374,0.0,2354.5,-39
3653,2308,2249,1.0,2278.5,59
3654,2214,2383,0.0,2298.5,-169
3655,2257,2158,1.0,2207.5,99
3656,2450,2307,1.0,2378.5,143
3657,2204,2415,0.0,2309.5,-211
3658,2385,2168,1.0,2276.5,217
3659,2117,2292,0.0,2204.5,-175
3660,2237,2452,1.0,2344.5,-215
3661,2423,2197,1.0,2310.0,226
3662,2211,2210,0.5,2210.5,1
3663,1878,2099,0.0,1988.5,-221
3664,2353,2348,1.0,2350.5,5
3665,2264,2307,0.5,2285.5,-43
3666,2268,2018,1.0,2143.0,250
3667,2015,2301,0.0,2158.0,-286
3668,2352,2168,0.5,2260.0,184
3669,2161,2272,1.0,2216.5,-111
3670,2291,2106,0.0,2198.5,185
3671,2087,2176,0.0,2131.5,-89
3672,2391,2300,0.5,2345.5,91
3673,2300,2279,0.5,2289.5,21
3674,2356,2121,0.5,2238.5,235
3675,2055,2255,0.0,2155.0,-200
3676,2255,2387,0.5,2321.0,-132
3677,2301,2073,1.0,2187.0,228
3678,2167,2141,0.5,2154.0,26
3679,2122,1801,1.0,1961.5,321
3680,2047,1949,0.0,1998.0,98
3681,2022,2093,1.0,2057.5,-71
3682,1967,1947,1.0,1957.0,20
3683,1435,1981,0.0,1708.0,-546
3684,1875,1399,1.0,1637.0,476
3685,1424,2164,0.0,1794.0,-740
3686,2032,1668,1.0,1850.0,364
3687,1406,1960,0.0,1683.0,-554
3688,1751,1248,1.0,1499.5,503
3689,1990,2188,0.0,2089.0,-198
3690,2075,1901,0.5,1988.0,174
3691,1914,1931,0.0,1922.5,-17
3692,2128,1827,0.5,1977.5,301
3693,1649,2027,0.0,1838.0,-378
3694,2005,2080,1.0,2042.5,-75
3695,1560,1803,0.0,1681.5,-243
3696,1749,1982,0.0,1865.5,-233
3697,2107,2118,1.0,2112.5,-11
3698,1833,1732,0.5,1782.5,101
3699,2000,2057,1.0,2028.5,-57
3700,2045,1718,1.0,1881.5,327
3701,1780,1802,0.0,1791.0,-22
3702,1850,1923,1.0,1886.5,-73
3703,1487,1782,0.0,1634.5,-295
3704,2170,1745,1.0,1957.5,425
3705,1768,1929,0.0,1848.5,-161
3706,2051,2153,1.0,2102.0,-102
3707,1777,1559,0.0,1668.0,218
3708,1846,1866,0.0,1856.0,-20
3709,1976,2058,1.0,2017.0,-82
3710,1734,1925,1.0,1829.5,-191
3711,2138,1162,1.0,1650.0,976
3712,1584,1529,0.0,1556.5,55
3713,2026,2051,1.0,2038.5,-25
3714,1607,1539,0.5,1573.0,68
3715,2183,1679,1.0,1931.0,504
3716,1896,1947,0.0,1921.5,-51
3717,2055,2134,0.5,2094.5,-79
3718,1688,2031,0.0,1859.5,-343
3719,1719,2031,0.0,1875.0,-312
3720,2090,2370,0.0,2230.0,-280
3721,1891,1944,0.5,1917.5,-53
3722,1925,2017,1.0,1971.0,-92
3723,1760,1549,1.0,1654.5,211
3724,2004,2147,0.5,2075.5,-143
3725,1696,1806,0.0,1751.0,-110
3726,1694,2104,0.0,1899.0,-410
3727,2109,1524,0.5,1816.5,585
3728,1846,1958,0.5,1902.0,-112
3729,1978,1969,0.0,1973.5,9
3730,1547,1695,0.0,1621.0,-148
3731,2371,2516,0.0,2443.5,-145
3732,2497,2363,0.5,2430.0,134
3733,2415,2476,0.0,2445.5,-61
3734,2316,2340,0.5,2328.0,-24
3735,2424,2236,1.0,2330.0,188
3736,2144,2374,0.5,2259.0,-230
3737,2383,2216,0.0,2299.5,167
3738,2186,2257,0.5,2221.5,-71
3739,2168,2450,0.0,2309.0,-282
3740,2415,2161,0.5,2288.0,254
3741,2106,2385,0.0,2245.5,-279
3742,2292,2009,1.0,2150.5,283
3743,2353,2437,0.5,2395.0,-84
3744,2441,2307,0.5,2374.0,134
3745,2268,2430,0.0,2349.0,-162
3746,2391,2301,1.0,2346.0,90
3747,2523,2391,0.0,2457.0,132
3748,2279,2402,0.0,2340.5,-123
3749,2401,2356,0.5,2378.5,45
3750,2255,2019,1.0,2137.0,236
3751,2441,2237,0.5,2339.0,204
3752,2197,2309,0.5,2253.0,-112
3753,2363,2211,0.5,2287.0,152
3754,2099,2257,0.0,2178.0,-158
3755,2387,2313,0.0,2350.0,74
3756,2236,2301,0.5,2268.5,-65
3757,2141,2193,1.0,2167.0,-52
3758,2105,2122,0.0,2113.5,-17
3759,2321,2047,1.0,2184.0,274
3760,1949,2294,0.5,2121.5,-345
3761,2147,1785,1.0,1966.0,362
3762,2164,2290,0.0,2227.0,-126
3763,2073,2255,1.0,2164.0,-182
3764,1960,2032,1.0,1996.0,-72
3765,1801,2133,1.0,1967.0,-332
3766,2370,1751,0.5,2060.5,619
3767,2266,2307,1.0,2286.5,-41
3768,2017,2090,0.0,2053.5,-73
3769,2182,2241,1.0,2211.5,-59
3770,2300,1925,0.0,2112.5,375
3771,2051,2138,0.0,2094.5,-87
3772,2121,2300,1.0,2210.5,-179
3773,1679,2026,0.5,1852.5,-347
3774,2100,2055,0.5,2077.5,45
3775,2153,2170,0.5,2161.5,-17
3776,2360,2301,1.0,2330.5,59
3777,1866,2051,0.0,1958.5,-185
3778,2379,2089,1.0,2234.0,290
3779,2080,2128,0.0,2104.0,-48
3780,2219,2378,0.0,2298.5,-159
3781,2005,2085,1.0,2045.0,-80
3782,2307,1996,0.5,2151.5,311
3783,2045,2108,0.0,2076.5,-63
3784,2168,2204,1.0,2186.0,-36
3785,1745,1850,0.0,1797.5,-105
3786,2452,2117,1.0,2284.5,335
3787,2134,2183,0.5,2158.5,-49
3788,2091,2423,0.0,2257.0,-332
3789,2031,2055,1.0,2043.0,-24
3790,2118,2210,0.5,2164.0,-92
3791,2249,2335,1.0,2292.0,-86
3792,2057,2107,0.0,2082.0,-50
3793,2158,2214,1.0,2186.0,-56
3794,2348,2000,0.5,2174.0,348
3795,1696,1806,0.0,1751.0,-110
3796,2018,2264,0.0,2141.0,-246
3797,1524,1712,0.0,1618.0,-188
3798,2093,2015,0.0,2054.0,78
3799,2332,2407,1.0,2369.5,-75
3800,1957,1967,1.0,1962.0,-10
3801,1985,2182,0.5,2083.5,-197
3802,2188,1981,1.0,2084.5,207
3803,2272,2352,1.0,2312.0,-80
3804,1931,2075,0.5,2003.0,-144
3805,2176,2291,1.0,2233.5,-115
3806,2058,2109,1.0,2083.5,-51
3807,1969,1976,1.0,1972.5,-7
3808,1925,1978,0.0,1951.5,-53
3809,1695,1734,0.5,1714.5,-39
3810,1547,1625,1.0,1586.0,-78
3811,1529,1944,0.0,1736.5,-415
3812,1891,1584,1.0,1737.5,307
3813,1539,1469,0.0,1504.0,70
3814,1549,1607,0.5,1578.0,-58
3815,1929,1846,1.0,1887.5,83
3816,1231,1559,0.0,1395.0,-328
3817,1162,1777,0.0,1469.5,-615
3818,1947,2022,0.0,1984.5,-75
3819,1947,1896,1.0,1921.5,51
3820,1743,1435,1.0,1589.0,308
3821,1399,2031,0.0,1715.0,-632
3822,1802,1901,1.0,1851.5,-99
3823,1914,1780,1.0,1847.0,134
3824,1782,1849,0.5,1815.5,-67
3825,1827,1487,0.0,1657.0,340
3826,2147,1749,1.0,1948.0,398
3827,1732,2104,0.0,1918.0,-372
3828,1962,1833,1.0,1897.5,129
3829,1718,1694,0.5,1706.0,24
3830,2027,1424,1.0,1725.5,603
3831,1668,1649,1.0,1658.5,19
3832,1803,1406,1.0,1604.5,397
3833,1248,1560,0.0,1404.0,-312
3834,2516,2450,0.5,2483.0,66
3835,2415,2497,0.0,2456.0,-82
3836,2476,2385,1.0,2430.5,91
3837,2292,2316,1.0,2304.0,-24
3838,2437,2391,0.5,2414.0,46
3839,2279,2441,0.5,2360.0,-162
3840,2430,2356,1.0,2393.0,74
3841,2255,2391,0.5,2323.0,-136
3842,2387,2424,1.0,2405.5,-37
3843,2374,2301,0.5,2337.5,73
3844,2141,2308,0.0,2224.5,-167
3845,2383,2122,0.0,2252.5,261
3846,2236,2441,0.0,2338.5,-205
3847,2309,2144,0.0,2226.5,165
3848,2216,2363,0.0,2289.5,-147
3849,2156,2186,0.0,2171.0,-30
3850,2237,2371,0.5,2304.0,-134
3851,2363,2197,1.0,2280.0,166
3852,2211,2415,0.5,2313.0,-204
3853,2340,2099,1.0,2219.5,241
3854,2255,2334,1.0,2294.5,-79
3855,2294,2073,0.5,2183.5,221
3856,2133,2147,1.0,2140.0,-14
3857,2290,2167,1.0,2228.5,123
3858,2307,2300,0.0,2303.5,7
3859,2300,2241,0.5,2270.5,59
3860,2182,2121,0.5,2151.5,61
3861,2055,2143,0.0,2099.0,-88
3862,2100,2523,0.0,2311.5,-423
3863,2402,2301,1.0,2351.5,101
3864,2360,2401,0.5,2380.5,-41
3865,2019,2089,0.0,2054.0,-70
3866,2352,2307,0.5,2329.5,45
3867,2204,2272,1.0,2238.0,-68
3868,2291,2168,0.0,2229.5,123
3869,2117,2176,1.0,2146.5,-59
3870,2335,2348,0.5,2341.5,-13
3871,2264,2214,1.0,2239.0,50
3872,2158,2018,1.0,2088.0,140
3873,2015,2039,1.0,2027.0,-24
3874,2183,2353,1.0,2268.0,-170
3875,2307,2134,1.0,2220.5,173
3876,2055,2268,0.5,2161.5,-213
3877,1999,2031,0.0,2015.0,-32
3878,2407,2168,1.0,2287.5,239
3879,2161,2332,0.5,2246.5,-171
3880,2182,2106,0.0,2144.0,76
3881,2087,1985,1.0,2036.0,102
3882,2109,2379,0.0,2244.0,-270
3883,2378,1969,1.0,2173.5,409
3884,1978,2219,0.0,2098.5,-241
3885,1996,1947,0.5,1971.5,49
3886,2313,2047,1.0,2180.0,266
3887,1949,2236,0.0,2092.5,-287
3888,1559,1848,0.0,1703.5,-289
3889,1958,2080,0.5,2019.0,-122
3890,1625,2005,0.0,1815.0,-380
3891,1982,1547,1.0,1764.5,435
3892,2164,2452,0.0,2308.0,-288
3893,2423,2032,1.0,2227.5,391
3894,1960,2091,0.0,2025.5,-131
3895,2210,1751,1.0,1980.5,459
3896,2138,2188,0.0,2163.0,-50
3897,2075,2051,1.0,2063.0,24
3898,2026,1931,0.0,1978.5,95
3899,1760,1679,0.0,1719.5,81
3900,1967,2093,1.0,2030.0,-126
3901,1712,1696,0.0,1704.0,16
3902,1875,1957,0.5,1916.0,-82
3903,2058,1524,0.0,1791.0,534
3904,2017,2090,0.5,2053.5,-73
3905,1925,1976,0.0,1950.5,-51
3906,1765,1925,1.0,1845.0,-160
3907,2108,1511,0.5,1809.5,597
3908,1768,1929,0.5,1848.5,-161
3909,1850,1923,0.0,1886.5,-73
3910,1777,1575,1.0,1676.0,202
3911,2170,1745,1.0,1957.5,425
3912,1780,1802,0.5,1791.0,-22
3913,2051,2153,1.0,2102.0,-102
3914,1487,1782,0.0,1634.5,-295
3915,2027,1866,0.0,1946.5,161
3916,2107,2118,0.5,2112.5,-11
3917,1803,1730,0.0,1766.5,73
3918,1670,2000,1.0,1835.0,-330
3919,2022,1560,1.0,1791.0,462
3920,1435,1947,0.5,1691.0,-512
3921,1990,1399,0.5,1694.5,591
3922,1743,1947,1.0,1845.0,-204
3923,1849,1914,0.5,1881.5,-65
3924,1688,2031,1.0,1859.5,-343
3925,1846,1827,0.0,1836.5,19
3926,1584,1529,1.0,1556.5,55
3927,1607,1539,1.0,1573.0,68
3928,1719,1162,0.0,1440.5,557
3929,2104,2004,1.0,2054.0,100
3930,1891,1944,1.0,1917.5,-53
3931,1694,1962,1.0,1828.0,-268
3932,1732,1469,1.0,1600.5,263
3933,1668,1424,0.0,1546.0,244
3934,1718,1833,1.0,1775.5,-115
3935,1319,1406,0.0,1362.5,-87
3936,2119,2004,1.0,2061.5,115
3937,2537,2619,0.0,2578.0,-82
3938,2545,2420,1.0,2482.5,125
3939,2330,2590,0.0,2460.0,-260
3940,2382,2112,0.5,2247.0,270
3941,2231,2424,0.5,2327.5,-193
3942,2286,2360,0.0,2323.0,-74
3943,2395,2352,0.5,2373.5,43
3944,2392,2234,0.5,2313.0,158
3945,2315,2205,1.0,2260.0,110
3946,2311,2210,1.0,2260.5,101
3947,2147,2497,1.0,2322.0,-350
3948,2387,2523,0.5,2455.0,-136
3949,2379,2419,1.0,2399.0,-40
3950,2198,2425,0.5,2311.5,-227
3951,2378,2303,0.5,2340.5,75
3952,2129,2380,0.0,2254.5,-251
3953,2327,2313,0.0,2320.0,14
3954,2136,2324,0.0,2230.0,-188
3955,2368,2151,1.0,2259.5,217
3956,2337,2379,0.0,2358.0,-42
3957,2432,2423,1.0,2427.5,9
3958,2216,2209,1.0,2212.5,7
3959,2416,2330,1.0,2373.0,86
3960,2201,2305,1.0,2253.0,-104
3961,2216,2295,1.0,2255.5,-79
3962,2242,2107,1.0,2174.5,135
3963,2311,2333,0.0,2322.0,-22
3964,1924,2206,0.5,2065.0,-282
3965,2170,2139,0.5,2154.5,31
3966,2602,2397,0.0,2499.5,205
3967,2223,2204,1.0,2213.5,19
3968,2440,2414,0.0,2427.0,26
3969,2214,2457,0.5,2335.5,-243
3970,2347,2365,0.0,2356.0,-18
3971,2331,2461,0.0,2396.0,-130
3972,2455,2479,0.5,2467.0,-24
3973,2238,2363,0.0,2300.5,-125
3974,2371,2370,1.0,2370.5,1
3975,2786,2696,0.5,2741.0,90
3976,2452,2501,1.0,2476.5,-49
3977,2501,2452,0.5,2476.5,49
3978,2452,2491,0.5,2471.5,-39
3979,2491,2452,0.5,2471.5,39
3980,2452,2491,1.0,2471.5,-39
3981,2491,2452,1.0,2471.5,39
3982,2491,2452,0.5,2471.5,39
3983,2524,2589,0.0,2556.5,-65
3984,2452,2491,1.0,2471.5,-39
3985,1754,2097,0.0,1925.5,-343
3986,2406,2615,0.5,2510.5,-209
3987,2325,2363,1.0,2344.0,-38
3988,2577,2350,0.5,2463.5,227
3989,2499,2465,0.5,2482.0,34
3990,2401,2296,0.5,2348.5,105
3991,2351,2338,0.5,2344.5,13
3992,2367,2136,1.0,2251.5,231
3993,2205,1877,1.0,2041.0,328
3994,2280,1796,1.0,2038.0,484
3995,2585,2393,0.5,2489.0,192
3996,2592,2404,0.5,2498.0,188
3997,2368,2374,1.0,2371.0,-6
3998,2213,2493,0.0,2353.0,-280
3999,2402,2611,0.0,2506.5,-209
4000,2368,2286,0.5,2327.0,82
4001,2324,2538,0.5,2431.0,-214
4002,2362,2383,1.0,2372.5,-21
4003,2384,1984,1.0,2184.0,400
4004,2357,2364,0.5,2360.5,-7
4005,2578,2485,1.0,2531.5,93
4006,2409,2674,1.0,2541.5,-265
4007,2467,2496,0.5,2481.5,-29
4008,2381,2511,0.0,2446.0,-130
4009,2444,2311,1.0,2377.5,133
4010,2374,2397,0.5,2385.5,-23
4011,2319,2188,0.5,2253.5,131
4012,2391,2347,0.0,2369.0,44
4013,2435,2315,1.0,2375.0,120
4014,2247,2266,0.0,2256.5,-19
4015,2551,2595,0.0,2573.0,-44
4016,2548,2234,1.0,2391.0,314
4017,2184,2417,0.5,2300.5,-233
4018,2571,2534,0.5,2552.5,37
4019,2250,2381,1.0,2315.5,-131
4020,2402,2359,1.0,2380.5,43
4021,2506,2381,0.0,2443.5,125
4022,2404,2283,0.5,2343.5,121
4023,2230,2309,0.0,2269.5,-79
4024,2193,2287,1.0,2240.0,-94
4025,2349,2186,0.5,2267.5,163
4026,2757,2786,0.5,2771.5,-29
4027,2794,2780,0.5,2787.0,14
4028,2760,2762,1.0,2761.0,-2
4029,2790,2793,0.5,2791.5,-3
4030,2793,2757,0.5,2775.0,36
4031,2762,2790,0.5,2776.0,-28
4032,2780,2760,0.5,2770.0,20
4033,2786,2794,0.5,2790.0,-8
4034,2762,2757,1.0,2759.5,5
4035,2780,2793,0.5,2786.5,-13
4036,2786,2790,1.0,2788.0,-4
4037,2794,2760,0.5,2777.0,34
4038,2757,2794,0.5,2775.5,-37
4039,2760,2786,0.5,2773.0,-26
4040,2790,2780,1.0,2785.0,10
4041,2793,2762,0.5,2777.5,31
4042,2757,2760,0.5,2758.5,-3
4043,2794,2790,1.0,2792.0,4
4044,2786,2793,0.5,2789.5,-7
4045,2780,2762,0.5,2771.0,18
4046,2780,2757,0.5,2768.5,23
4047,2762,2786,1.0,2774.0,-24
4048,2793,2794,0.5,2793.5,-1
4049,2790,2760,0.5,2775.0,30
4050,1911,2133,0.0,2022.0,-222
4051,2420,2617,1.0,2518.5,-197
4052,2566,2316,0.5,2441.0,250
4053,2398,2518,0.0,2458.0,-120
4054,2384,2449,0.0,2416.5,-65
4055,2372,2376,0.0,2374.0,-4
4056,2261,2250,0.0,2255.5,11
4057,2294,2365,0.0,2329.5,-71
4058,2342,2312,1.0,2327.0,30
4059,2213,2187,0.0,2200.0,26
4060,2352,1890,1.0,2121.0,462
4061,2323,2544,0.0,2433.5,-221
4062,2170,2102,0.0,2136.0,68
4063,2243,2592,0.5,2417.5,-349
4064,2411,2363,0.0,2387.0,48
4065,2336,2259,0.0,2297.5,77
4066,2430,2264,1.0,2347.0,166
4067,2189,2382,1.0,2285.5,-193
4068,2440,2235,0.5,2337.5,205
4069,2109,2334,0.0,2221.5,-225
4070,2533,2616,0.5,2574.5,-83
4071,2586,2339,1.0,2462.5,247
4072,2420,2482,0.5,2451.0,-62
4073,2509,2318,0.5,2413.5,191
4074,2502,2490,0.5,2496.0,12
4075,2415,2357,0.5,2386.0,58
4076,2234,2378,0.5,2306.0,-144
4077,2118,2289,0.0,2203.5,-171
4078,2292,2054,0.5,2173.0,238
4079,2491,2400,1.0,2445.5,91
4080,2632,2580,1.0,2606.0,52
4081,2314,2179,1.0,2246.5,135
4082,2583,2432,0.5,2507.5,151
4083,2506,2474,0.5,2490.0,32
4084,2421,2464,0.5,2442.5,-43
4085,2407,2509,1.0,2458.0,-102
4086,2202,2248,0.0,2225.0,-46
4087,2301,2230,0.5,2265.5,71
4088,2256,2362,0.5,2309.0,-106
4089,2436,2444,0.5,2440.0,-8
4090,2606,2400,1.0,2503.0,206
4091,2302,2398,0.0,2350.0,-96
4092,2343,2441,0.0,2392.0,-98
4093,2317,2415,1.0,2366.0,-98
4094,2317,2425,1.0,2371.0,-108
4095,2315,2510,0.0,2412.5,-195
4096,2229,2370,0.5,2299.5,-141
4097,2429,2453,1.0,2441.0,-24
4098,1730,2000,0.0,1865.0,-270
4099,2767,2834,0.5,2800.5,-67
4100,2718,2752,0.0,2735.0,-34
4101,2640,2680,0.5,2660.0,-40
4102,2792,2768,0.5,2780.0,24
4103,2804,2787,0.5,2795.5,17
4104,2753,2743,0.5,2748.0,10
4105,2811,2655,0.5,2733.0,156
4106,2834,2792,1.0,2813.0,42
4107,2752,2753,0.5,2752.5,-1
4108,2768,2804,0.0,2786.0,-36
4109,2787,2718,1.0,2752.5,69
4110,2640,2767,0.0,2703.5,-127
4111,2743,2811,0.5,2777.0,-68
4112,2680,2655,0.5,2667.5,25
4113,2804,2834,0.5,2819.0,-30
4114,2811,2752,0.5,2781.5,59
4115,2753,2787,1.0,2770.0,-34
4116,2767,2680,1.0,2723.5,87
4117,2655,2743,0.5,2699.0,-88
4118,2718,2768,0.5,2743.0,-50
4119,2792,2640,1.0,2716.0,152
4120,2834,2718,1.0,2776.0,116
4121,2752,2655,1.0,2703.5,97
4122,2640,2804,0.5,2722.0,-164
4123,2767,2792,0.5,2779.5,-25
4124,2787,2811,1.0,2799.0,-24
4125,2768,2753,0.5,2760.5,15
4126,2680,2743,0.5,2711.5,-63
4127,2753,2834,0.5,2793.5,-81
4128,2743,2752,0.5,2747.5,-9
4129,2804,2767,0.5,2785.5,37
4130,2655,2787,0.0,2721.0,-132
4131,2811,2768,0.5,2789.5,43
4132,2718,2640,0.5,2679.0,78
4133,2792,2680,1.0,2736.0,112
4134,2834,2752,1.0,2793.0,82
4135,2752,2834,0.5,2793.0,-82
4136,2693,2489,1.0,2591.0,204
4137,2599,2607,0.5,2603.0,-8
4138,2671,2629,0.0,2650.0,42
4139,2497,2652,0.5,2574.5,-155
4140,2481,2622,0.0,2551.5,-141
4141,2718,2640,0.5,2679.0,78
4142,2634,2634,0.0,2634.0,0
4143,2640,2481,1.0,2560.5,159
4144,2599,2671,0.5,2635.0,-72
4145,2489,2497,0.5,2493.0,-8
4146,2634,2718,0.5,2676.0,-84
4147,2652,2634,0.5,2643.0,18
4148,2629,2693,0.5,2661.0,-64
4149,2607,2622,0.0,2614.5,-15
4150,2671,2607,0.5,2639.0,64
4151,2693,2599,0.5,2646.0,94
4152,2481,2634,0.0,2557.5,-153
4153,2718,2652,0.5,2685.0,66
4154,2497,2629,0.0,2563.0,-132
4155,2622,2640,0.5,2631.0,-18
4156,2634,2489,0.5,2561.5,145
4157,2634,2622,0.5,2628.0,12
4158,2599,2497,0.5,2548.0,102
4159,2629,2634,0.5,2631.5,-5
4160,2671,2693,0.0,2682.0,-22
4161,2652,2481,0.5,2566.5,171
4162,2489,2718,0.0,2603.5,-229
4163,2607,2640,0.5,2623.5,-33
4164,2718,2629,0.5,2673.5,89
4165,2634,2599,0.5,2616.5,35
4166,2622,2652,1.0,2637.0,-30
4167,2497,2671,0.5,2584.0,-174
4168,2693,2607,0.5,2650.0,86
4169,2640,2634,0.0,2637.0,6
4170,2481,2489,1.0,2485.0,-8
4171,2098,2223,0.5,2160.5,-125
4172,2527,2474,0.5,2500.5,53
4173,2486,2340,1.0,2413.0,146
4174,2341,2263,1.0,2302.0,78
4175,2318,2552,0.5,2435.0,-234
4176,2489,2397,0.5,2443.0,92
4177,2288,2289,0.5,2288.5,-1
4178,2272,2244,1.0,2258.0,28
4179,2308,2248,1.0,2278.0,60
4180,2206,2015,0.0,2110.5,191
4181,2590,2497,1.0,2543.5,93
4182,2422,2410,1.0,2416.0,12
4183,2449,2485,0.0,2467.0,-36
4184,2347,2346,1.0,2346.5,1
4185,2477,2339,0.0,2408.0,138
4186,2341,2301,1.0,2321.0,40
4187,2273,2147,1.0,2210.0,126
4188,2295,2416,0.0,2355.5,-121
4189,2233,2201,0.5,2217.0,32
4190,2339,2552,0.0,2445.5,-213
4191,2485,2661,0.0,2573.0,-176
4192,2448,2607,0.5,2527.5,-159
4193,2339,2586,0.0,2462.5,-247
4194,2279,2440,1.0,2359.5,-161
4195,2422,2473,0.0,2447.5,-51
4196,2325,2295,1.0,2310.0,30
4197,2347,2443,0.0,2395.0,-96
4198,2177,2201,0.5,2189.0,-24
4199,2147,2300,0.0,2223.5,-153
4200,2207,1993,1.0,2100.0,214
4201,2598,2294,0.0,2446.0,304
4202,2582,2437,0.5,2509.5,145
4203,2446,2396,0.5,2421.0,50
4204,2428,2408,0.5,2418.0,20
4205,2402,2399,1.0,2400.5,3
4206,2403,2446,0.5,2424.5,-43
4207,2400,2387,0.0,2393.5,13
4208,2279,2342,0.0,2310.5,-63
4209,2408,2288,0.5,2348.0,120
4210,2336,2462,0.0,2399.0,-126
4211,2620,2410,0.5,2515.0,210
4212,2449,2526,0.5,2487.5,-77
4213,2516,2651,0.0,2583.5,-135
4214,2371,2405,0.0,2388.0,-34
4215,2380,2346,1.0,2363.0,34
4216,2416,2359,0.5,2387.5,57
4217,2366,2301,0.5,2333.5,65
4218,2348,2273,0.0,2310.5,75
4219,2291,2253,0.5,2272.0,38
4220,2474,2607,0.5,2540.5,-133
4221,2497,2383,1.0,2440.0,114
4222,2397,2485,0.5,2441.0,-88
4223,2339,2486,0.5,2412.5,-147
4224,2322,2422,0.5,2372.0,-100
4225,2440,2308,1.0,2374.0,132
4226,2295,2318,0.5,2306.5,-23
4227,2369,2147,1.0,2258.0,222
4228,2201,2263,0.0,2232.0,-62
4229,1738,1715,0.0,1726.5,23
4230,2844,2744,1.0,2794.0,100
4231,2760,2798,0.5,2779.0,-38
4232,2706,2730,1.0,2718.0,-24
4233,2640,2773,0.5,2706.5,-133
4234,2787,2769,0.5,2778.0,18
4235,2747,2766,0.5,2756.5,-19
4236,2728,2673,0.5,2700.5,55
4237,2798,2844,0.5,2821.0,-46
4238,2787,2706,1.0,2746.5,81
4239,2773,2728,0.5,2750.5,45
4240,2766,2640,0.5,2703.0,126
4241,2769,2744,0.0,2756.5,25
4242,2673,2760,0.0,2716.5,-87
4243,2730,2747,0.5,2738.5,-17
4244,2844,2673,1.0,2758.5,171
4245,2744,2798,0.5,2771.0,-54
4246,2640,2730,0.5,2685.0,-90
4247,2760,2773,0.5,2766.5,-13
4248,2747,2787,0.5,2767.0,-40
4249,2728,2766,0.0,2747.0,-38
4250,2706,2769,0.5,2737.5,-63
4251,2773,2844,0.5,2808.5,-71
4252,2787,2640,1.0,2713.5,147
4253,2673,2744,0.5,2708.5,-71
4254,2706,2747,0.5,2726.5,-41
4255,2766,2760,1.0,2763.0,6
4256,2769,2798,0.5,2783.5,-29
4257,2730,2728,0.5,2729.0,2
4258,2844,2766,0.5,2805.0,78
4259,2798,2673,0.5,2735.5,125
4260,2760,2730,1.0,2745.0,30
4261,2640,2706,0.5,2673.0,-66
4262,2728,2787,1.0,2757.5,-59
4263,2747,2769,0.5,2758.0,-22
4264,2744,2773,0.5,2758.5,-29
4265,2578,2391,1.0,2484.5,187
4266,2653,2627,0.5,2640.0,26
4267,2679,2644,0.5,2661.5,35
4268,2653,2541,0.0,2597.0,112
4269,2485,2567,0.0,2526.0,-82
4270,2441,2607,0.0,2524.0,-166
4271,2556,2548,1.0,2552.0,8
4272,2541,2607,1.0,2574.0,-66
4273,2548,2441,1.0,2494.5,107
4274,2653,2653,1.0,2653.0,0
4275,2391,2556,0.0,2473.5,-165
4276,2627,2679,0.5,2653.0,-52
4277,2644,2485,1.0,2564.5,159
4278,2567,2578,0.0,2572.5,-11
4279,2485,2627,0.5,2556.0,-142
4280,2679,2653,0.5,2666.0,26
4281,2441,2391,1.0,2416.0,50
4282,2653,2541,1.0,2597.0,112
4283,2578,2644,0.0,2611.0,-66
4284,2556,2567,0.5,2561.5,-11
4285,2607,2548,1.0,2577.5,59
4286,2567,2441,1.0,2504.0,126
4287,2644,2556,0.5,2600.0,88
4288,2541,2548,0.0,2544.5,-7
4289,2653,2485,0.5,2569.0,168
4290,2391,2607,0.0,2499.0,-216
4291,2653,2679,0.5,2666.0,-26
4292,2627,2578,1.0,2602.5,49
4293,2548,2391,1.0,2469.5,157
4294,2679,2541,0.5,2610.0,138
4295,2485,2653,0.0,2569.0,-168
4296,2441,2644,0.5,2542.5,-203
4297,2578,2653,0.5,2615.5,-75
4298,2556,2627,0.5,2591.5,-71
4299,2607,2567,0.5,2587.0,40
4300,2336,2394,0.0,2365.0,-58
4301,2518,2374,1.0,2446.0,144
4302,2463,2310,0.5,2386.5,153
4303,2332,2357,1.0,2344.5,-25
4304,2360,2389,0.0,2374.5,-29
4305,2394,2332,0.0,2363.0,62
4306,2389,2310,0.5,2349.5,79
4307,2374,2336,1.0,2355.0,38
4308,2360,2518,0.5,2439.0,-158
4309,2357,2463,0.5,2410.0,-106
4310,2332,2374,0.5,2353.0,-42
4311,2518,2389,1.0,2453.5,129
4312,2463,2394,1.0,2428.5,69
4313,2310,2357,0.0,2333.5,-47
4314,2336,2360,1.0,2348.0,-24
4315,2394,2310,0.5,2352.0,84
4316,2374,2463,1.0,2418.5,-89
4317,2518,2336,1.0,2427.0,182
4318,2389,2357,0.0,2373.0,32
4319,2360,2332,1.0,2346.0,28
4320,2357,2394,0.0,2375.5,-37
4321,2463,2360,1.0,2411.5,103
4322,2336,2389,1.0,2362.5,-53
4323,2310,2374,0.5,2342.0,-64
4324,2332,2518,0.0,2425.0,-186
4325,2374,2357,0.5,2365.5,17
4326,2389,2394,0.0,2391.5,-5
4327,2360,2310,0.0,2335.0,50
4328,2336,2332,1.0,2334.0,4
4329,2518,2463,1.0,2490.5,55
4330,2310,2518,1.0,2414.0,-208
4331,2332,2389,0.0,2360.5,-57
4332,2463,2336,1.0,2399.5,127
4333,2394,2374,0.5,2384.0,20
4334,2357,2360,0.5,2358.5,-3
4335,2336,2310,1.0,2323.0,26
4336,2518,2357,1.0,2437.5,161
4337,2389,2374,0.0,2381.5,15
4338,2332,2463,0.5,2397.5,-131
4339,2360,2394,0.0,2377.0,-34
4340,2310,2332,0.5,2321.0,-22
4341,2394,2518,1.0,2456.0,-124
4342,2374,2360,1.0,2367.0,14
4343,2463,2389,0.5,2426.0,74
4344,2357,2336,1.0,2346.5,21
4345,1949,2078,0.0,2013.5,-129
4346,2793,2810,0.5,2801.5,-17
4347,2809,2747,0.5,2778.0,62
4348,2740,2757,0.5,2748.5,-17
4349,2872,2764,1.0,2818.0,108
4350,2757,2872,0.5,2814.5,-115
4351,2747,2740,0.5,2743.5,7
4352,2810,2809,0.5,2809.5,1
4353,2764,2793,0.5,2778.5,-29
4354,2793,2809,0.0,2801.0,-16
4355,2747,2872,0.0,2809.5,-125
4356,2810,2757,0.5,2783.5,53
4357,2764,2740,0.5,2752.0,24
4358,2740,2810,0.5,2775.0,-70
4359,2757,2747,0.5,2752.0,10
4360,2872,2793,0.5,2832.5,79
4361,2809,2764,0.5,2786.5,45
4362,2793,2740,0.0,2766.5,53
4363,2764,2757,1.0,2760.5,7
4364,2810,2747,1.0,2778.5,63
4365,2872,2809,0.5,2840.5,63
4366,2810,2872,0.5,2841.0,-62
4367,2747,2764,0.5,2755.5,-17
4368,2757,2793,1.0,2775.0,-36
4369,2740,2809,1.0,2774.5,-69
4370,2218,2181,0.5,2199.5,37
4371,2264,2301,0.5,2282.5,-37
4372,2491,2363,1.0,2427.0,128
4373,2323,2541,0.0,2432.0,-218
4374,2314,2109,1.0,2211.5,205
4375,2298,2362,1.0,2330.0,-64
4376,2109,2298,0.5,2203.5,-189
4377,2203,2235,0.5,2219.0,-32
4378,2201,2248,1.0,2224.5,-47
4379,2646,1975,1.0,2310.5,671
4380,2411,2170,1.0,2290.5,241
4381,2420,2533,1.0,2476.5,-113
4382,2592,2361,1.0,2476.5,231
4383,2367,2502,0.5,2434.5,-135
4384,2318,2340,0.5,2329.0,-22
4385,2318,2016,0.5,2167.0,302
4386,2259,2382,0.0,2320.5,-123
4387,2118,2357,0.5,2237.5,-239
4388,2215,2334,0.5,2274.5,-119
4389,2647,2234,0.0,2440.5,413
4390,2583,2632,0.0,2607.5,-49
4391,2518,2614,1.0,2566.0,-96
4392,2421,2509,0.0,2465.0,-88
4393,2617,2566,0.5,2591.5,51
4394,2276,2474,0.0,2375.0,-198
4395,2365,2376,0.5,2370.5,-11
4396,2400,2419,1.0,2409.5,-19
4397,2261,2384,0.5,2322.5,-123
4398,2202,2230,0.5,2216.0,-28
4399,2425,2352,0.0,2388.5,73
4400,1997,2363,1.0,2180.0,-366
4401,2615,2436,1.0,2525.5,179
4402,2323,2186,0.5,2254.5,137
4403,2400,2441,1.0,2420.5,-41
4404,2243,2102,1.0,2172.5,141
4405,2370,2317,0.5,2343.5,53
4406,2119,2264,0.0,2191.5,-145
4407,2204,2302,1.0,2253.0,-98
4408,2235,2189,0.5,2212.0,46
4409,2421,2315,0.5,2368.0,106
4410,2429,2606,0.5,2517.5,-177
4411,2398,2420,1.0,2409.0,-22
4412,2444,2415,1.0,2429.5,29
4413,2449,2372,1.0,2410.5,77
4414,2510,2317,0.5,2413.5,193
4415,2316,2250,1.0,2283.0,66
4416,2453,2398,1.0,2425.5,55
4417,2312,2294,1.0,2303.0,18
4418,2343,2297,1.0,2320.0,46
4419,2240,2069,0.5,2154.5,171
4420,2390,1981,0.5,2185.5,409
4421,1866,2416,0.0,2141.0,-550
4422,2333,1724,1.0,2028.5,609
4423,1650,2337,0.0,1993.5,-687
4424,1910,2228,0.0,2069.0,-318
4425,2256,1905,1.0,2080.5,351
4426,1803,2260,0.0,2031.5,-457
4427,2191,1589,1.0,1890.0,602
4428,2238,1855,1.0,2046.5,383
4429,1803,2166,0.0,1984.5,-363
4430,2132,1786,1.0,1959.0,346
4431,1709,2170,0.0,1939.5,-461
4432,2273,2302,0.5,2287.5,-29
4433,2117,1935,1.0,2026.0,182
4434,1933,2128,0.5,2030.5,-195
4435,2038,2132,0.0,2085.0,-94
4436,2060,2109,1.0,2084.5,-49
4437,1647,1991,0.5,1819.0,-344
4438,2055,2155,1.0,2105.0,-100
4439,1826,1811,0.5,1818.5,15
4440,2127,2217,1.0,2172.0,-90
4441,2176,1807,1.0,1991.5,369
4442,2073,2159,0.0,2116.0,-86
4443,1925,2015,0.5,1970.0,-90
4444,1795,1948,0.0,1871.5,-153
4445,1910,2124,0.0,2017.0,-214
4446,2018,1871,0.5,1944.5,147
4447,1547,1986,0.0,1766.5,-439
4448,1784,1518,1.0,1651.0,266
4449,1884,1976,0.0,1930.0,-92
4450,1698,1972,0.0,1835.0,-274
4451,2015,1633,1.0,1824.0,382
4452,1511,1919,0.0,1715.0,-408
4453,2232,1992,1.0,2112.0,240
4454,1877,1756,1.0,1816.5,121
4455,1958,1821,1.0,1889.5,137
4456,2373,1982,1.0,2177.5,391
4457,1928,2231,1.0,2079.5,-303
4458,1884,1914,0.5,1899.0,-30
4459,1667,1871,0.0,1769.0,-204
4460,2155,2390,0.5,2272.5,-235
4461,2416,2055,0.5,2235.5,361
4462,2217,2337,0.5,2277.0,-120
4463,2280,2127,1.0,2203.5,153
4464,2228,2176,1.0,2202.0,52
4465,2015,2256,0.0,2135.5,-241
4466,2260,1925,1.0,2092.5,335
4467,1944,2165,0.0,2054.5,-221
4468,2124,2238,0.5,2181.0,-114
4469,2166,2018,1.0,2092.0,148
4470,1986,2170,0.0,2078.0,-184
4471,2134,1784,1.0,1959.0,350
4472,2302,1885,1.0,2093.5,417
4473,1972,2117,1.0,2044.5,-145
4474,2128,2015,0.0,2071.5,113
4475,1919,2137,0.0,2028.0,-218
4476,1914,2265,0.0,2089.5,-351
4477,2110,1884,1.0,1997.0,226
4478,1871,2060,0.5,1965.5,-189
4479,1991,1717,0.5,1854.0,274
4480,1992,2373,0.0,2182.5,-381
4481,1958,1931,0.0,1944.5,27
4482,1981,2232,0.0,2106.5,-251
4483,1724,1866,0.0,1795.0,-142
4484,1821,1717,0.5,1769.0,104
4485,2159,1910,0.5,2034.5,249
4486,1905,2073,1.0,1989.0,-168
4487,1855,1803,1.0,1829.0,52
4488,1871,1910,0.5,1890.5,-39
4489,1786,1803,1.0,1794.5,-17
4490,1518,1547,1.0,1532.5,-29
4491,1976,1709,0.0,1842.5,267
4492,1935,2273,0.5,2104.0,-338
4493,1633,1698,0.0,1665.5,-65
4494,1667,1511,0.0,1589.0,156
4495,1982,1947,1.0,1964.5,35
4496,1647,1596,1.0,1621.5,51
4497,1807,1826,1.0,1816.5,-19
4498,2390,2238,0.0,2314.0,152
4499,2166,2416,0.5,2291.0,-250
4500,2333,2132,0.5,2232.5,201
4501,2170,2337,0.5,2253.5,-167
4502,2373,2228,1.0,2300.5,145
4503,2256,2231,0.0,2243.5,25
4504,1928,2260,0.0,2094.0,-332
4505,2265,2302,0.5,2283.5,-37
4506,2117,2132,0.5,2124.5,-15
4507,2110,2128,1.0,2119.0,-18
4508,2137,1991,0.0,2064.0,146
4509,1885,2232,0.0,2058.5,-347
4510,1972,1884,1.0,1928.0,88
4511,1821,2015,0.5,1918.0,-194
4512,1855,2155,0.0,2005.0,-300
4513,2055,1803,1.0,1929.0,252
4514,1786,2217,0.0,2001.5,-431
4515,2127,1709,1.0,1918.0,418
4516,2038,2015,0.5,2026.5,23
4517,1947,1948,0.0,1947.5,-1
4518,2273,2124,1.0,2198.5,149
4519,2018,1935,1.0,1976.5,83
4520,1933,1986,1.0,1959.5,-53
4521,1647,1914,1.0,1780.5,-267
4522,1884,1811,1.0,1847.5,73
4523,1826,1871,0.5,1848.5,-45
4524,1717,1807,0.5,1762.0,-90
4525,2383,2159,0.5,2271.0,224
4526,2073,2038,0.5,2055.5,35
4527,1910,1992,0.0,1951.0,-82
4528,1877,1905,1.0,1891.0,-28
4529,1803,1958,0.0,1880.5,-155
4530,1931,1981,0.0,1956.0,-50
4531,1866,1650,1.0,1758.0,216
4532,1910,1976,1.0,1943.0,-66
4533,1698,1871,0.0,1784.5,-173
4534,1547,1633,0.0,1590.0,-86
4535,1511,1518,1.0,1514.5,-7
4536,2238,2265,0.5,2251.5,-27
4537,2132,2166,0.5,2149.0,-34
4538,2170,2110,1.0,2140.0,60
4539,2060,2134,0.5,2097.0,-74
4540,1885,2373,0.0,2129.0,-488
4541,2231,1884,1.0,2057.5,347
4542,1972,1928,1.0,1950.0,44
4543,2228,2015,0.0,2121.5,213
4544,2416,2390,0.0,2403.0,26
4545,2260,2256,0.5,2258.0,4
4546,2337,2333,1.0,2335.0,4
4547,2155,2165,0.5,2160.0,-10
4548,2015,2176,0.0,2095.5,-161
4549,2217,2055,0.5,2136.0,162
4550,1948,1925,0.0,1936.5,23
4551,2302,2127,1.0,2214.5,175
4552,1811,1647,0.0,1729.0,164
4553,2128,2117,0.0,2122.5,11
4554,1807,1826,0.0,1816.5,-19
4555,2124,2137,0.0,2130.5,-13
4556,2038,2383,1.0,2210.5,-345
4557,1992,1784,0.0,1888.0,208
4558,1935,2273,0.0,2104.0,-338
4559,1958,1877,0.5,1917.5,81
4560,2232,1931,1.0,2081.5,301
4561,1884,1914,0.0,1899.0,-30
4562,1717,1871,1.0,1794.0,-154
4563,2038,1821,1.0,1929.5,217
4564,1724,1866,0.0,1795.0,-142
4565,2159,1717,1.0,1938.0,442
4566,1803,1855,0.0,1829.0,-52
4567,1709,1786,1.0,1747.5,-77
4568,1976,1795,1.0,1885.5,181
4569,1633,1698,1.0,1665.5,-65
4570,1871,1910,0.5,1890.5,-39
4571,1667,1547,1.0,1607.0,120
4572,2154,1903,0.5,2028.5,251
4573,2842,2741,1.0,2791.5,101
4574,2801,2526,1.0,2663.5,275
4575,2779,2753,0.5,2766.0,26
4576,2779,2842,0.0,2810.5,-63
4577,2741,2801,0.5,2771.0,-60
4578,2753,2526,1.0,2639.5,227
4579,2192,1983,0.0,2087.5,209
4580,2453,2464,0.5,2458.5,-11
4581,2314,2510,0.5,2412.0,-196
4582,2444,2580,0.0,2512.0,-136
4583,2506,2317,0.5,2411.5,189
4584,2606,2541,0.0,2573.5,65
4585,2301,2343,0.0,2322.0,-42
4586,2297,2491,1.0,2394.0,-194
4587,2248,2429,0.0,2338.5,-181
4588,2415,2407,0.0,2411.0,8
4589,2298,2398,0.0,2348.0,-100
4590,2632,2250,1.0,2441.0,382
4591,2420,2583,0.0,2501.5,-163
4592,2474,2398,0.5,2436.0,76
4593,2421,2421,0.5,2421.0,0
4594,2400,2152,0.5,2276.0,248
4595,2211,2256,0.0,2233.5,-45
4596,2230,2449,0.5,2339.5,-219
4597,2372,2202,0.0,2287.0,170
4598,2179,2316,1.0,2247.5,-137
4599,2312,2276,1.0,2294.0,36
4600,2363,2533,0.0,2448.0,-170
4601,2565,1997,0.0,2281.0,568
4602,2235,2420,0.0,2327.5,-185
4603,2502,2323,1.0,2412.5,179
4604,2264,2367,0.0,2315.5,-103
4605,2339,2243,1.0,2291.0,96
4606,2102,2357,0.0,2229.5,-255
4607,2254,2109,1.0,2181.5,145
4608,2189,2234,0.5,2211.5,-45
4609,2118,2109,0.5,2113.5,9
4610,1486,1735,1.0,1610.5,-249
4611,2234,2536,0.5,2385.0,-302
4612,2517,2182,1.0,2349.5,335
4613,1991,2452,0.0,2221.5,-461
4614,2329,1849,1.0,2089.0,480
4615,2573,2146,1.0,2359.5,427
4616,1805,2526,0.0,2165.5,-721
4617,2479,2134,1.0,2306.5,345
4618,2091,1998,0.5,2044.5,93
4619,2046,2441,0.0,2243.5,-395
4620,2417,2039,1.0,2228.0,378
4621,2037,2408,0.0,2222.5,-371
4622,2328,1755,1.0,2041.5,573
4623,2453,1860,1.0,2156.5,593
4624,2158,2345,0.0,2251.5,-187
4625,2342,1696,1.0,2019.0,646
4626,1556,2160,0.0,1858.0,-604
4627,1836,2412,0.0,2124.0,-576
4628,2362,1864,1.0,2113.0,498
4629,1818,2250,0.0,2034.0,-432
4630,1807,1594,1.0,1700.5,213
4631,2406,2029,1.0,2217.5,377
4632,1975,2254,0.5,2114.5,-279
4633,2359,1693,1.0,2026.0,666
4634,1131,2315,0.0,1723.0,-1184
4635,1506,2174,0.0,1840.0,-668
4636,2331,1704,1.0,2017.5,627
4637,1724,2394,0.5,2059.0,-670
4638,2293,1373,1.0,1833.0,920
4639,2377,1833,0.0,2105.0,544
4640,1694,2258,0.0,1976.0,-564
4641,2239,1626,1.0,1932.5,613
4642,1583,2179,0.0,1881.0,-596
4643,1658,2294,0.0,1976.0,-636
4644,2268,1704,1.0,1986.0,564
4645,1686,2227,0.0,1956.5,-541
4646,1615,1510,1.0,1562.5,105
4647,2330,1541,1.0,1935.5,789
4648,1573,2388,0.0,1980.5,-815
4649,2221,1446,1.0,1833.5,775
4650,1517,2145,0.0,1831.0,-628
4651,2245,2325,1.0,2285.0,-80
4652,1468,1606,0.0,1537.0,-138
4653,2170,2215,1.0,2192.5,-45
4654,2303,1566,1.0,1934.5,737
4655,1513,1039,0.0,1276.0,474
4656,2134,2335,1.0,2234.5,-201
4657,1644,1633,0.0,1638.5,11
4658,1552,1842,0.0,1697.0,-290
4659,2232,2350,1.0,2291.0,-118
4660,1960,2201,1.0,2080.5,-241
4661,2242,1407,1.0,1824.5,835
4662,2070,2247,1.0,2158.5,-177
4663,2536,1801,1.0,2168.5,735
4664,2377,2412,0.0,2394.5,-35
4665,2507,2517,0.5,2512.0,-10
4666,2239,2258,0.5,2248.5,-19
4667,2325,2329,0.0,2327.0,-4
4668,2526,2573,1.0,2549.5,-47
4669,2215,2245,0.0,2230.0,-30
4670,1998,2479,0.0,2238.5,-481
4671,2516,2222,0.5,2369.0,294
4672,2388,2330,0.5,2359.0,58
4673,2417,2441,0.5,2429.0,-24
4674,2145,2221,0.0,2183.0,-76
4675,2335,2328,0.0,2331.5,7
4676,2453,2465,0.5,2459.0,-12
4677,2268,2294,0.5,2281.0,-26
4678,2160,2345,1.0,2252.5,-185
4679,2448,2227,1.0,2337.5,221
4680,2335,2303,0.5,2319.0,32
4681,2362,2412,1.0,2387.0,-50
4682,2203,2134,1.0,2168.5,69
4683,2350,2250,0.0,2300.0,100
4684,2359,2406,0.0,2382.5,-47
4685,2201,2232,0.5,2216.5,-31
4686,2014,2315,0.0,2164.5,-301
4687,2331,2141,0.0,2236.0,190
4688,2247,2242,0.0,2244.5,5
4689,2293,2394,1.0,2343.5,-101
4690,2075,2070,1.0,2072.5,5
4691,2146,2314,0.0,2230.0,-168
4692,2150,2260,0.0,2205.0,-110
4693,2091,2134,1.0,2112.5,-43
4694,1768,2137,0.0,1952.5,-369
4695,1833,1688,0.0,1760.5,145
4696,1918,2234,1.0,2076.0,-316
4697,1626,1694,0.0,1660.0,-68
4698,1991,2182,1.0,2086.5,-191
4699,1541,1583,0.0,1562.0,-42
4700,2039,2046,1.0,2042.5,-7
4701,1718,2037,1.0,1877.5,-319
4702,1860,1603,1.0,1731.5,257
4703,1704,1658,0.0,1681.0,46
4704,1696,2158,0.0,1927.0,-462
4705,1535,1686,0.0,1610.5,-151
4706,1039,1582,0.0,1310.5,-543
4707,1864,1836,1.0,1850.0,28
4708,1633,1513,1.0,1573.0,120
4709,1395,1594,0.0,1494.5,-199
4710,2029,1644,1.0,1836.5,385
4711,1606,1517,0.0,1561.5,89
4712,1693,1975,1.0,1834.0,-282
4713,1566,1468,0.0,1517.0,98
4714,1407,1506,0.0,1456.5,-99
4715,1847,1704,0.0,1775.5,143
4716,2465,2536,1.0,2500.5,-71
4717,2517,2453,0.5,2485.0,64
4718,2345,2507,0.0,2426.0,-162
4719,2452,2342,1.0,2397.0,110
4720,2573,2448,0.0,2510.5,125
4721,2412,2526,0.0,2469.0,-114
4722,2479,2362,1.0,2420.5,117
4723,2250,2298,1.0,2274.0,-48
4724,2350,2516,0.0,2433.0,-166
4725,2417,2232,0.5,2324.5,185
4726,2201,2408,0.0,2304.5,-207
4727,2328,2141,1.0,2234.5,187
4728,2406,2331,0.5,2368.5,75
4729,2394,2254,0.5,2324.0,140
4730,2359,2293,0.5,2326.0,66
4731,2314,2315,0.0,2314.5,-1
4732,2242,2412,0.0,2327.0,-170
4733,2258,2247,0.5,2252.5,11
4734,2070,2239,0.0,2154.5,-169
4735,2179,2075,1.0,2127.0,104
4736,2234,2335,0.0,2284.5,-101
4737,2294,1918,1.0,2106.0,376
4738,2182,2268,1.0,2225.0,-86
4739,2227,1991,1.0,2109.0,236
4740,2330,2146,1.0,2238.0,184
4741,1805,2388,0.0,2096.5,-583
4742,2221,2134,1.0,2177.5,87
4743,2091,2145,1.0,2118.0,-54
4744,2046,2325,0.0,2185.5,-279
4745,2245,2039,1.0,2142.0,206
4746,2037,2170,0.0,2103.5,-133
4747,2222,1718,1.0,1970.0,504
4748,2303,1860,1.0,2081.5,443
4749,2158,2335,0.5,2246.5,-177
4750,2134,1696,1.0,1915.0,438
4751,1582,1842,1.0,1712.0,-260
4752,2260,2029,1.0,2144.5,231
4753,1975,2150,0.0,2062.5,-175
4754,2137,1693,1.0,1915.0,444
4755,1131,2010,0.0,1570.5,-879
4756,1506,1039,0.5,1272.5,467
4757,1513,1847,0.0,1680.0,-334
4758,1704,1633,0.5,1668.5,71
4759,1644,1724,0.5,1684.0,-80
4760,1836,1552,0.5,1694.0,284
4761,1594,1818,0.0,1706.0,-224
4762,1517,1395,1.0,1456.0,122
4763,1694,1833,0.0,1763.5,-139
4764,1566,1468,0.5,1517.0,98
4765,1357,1626,0.5,1491.5,-269
4766,1658,1218,1.0,1438.0,440
4767,1573,1541,0.0,1557.0,32
4768,1686,1704,1.0,1695.0,-18
4769,1603,1510,0.0,1556.5,93
4770,2536,2516,0.0,2526.0,20
4771,2441,2517,1.0,2479.0,-76
4772,2507,2417,0.5,2462.0,90
4773,2408,2452,0.5,2430.0,-44
4774,2465,2573,0.5,2519.0,-108
4775,2526,2453,1.0,2489.5,73
4776,2345,2479,0.5,2412.0,-134
4777,2298,2342,1.0,2320.0,-44
4778,2448,2330,1.0,2389.0,118
4779,2388,2412,0.5,2400.0,-24
4780,2362,2221,0.5,2291.5,141
4781,2145,2250,0.0,2197.5,-105
4782,2303,2406,0.5,2354.5,-103
4783,2254,2335,1.0,2294.5,-81
4784,2134,2359,0.0,2246.5,-225
4785,2315,2203,0.0,2259.0,112
4786,2412,2350,1.0,2381.0,62
4787,2232,2377,0.0,2304.5,-145
4788,2258,2201,0.0,2229.5,57
4789,1960,2239,1.0,2099.5,-279
4790,2335,2260,1.0,2297.5,75
4791,2150,2294,0.5,2222.0,-144
4792,2268,2137,1.0,2202.5,131
4793,2010,1615,1.0,1812.5,395
4794,2325,1506,1.0,1915.5,819
4795,1847,2215,0.0,2031.0,-368
4796,2170,1704,1.0,1937.0,466
4797,1724,2222,0.0,1973.0,-498
4798,2174,1836,1.0,2005.0,338
4799,1864,2331,0.0,2097.5,-467
4800,2293,1818,1.0,2055.5,475
4801,1395,2314,0.0,1854.5,-919
4802,2234,2242,1.0,2238.0,-8
4803,2247,1918,1.0,2082.5,329
4804,2182,2075,1.0,2128.5,107
4805,1801,1991,0.0,1896.0,-190
4806,1805,1658,1.0,1731.5,147
4807,1686,2134,0.5,1910.0,-448
4808,2091,1510,0.5,1800.5,581
4809,1535,1688,1.0,1611.5,-153
4810,2029,2046,0.0,2037.5,-17
4811,2039,1975,0.5,2007.0,64
4812,1693,2037,1.0,1865.0,-344
4813,1860,1517,1.0,1688.5,343
4814,1606,2158,0.0,1882.0,-552
4815,1582,1468,1.0,1525.0,114
4816,1218,1556,0.0,1387.0,-338
4817,1552,1407,1.0,1479.5,145
4818,1039,1833,0.0,1436.0,-794
4819,1626,1513,0.0,1569.5,113
4820,1633,1583,1.0,1608.0,50
4821,1357,1644,0.0,1500.5,-287
4822,2516,2448,1.0,2482.0,68
4823,2412,2441,0.5,2426.5,-29
4824,2417,2362,1.0,2389.5,55
4825,2250,2328,1.0,2289.0,-78
4826,2573,2536,1.0,2554.5,37
4827,2517,2526,0.0,2521.5,-9
4828,2479,2507,0.0,2493.0,-28
4829,2452,2298,1.0,2375.0,154
4830,2406,2335,0.0,2370.5,71
4831,2294,2254,0.0,2274.0,40
4832,2359,2268,1.0,2313.5,91
4833,2227,2315,0.0,2271.0,-88
4834,2350,2325,1.0,2337.5,25
4835,2245,2232,0.5,2238.5,13
4836,2201,2215,0.5,2208.0,-14
4837,2170,2141,0.0,2155.5,29
4838,2412,2331,0.5,2371.5,81
4839,2394,2377,0.0,2385.5,17
4840,2239,2293,1.0,2266.0,-54
4841,2314,2179,1.0,2246.5,135
4842,2029,2465,0.0,2247.0,-436
4843,2453,1975,1.0,2214.0,478
4844,1693,2345,0.5,2019.0,-652
4845,2330,2234,1.0,2282.0,96
4846,2182,2388,0.0,2285.0,-206
4847,2221,1991,1.0,2106.0,230
4848,1849,2145,0.0,1997.0,-296
4849,1506,2303,0.0,1904.5,-797
4850,2335,1847,0.5,2091.0,488
4851,1724,2134,0.0,1929.0,-410
4852,2203,1373,1.0,1788.0,830
4853,2260,1860,1.0,2060.0,400
4854,2158,2150,0.5,2154.0,8
4855,2010,1696,0.5,1853.0,314
4856,1582,1768,0.0,1675.0,-186
4857,2242,1039,1.0,1640.5,1203
4858,1513,2247,0.0,1880.0,-734
4859,2070,1633,1.0,1851.5,437
4860,1644,1801,1.0,1722.5,-157
4861,1836,2146,0.5,1991.0,-310
4862,1805,1864,0.0,1834.5,-59
4863,1818,2091,1.0,1954.5,-273
4864,1688,1594,1.0,1641.0,94
4865,1658,1552,0.0,1605.0,106
4866,1510,1704,1.0,1607.0,-194
4867,2046,1535,1.0,1790.5,511
4868,1606,1517,0.0,1561.5,89
4869,2037,2039,1.0,2038.0,-2
4870,1566,1468,1.0,1517.0,98
4871,1541,1718,1.0,1629.5,-177
4872,1446,1573,1.0,1509.5,-127
4873,2516,1603,0.5,2059.5,913
4874,2526,2573,0.0,2549.5,-47
4875,2417,2441,0.5,2429.0,-24
4876,2298,2479,0.0,2388.5,-181
4877,2536,2408,1.0,2472.0,128
4878,2254,2406,0.0,2330.0,-152
4879,2507,2517,0.5,2512.0,-10
4880,2014,2359,0.0,2186.5,-345
4881,2448,2452,0.5,2450.0,-4
4882,2377,2412,1.0,2394.5,-35
4883,2250,2412,0.0,2331.0,-162
4884,2239,2258,0.5,2248.5,-19
4885,2335,1807,0.5,2071.0,528
4886,2232,2350,0.0,2291.0,-118
4887,2227,2294,0.5,2260.5,-67
4888,2141,2201,1.0,2171.0,-60
4889,2325,1615,0.0,1970.0,710
4890,2453,2465,1.0,2459.0,-12
4891,2215,2245,0.0,2230.0,-30
4892,2342,2345,1.0,2343.5,-3
4893,2303,2222,0.5,2262.5,81
4894,2388,2330,1.0,2359.0,58
4895,2134,2335,1.0,2234.5,-201
4896,2145,2221,1.0,2183.0,-76
4897,2174,2203,0.5,2188.5,-29
4898,2150,2260,1.0,2205.0,-110
4899,2394,2331,1.0,2362.5,63
4900,2010,2137,0.0,2073.5,-127
4901,1836,2293,0.0,2064.5,-457
4902,2247,2242,1.0,2244.5,5
4903,1818,1864,1.0,1841.0,-46
4904,2075,2070,0.5,2072.5,5
4905,2046,1594,1.0,1820.0,452
4906,1704,1658,0.0,1681.0,46
4907,2037,2039,1.0,2038.0,-2
4908,1510,1686,0.5,1598.0,-176
4909,2234,1718,1.0,1976.0,516
4910,1975,2029,0.0,2002.0,-54
4911,1991,2182,0.5,2086.5,-191
4912,1131,1693,0.5,1412.0,-562
4913,1860,1849,1.0,1854.5,11
4914,1847,1506,0.0,1676.5,341
4915,1696,2158,1.0,1927.0,-462
4916,1724,1704,0.5,1714.0,20
4917,2146,1582,1.0,1864.0,564
4918,1573,1541,0.0,1557.0,32
4919,2134,1805,1.0,1969.5,329
4920,1833,2091,0.5,1962.0,-258
4921,1583,1694,0.0,1638.5,-111
4922,1407,1357,1.0,1382.0,50
4923,1513,1039,1.0,1276.0,474
4924,1644,1633,1.0,1638.5,11
4925,2412,2441,0.5,2426.5,-29
4926,2417,2377,1.0,2397.0,40
4927,2258,2408,0.0,2333.0,-150
4928,2328,2239,0.5,2283.5,89
4929,2330,2536,1.0,2433.0,-206
4930,2517,2388,1.0,2452.5,129
4931,2221,2452,0.0,2336.5,-231
4932,2329,2145,1.0,2237.0,184
4933,2573,2406,1.0,2489.5,167
4934,2254,2526,0.0,2390.0,-272
4935,2479,2359,1.0,2419.0,120
4936,2315,1998,0.0,2156.5,317
4937,2465,2350,0.0,2407.5,115
4938,2232,2453,0.0,2342.5,-221
4939,2345,2201,1.0,2273.0,144
4940,2141,2342,0.0,2241.5,-201
4941,2242,2448,0.0,2345.0,-206
4942,2412,2247,1.0,2329.5,165
4943,2070,2362,1.0,2216.0,-292
4944,1807,2075,1.0,1941.0,-268
4945,2335,2174,0.5,2254.5,161
4946,2331,2294,1.0,2312.5,37
4947,2268,2394,0.0,2331.0,-126
4948,2293,2227,1.0,2260.0,66
4949,2325,2234,0.5,2279.5,91
4950,1918,2245,0.0,2081.5,-327
4951,2170,2182,1.0,2176.0,-12
4952,1991,2222,0.5,2106.5,-231
4953,2260,2303,1.0,2281.5,-43
4954,2335,2150,1.0,2242.5,185
4955,2137,2134,0.5,2135.5,3
4956,2203,1768,1.0,1985.5,435
4957,1860,2046,1.0,1953.0,-186
4958,2039,2158,0.0,2098.5,-119
4959,1696,2037,0.5,1866.5,-341
4960,1755,1582,0.5,1668.5,173
4961,1039,2146,0.0,1592.5,-1107
4962,2134,1513,1.0,1823.5,621
4963,1633,2091,0.0,1862.0,-458
4964,1688,1644,0.5,1666.0,44
4965,1704,1864,0.0,1784.0,-160
4966,1818,1686,1.0,1752.0,132
4967,1510,1594,0.0,1552.0,-84
4968,1395,1535,0.0,1465.0,-140
4969,1552,2029,0.0,1790.5,-477
4970,1975,1693,0.0,1834.0,282
4971,1517,1573,1.0,1545.0,-56
4972,1446,1606,0.0,1526.0,-160
4973,1603,1218,1.0,1410.5,385
4974,1833,1407,1.0,1620.0,426
4975,1626,1694,1.0,1660.0,-68
4976,2516,1357,0.5,1936.5,1159
4977,2453,2465,0.5,2459.0,-12
4978,2417,2441,0.5,2429.0,-24
4979,2342,2345,0.0,2343.5,-3
4980,2536,2408,0.0,2472.0,128
4981,2412,2448,0.0,2430.0,-36
4982,2507,2517,1.0,2512.0,-10
4983,2250,2362,0.0,2306.0,-112
4984,2174,2452,0.0,2313.0,-278
4985,2526,2573,1.0,2549.5,-47
4986,2394,2331,0.5,2362.5,63
4987,2298,2479,0.5,2388.5,-181
4988,2254,2293,0.5,2273.5,-39
4989,2377,2412,0.0,2394.5,-35
4990,2315,2359,1.0,2337.0,-44
4991,2179,2258,1.0,2218.5,-79
4992,2350,2014,0.5,2182.0,336
4993,2388,2330,1.0,2359.0,58
4994,2201,2232,0.5,2216.5,-31
4995,2145,2221,0.5,2183.0,-76
4996,2303,1960,0.5,2131.5,343
4997,2245,2325,0.5,2285.0,-80
4998,2134,2335,0.5,2234.5,-201
4999,2222,2215,1.0,2218.5,7
5000,2242,2203,1.0,2222.5,39
5001,2158,1860,0.5,2009.0,298
5002,2070,2247,1.0,2158.5,-177
5003,1556,1582,0.5,1569.0,-26
5004,2146,2075,1.0,2110.5,71
5005,2294,2335,0.5,2314.5,-41
5006,2134,1805,0.0,1969.5,329
5007,2227,2268,0.5,2247.5,-41
5008,2029,2091,0.0,2060.0,-62
5009,1864,1836,1.0,1850.0,28
5010,1693,1975,0.5,1834.0,-282
5011,1594,1818,1.0,1706.0,-224
5012,2260,2234,0.0,2247.0,26
5013,1918,2137,0.0,2027.5,-219
5014,2010,2182,0.5,2096.0,-172
5015,1991,1768,0.0,1879.5,223
5016,1506,2046,0.0,1776.0,-540
5017,2039,1847,0.5,1943.0,192
5018,1704,2037,0.0,1870.5,-333
5019,1718,1373,1.0,1545.5,345
5020,1039,1552,1.0,1295.5,-513
5021,1633,1513,1.0,1573.0,120
5022,1468,1606,1.0,1537.0,-138
5023,1218,1566,0.0,1392.0,-348
5024,1541,1833,0.0,1687.0,-292
5025,1694,1446,1.0,1570.0,248
5026,1583,1626,1.0,1604.5,-43
5027,2406,1603,0.0,2004.5,803
5028,2441,2516,0.5,2478.5,-75
5029,2359,2254,1.0,2306.5,105
5030,2328,2408,0.0,2368.0,-80
5031,2325,2315,0.5,2320.0,10
5032,2507,2517,1.0,2512.0,-10
5033,2215,2245,0.0,2230.0,-30
5034,2329,2452,1.0,2390.5,-123
5035,2573,2222,1.0,2397.5,351
5036,2388,2330,0.0,2359.0,58
5037,2479,2526,1.0,2502.5,-47
5038,2145,2221,0.0,2183.0,-76
5039,2465,2298,0.0,2381.5,167
5040,2247,2242,0.0,2244.5,5
5041,2345,2453,1.0,2399.0,-108
5042,1801,2070,0.0,1935.5,-269
5043,2448,2160,0.5,2304.0,288
5044,2331,2174,0.5,2252.5,157
5045,2362,2412,1.0,2387.0,-50
5046,2293,2394,0.5,2343.5,-101
5047,1836,2250,0.0,2043.0,-414
5048,2258,2377,1.0,2317.5,-119
5049,1818,1864,1.0,1841.0,-46
5050,2179,2239,1.0,2209.0,-60
5051,2335,1395,1.0,1865.0,940
5052,2335,2303,0.5,2319.0,32
5053,2268,2294,1.0,2281.0,-26
5054,1842,2134,0.0,1988.0,-292
5055,1860,2227,0.0,2043.5,-367
5056,2232,2350,0.0,2291.0,-118
5057,1696,2158,0.0,1927.0,-462
5058,2141,2201,1.0,2171.0,-60
5059,2046,1582,0.5,1814.0,464
5060,2150,2260,0.5,2205.0,-110
5061,2037,2039,1.0,2038.0,-2
5062,2010,2137,1.0,2073.5,-127
5063,1517,1755,0.0,1636.0,-238
5064,1805,2146,1.0,1975.5,-341
5065,1468,1606,0.0,1537.0,-138
5066,1688,2091,1.0,1889.5,-403
5067,2234,1566,1.0,1900.0,668
5068,1513,1039,0.0,1276.0,474
5069,2182,1918,1.0,2050.0,264
5070,1644,1633,0.0,1638.5,11
5071,1833,1991,1.0,1912.0,-158
5072,1847,1506,1.0,1676.5,341
5073,1626,1694,1.0,1660.0,-68
5074,1373,1704,1.0,1538.5,-331
5075,1407,1583,0.0,1495.0,-176
5076,1704,1658,1.0,1681.0,46
5077,1535,1686,1.0,1610.5,-151
5078,1552,1541,1.0,1546.5,11
5079,2216,2127,0.5,2171.5,89
5080,2591,2497,0.0,2544.0,94
5081,2607,2527,0.0,2567.0,80
5082,2233,2485,0.0,2359.0,-252
5083,2339,2552,0.0,2445.5,-213
5084,2193,2374,1.0,2283.5,-181
5085,2422,2489,0.0,2455.5,-67
5086,2341,2347,1.0,2344.0,-6
5087,2341,2340,0.0,2340.5,1
5088,2289,2201,1.0,2245.0,88
5089,2147,2289,1.0,2218.0,-142
5090,2620,2586,1.0,2603.0,34
5091,2661,2516,0.5,2588.5,145
5092,2405,2473,0.0,2439.0,-68
5093,2279,2348,0.5,2313.5,-69
5094,2380,2491,0.0,2435.5,-111
5095,2448,2359,0.5,2403.5,89
5096,2374,2379,1.0,2376.5,-5
5097,2443,2253,0.5,2348.0,190
5098,2325,2300,1.0,2312.5,25
5099,2418,2175,0.0,2296.5,243
5100,2446,2514,1.0,2480.0,-68
5101,2374,2324,0.0,2349.0,50
5102,2437,2598,0.5,2517.5,-161
5103,2545,2373,1.0,2459.0,172
5104,2402,2342,0.5,2372.0,60
5105,2399,2573,0.0,2486.0,-174
5106,2462,2408,0.5,2435.0,54
5107,2216,2450,0.5,2333.0,-234
5108,2408,2400,1.0,2404.0,8
5109,1990,2132,0.0,2061.0,-142
5110,2706,2716,0.5,2711.0,-10
5111,2784,2719,0.5,2751.5,65
5112,2706,2716,0.5,2711.0,-10
5113,2719,2784,0.0,2751.5,-65
5114,2716,2706,1.0,2711.0,10
5115,2784,2719,0.5,2751.5,65
5116,2784,2716,1.0,2750.0,68
5117,2716,2784,0.5,2750.0,-68
5118,2784,2716,0.5,2750.0,68
5119,2716,2784,0.5,2750.0,-68
5120,2005,2143,0.5,2074.0,-138
5121,2523,2420,0.5,2471.5,103
5122,2481,2590,0.5,2535.5,-109
5123,2497,2537,0.5,2517.0,-40
5124,2360,2425,0.5,2392.5,-65
5125,2378,2330,0.5,2354.0,48
5126,2315,2379,1.0,2347.0,-64
5127,2324,2373,1.0,2348.5,-49
5128,2210,2327,0.5,2268.5,-117
5129,2380,2112,1.0,2246.0,268
5130,2234,2349,0.5,2291.5,-115
5131,2371,2419,1.0,2395.0,-48
5132,2313,2479,0.0,2396.0,-166
5133,2448,2602,0.5,2525.0,-154
5134,2347,2387,0.5,2367.0,-40
5135,2147,2370,0.5,2258.5,-223
5136,2414,2198,1.0,2306.0,216
5137,2151,2397,1.0,2274.0,-246
5138,2365,2129,0.5,2247.0,236
5139,2303,2455,0.5,2379.0,-152
5140,2650,2214,1.0,2432.0,436
5141,2461,2556,1.0,2508.5,-95
5142,2455,2204,1.0,2329.5,251
5143,2170,2536,1.0,2353.0,-366
5144,2329,2238,1.0,2283.5,91
5145,2363,2340,0.5,2351.5,23
5146,2018,2257,0.0,2137.5,-239
5147,2244,2266,0.0,2255.0,-22
5148,2187,2020,0.5,2103.5,167
5149,2223,2256,0.0,2239.5,-33
5150,2590,2368,1.0,2479.0,222
5151,2637,2630,0.5,2633.5,7
5152,2545,2416,1.0,2480.5,129
5153,2423,2619,0.5,2521.0,-196
5154,2382,2432,0.5,2407.0,-50
5155,2333,2352,1.0,2342.5,-19
5156,2392,2216,1.0,2304.0,176
5157,2295,2286,0.0,2290.5,9
5158,2311,2311,0.5,2311.0,0
5159,2330,2424,1.0,2377.0,-94
5160,2305,2523,1.0,2414.0,-218
5161,2261,2337,0.5,2299.0,-76
5162,2379,2534,1.0,2456.5,-155
5163,2345,2337,1.0,2341.0,8
5164,2206,2340,0.0,2273.0,-134
5165,2266,1973,1.0,2119.5,293
5166,2209,2220,1.0,2214.5,-11
5167,2185,2201,0.5,2193.0,-16
5168,2216,2253,0.5,2234.5,-37
5169,2217,2242,0.0,2229.5,-25
5170,2786,2751,1.0,2768.5,35
5171,2521,2491,1.0,2506.0,30
5172,2501,2465,0.5,2483.0,36
5173,2539,2452,0.5,2495.5,87
5174,2565,2512,0.5,2538.5,53
5175,2491,2521,1.0,2506.0,-30
5176,2465,2501,0.5,2483.0,-36
5177,2452,2539,1.0,2495.5,-87
5178,2512,2565,0.5,2538.5,-53
5179,2491,2521,1.0,2506.0,-30
5180,2501,2465,0.5,2483.0,36
5181,2565,2512,0.0,2538.5,53
5182,2521,2491,0.0,2506.0,30
5183,2465,2501,0.5,2483.0,-36
5184,2512,2565,0.5,2538.5,-53
5185,2501,2465,0.5,2483.0,36
5186,2465,2501,0.0,2483.0,-36
5187,2491,2512,1.0,2501.5,-21
5188,2452,2501,0.5,2476.5,-49
5189,2512,2491,0.5,2501.5,21
5190,2501,2452,0.5,2476.5,49
5191,2712,2698,0.5,2705.0,14
5192,2702,2664,1.0,2683.0,38
5193,2563,2705,0.0,2634.0,-142
5194,2664,2705,0.0,2684.5,-41
5195,2563,2540,1.0,2551.5,23
5196,2540,2563,0.0,2551.5,-23
5197,2705,2563,1.0,2634.0,142
5198,2664,2702,1.0,2683.0,-38
5199,2705,2664,0.0,2684.5,41
5200,2702,2664,1.0,2683.0,38
5201,2705,2664,1.0,2684.5,41
5202,2664,2705,0.0,2684.5,-41
5203,2664,2702,0.0,2683.0,-38
5204,2705,2563,1.0,2634.0,142
5205,2705,2702,0.5,2703.5,3
5206,2563,2705,0.5,2634.0,-142
5207,2702,2705,0.5,2703.5,-3
5208,2705,2702,0.5,2703.5,3
5209,2702,2705,1.0,2703.5,-3
5210,2705,2702,0.0,2703.5,3
5211,2702,2705,0.5,2703.5,-3
5212,1961,2218,0.0,2089.5,-257
5213,2674,2402,1.0,2538.0,272
5214,2417,2511,0.0,2464.0,-94
5215,2578,2006,1.0,2292.0,572
5216,2571,1985,1.0,2278.0,586
5217,2467,2202,1.0,2334.5,265
5218,2190,2444,0.0,2317.0,-254
5219,2266,2381,0.5,2323.5,-115
5220,2309,2397,1.0,2353.0,-88
5221,2202,2193,0.0,2197.5,9
5222,2404,2347,1.0,2375.5,57
5223,2577,2195,1.0,2386.0,382
5224,2611,2205,1.0,2408.0,406
5225,2371,2592,0.5,2481.5,-221
5226,2393,2401,1.0,2397.0,-8
5227,2245,2374,1.0,2309.5,-129
5228,2538,2363,1.0,2450.5,175
5229,2406,2368,0.5,2387.0,38
5230,2552,2252,0.5,2402.0,300
5231,2102,2213,0.0,2157.5,-111
5232,2362,2284,1.0,2323.0,78
5233,2506,2325,0.5,2415.5,181
5234,2492,2287,1.0,2389.5,205
5235,2534,2404,1.0,2469.0,130
5236,2373,2551,0.0,2462.0,-178
5237,2331,2344,0.5,2337.5,-13
5238,2283,2230,0.5,2256.5,53
5239,2184,2290,0.5,2237.0,-106
5240,2159,2359,0.5,2259.0,-200
5241,2234,2179,1.0,2206.5,55
5242,2225,2250,0.0,2237.5,-25
5243,2618,2325,1.0,2471.5,293
5244,2350,2485,1.0,2417.5,-135
5245,2391,2615,0.0,2503.0,-224
5246,2423,2496,0.0,2459.5,-73
5247,2381,2499,0.5,2440.0,-118
5248,2280,2374,0.5,2327.0,-94
5249,2311,2417,1.0,2364.0,-106
5250,2338,2315,0.5,2326.5,23
5251,2210,2105,1.0,2157.5,105
5252,2296,2319,1.0,2307.5,-23
5253,2730,2844,0.5,2787.0,-114
5254,2773,2798,1.0,2785.5,-25
5255,2673,2769,0.5,2721.0,-96
5256,2766,2744,1.0,2755.0,22
5257,2787,2760,1.0,2773.5,27
5258,2706,2728,0.5,2717.0,-22
5259,2747,2640,0.5,2693.5,107
5260,2844,2787,0.5,2815.5,57
5261,2798,2766,0.5,2782.0,32
5262,2744,2730,0.5,2737.0,14
5263,2728,2747,0.5,2737.5,-19
5264,2673,2773,0.5,2723.0,-100
5265,2769,2640,0.5,2704.5,129
5266,2760,2706,0.5,2733.0,54
5267,2706,2844,0.5,2775.0,-138
5268,2730,2798,0.5,2764.0,-68
5269,2747,2760,0.0,2753.5,-13
5270,2640,2728,0.5,2684.0,-88
5271,2787,2744,1.0,2765.5,43
5272,2773,2769,0.5,2771.0,4
5273,2766,2673,0.5,2719.5,93
5274,2391,2541,0.0,2466.0,-150
5275,2567,2548,0.0,2557.5,19
5276,2644,2607,1.0,2625.5,37
5277,2627,2441,1.0,2534.0,186
5278,2653,2556,1.0,2604.5,97
5279,2653,2578,1.0,2615.5,75
5280,2679,2485,1.0,2582.0,194
5281,2556,2653,0.5,2604.5,-97
5282,2541,2485,0.0,2513.0,56
5283,2391,2567,0.0,2479.0,-176
5284,2578,2679,0.5,2628.5,-101
5285,2607,2627,1.0,2617.0,-20
5286,2548,2644,0.0,2596.0,-96
5287,2441,2653,0.0,2547.0,-212
5288,2627,2548,0.5,2587.5,79
5289,2653,2607,0.5,2630.0,46
5290,2653,2441,0.5,2547.0,212
5291,2567,2541,1.0,2554.0,26
5292,2485,2578,0.0,2531.5,-93
5293,2679,2556,0.5,2617.5,123
5294,2644,2391,1.0,2517.5,253
5295,2161,2012,1.0,2086.5,149
5296,2506,2490,1.0,2498.0,16
5297,2586,2541,0.5,2563.5,45
5298,2580,2509,1.0,2544.5,71
5299,2482,2314,0.0,2398.0,168
5300,2491,2377,0.5,2434.0,114
5301,2386,2464,1.0,2425.0,-78
5302,2432,2378,0.5,2405.0,54
5303,2289,2301,0.5,2295.0,-12
5304,2298,2415,0.0,2356.5,-117
5305,2292,2248,0.5,2270.0,44
5306,2127,2255,0.0,2191.0,-128
5307,2760,2757,0.5,2758.5,3
5308,2790,2794,0.5,2792.0,-4
5309,2793,2786,0.5,2789.5,7
5310,2762,2780,1.0,2771.0,-18
5311,2757,2780,0.5,2768.5,-23
5312,2786,2762,0.5,2774.0,24
5313,2794,2793,0.5,2793.5,1
5314,2760,2790,1.0,2775.0,-30
5315,2790,2757,0.5,2773.5,33
5316,2793,2760,0.5,2776.5,33
5317,2762,2794,0.5,2778.0,-32
5318,2780,2786,0.0,2783.0,-6
5319,2437,2314,1.0,2375.5,123
5320,2771,2802,0.5,2786.5,-31
5321,2802,2771,1.0,2786.5,31
5322,2771,2802,0.0,2786.5,-31
5323,2164,2183,0.0,2173.5,-19
5324,2769,2819,0.5,2794.0,-50
5325,2770,2807,0.5,2788.5,-37
5326,2771,2791,1.0,2781.0,-20
5327,2755,2792,0.5,2773.5,-37
5328,2761,2751,1.0,2756.0,10
5329,2807,2761,0.5,2784.0,46
5330,2755,2771,0.5,2763.0,-16
5331,2819,2770,0.0,2794.5,49
5332,2791,2769,1.0,2780.0,22
5333,2792,2751,1.0,2771.5,41
5334,2771,2792,0.5,2781.5,-21
5335,2770,2791,0.5,2780.5,-21
5336,2761,2819,0.5,2790.0,-58
5337,2751,2807,0.5,2779.0,-56
5338,2769,2755,0.5,2762.0,14
5339,2576,2661,0.5,2618.5,-85
5340,2567,2649,0.5,2608.0,-82
5341,2656,2543,0.5,2599.5,113
5342,2608,2678,0.5,2643.0,-70
5343,2526,2657,0.5,2591.5,-131
5344,2513,2635,0.5,2574.0,-122
5345,2629,2592,0.5,2610.5,37
5346,2392,2618,0.5,2505.0,-226
5347,2660,2524,1.0,2592.0,136
5348,2728,2430,1.0,2579.0,298
5349,2419,2698,0.5,2558.5,-279
5350,2649,2398,1.0,2523.5,251
5351,2383,2639,0.0,2511.0,-256
5352,2639,2376,1.0,2507.5,263
5353,2585,2350,1.0,2467.5,235
5354,2352,2583,0.0,2467.5,-231
5355,2342,2578,0.0,2460.0,-236
5356,2571,2328,1.0,2449.5,243
5357,2557,2306,0.0,2431.5,251
5358,2481,2295,0.5,2388.0,186
5359,2661,2567,1.0,2614.0,94
5360,2543,2576,1.0,2559.5,-33
5361,2649,2728,0.5,2688.5,-79
5362,2678,2585,1.0,2631.5,93
5363,2608,2660,0.5,2634.0,-52
5364,2657,2571,0.5,2614.0,86
5365,2592,2656,0.5,2624.0,-64
5366,2583,2649,0.0,2616.0,-66
5367,2639,2526,0.5,2582.5,113
5368,2578,2639,0.5,2608.5,-61
5369,2635,2392,0.5,2513.5,243
5370,2306,2629,0.0,2467.5,-323
5371,2618,2513,1.0,2565.5,105
5372,2524,2457,0.5,2490.5,67
5373,2698,2318,1.0,2508.0,380
5374,2613,2419,1.0,2516.0,194
5375,2507,2260,1.0,2383.5,247
5376,2457,2499,0.5,2478.0,-42
5377,2498,2204,1.0,2351.0,294
5378,2415,2498,0.0,2456.5,-83
5379,2543,2661,0.5,2602.0,-118
5380,2649,2678,0.5,2663.5,-29
5381,2629,2649,0.5,2639.0,-20
5382,2639,2618,0.5,2628.5,21
5383,2728,2576,1.0,2652.0,152
5384,2571,2698,0.5,2634.5,-127
5385,2660,2567,1.0,2613.5,93
5386,2498,2657,0.5,2577.5,-159
5387,2656,2507,1.0,2581.5,149
5388,2476,2639,0.5,2557.5,-163
5389,2471,2635,1.0,2553.0,-164
5390,2526,2613,0.0,2569.5,-87
5391,2457,2608,0.0,2532.5,-151
5392,2392,2592,0.0,2492.0,-200
5393,2383,2578,0.0,2480.5,-195
5394,2585,2498,1.0,2541.5,87
5395,2375,2583,0.5,2479.0,-208
5396,2350,2524,0.0,2437.0,-174
5397,2513,2328,1.0,2420.5,185
5398,2499,2306,1.0,2402.5,193
5399,2661,2660,1.0,2660.5,1
5400,2678,2543,1.0,2610.5,135
5401,2618,2728,0.5,2673.0,-110
5402,2613,2656,1.0,2634.5,-43
5403,2649,2471,0.0,2560.0,178
5404,2608,2649,1.0,2628.5,-41
5405,2578,2629,0.5,2603.5,-51
5406,2592,2571,1.0,2581.5,21
5407,2698,2513,0.5,2605.5,185
5408,2657,2398,1.0,2527.5,259
5409,2639,2499,1.0,2569.0,140
5410,2498,2639,0.0,2568.5,-141
5411,2585,2476,1.0,2530.5,109
5412,2524,2258,1.0,2391.0,266
5413,2635,2457,0.5,2546.0,178
5414,2583,2392,1.0,2487.5,191
5415,2576,2419,1.0,2497.5,157
5416,2567,2383,0.5,2475.0,184
5417,2457,2557,0.0,2507.0,-100
5418,2415,2526,0.0,2470.5,-111
5419,2507,2375,0.5,2441.0,132
5420,2613,2661,0.0,2637.0,-48
5421,2592,2678,0.0,2635.0,-86
5422,2471,2608,0.5,2539.5,-137
5423,2728,2585,0.5,2656.5,143
5424,2657,2618,0.5,2637.5,39
5425,2639,2578,0.5,2608.5,61
5426,2639,2524,1.0,2581.5,115
5427,2629,2543,0.5,2586.0,86
5428,2557,2698,0.5,2627.5,-141
5429,2660,2498,1.0,2579.0,162
5430,2656,2576,0.0,2616.0,80
5431,2526,2649,0.0,2587.5,-123
5432,2649,2481,0.0,2565.0,168
5433,2513,2583,0.0,2548.0,-70
5434,2052,2635,0.0,2343.5,-583
5435,2571,2383,1.0,2477.0,188
5436,2398,2567,0.0,2482.5,-169
5437,2383,2507,0.5,2445.0,-124
5438,2499,2376,1.0,2437.5,123
5439,2375,2498,0.0,2436.5,-123
5440,2476,2328,1.0,2402.0,148
5441,2457,2306,0.5,2381.5,151
5442,2292,2430,0.0,2361.0,-138
5443,2661,2678,0.5,2669.5,-17
5444,2608,2639,0.5,2623.5,-31
5445,2618,2471,1.0,2544.5,147
5446,2583,2728,0.5,2655.5,-145
5447,2585,2660,0.5,2622.5,-75
5448,2578,2657,0.5,2617.5,-79
5449,2649,2592,1.0,2620.5,57
5450,2576,2639,0.5,2607.5,-63
5451,2481,2629,0.0,2555.0,-148
5452,2543,2613,1.0,2578.0,-70
5453,2698,2524,1.0,2611.0,174
5454,2635,2499,1.0,2567.0,136
5455,2498,2571,0.5,2534.5,-73
5456,2567,2476,1.0,2521.5,91
5457,2430,2557,0.5,2493.5,-127
5458,2419,2656,0.0,2537.5,-237
5459,2415,2649,0.0,2532.0,-234
5460,2383,2526,0.5,2454.5,-143
5461,2306,2513,0.0,2409.5,-207
5462,2507,2352,0.0,2429.5,155
5463,2498,2052,1.0,2275.0,446
5464,2494,2318,1.0,2406.0,176
5465,2350,2457,0.0,2403.5,-107
5466,1924,2138,0.0,2031.0,-214
5467,2758,2785,1.0,2771.5,-27
5468,2787,2830,0.5,2808.5,-43
5469,2709,2770,0.5,2739.5,-61
5470,2766,2757,0.5,2761.5,9
5471,2785,2787,1.0,2786.0,-2
5472,2770,2766,0.5,2768.0,4
5473,2757,2758,1.0,2757.5,-1
5474,2830,2709,0.5,2769.5,121
5475,2758,2770,0.5,2764.0,-12
5476,2709,2785,1.0,2747.0,-76
5477,2766,2830,0.0,2798.0,-64
5478,2787,2757,1.0,2772.0,30
5479,2785,2757,0.5,2771.0,28
5480,2830,2770,0.5,2800.0,60
5481,2787,2709,0.5,2748.0,78
5482,2758,2766,0.0,2762.0,-8
5483,2709,2758,0.5,2733.5,-49
5484,2766,2787,1.0,2776.5,-21
5485,2757,2830,1.0,2793.5,-73
5486,2770,2785,1.0,2777.5,-15
5487,2103,2284,0.5,2193.5,-181
5488,2748,2701,0.5,2724.5,47
5489,2726,2844,0.5,2785.0,-118
5490,2732,2722,0.5,2727.0,10
5491,2764,2797,0.5,2780.5,-33
5492,2764,2751,0.5,2757.5,13
5493,2767,2706,0.5,2736.5,61
5494,2844,2732,1.0,2788.0,112
5495,2767,2748,0.5,2757.5,19
5496,2751,2764,0.5,2757.5,-13
5497,2706,2722,1.0,2714.0,-16
5498,2797,2726,0.0,2761.5,71
5499,2701,2764,0.5,2732.5,-63
5500,2748,2706,0.5,2727.0,42
5501,2764,2701,0.5,2732.5,63
5502,2722,2844,1.0,2783.0,-122
5503,2764,2767,0.0,2765.5,-3
5504,2726,2751,0.5,2738.5,-25
5505,2732,2797,0.5,2764.5,-65
5506,2701,2726,0.5,2713.5,-25
5507,2706,2844,0.5,2775.0,-138
5508,2748,2764,0.5,2756.0,-16
5509,2751,2732,0.0,2741.5,19
5510,2797,2722,0.5,2759.5,75
5511,2767,2764,0.5,2765.5,3
5512,2844,2797,0.0,2820.5,47
5513,2764,2748,1.0,2756.0,16
5514,2732,2701,0.5,2716.5,31
5515,2764,2706,1.0,2735.0,58
5516,2726,2767,0.5,2746.5,-41
5517,2722,2751,1.0,2736.5,-29
5518,2748,2726,1.0,2737.0,22
5519,2767,2732,0.5,2749.5,35
5520,2764,2764,0.5,2764.0,0
5521,2701,2722,1.0,2711.5,-21
5522,2751,2844,0.0,2797.5,-93
5523,2706,2797,0.0,2751.5,-91
5524,2332,2254,0.5,2293.0,78
5525,2776,2391,1.0,2583.5,385
5526,2358,2763,0.0,2560.5,-405
5527,2722,2196,1.0,2459.0,526
5528,2244,2682,0.0,2463.0,-438
5529,2347,2760,0.0,2553.5,-413
5530,2768,2329,1.0,2548.5,439
5531,2258,2726,0.0,2492.0,-468
5532,2747,2222,1.0,2484.5,525
5533,2765,2388,1.0,2576.5,377
5534,2315,2742,0.0,2528.5,-427
5535,2712,2192,1.0,2452.0,520
5536,2244,2708,1.0,2476.0,-464
5537,2743,2303,1.0,2523.0,440
5538,2244,2711,0.0,2477.5,-467
5539,2668,2274,1.0,2471.0,394
5540,2222,2672,0.5,2447.0,-450
5541,2393,2710,0.5,2551.5,-317
5542,2695,2273,1.0,2484.0,422
5543,2208,2681,0.0,2444.5,-473
5544,2685,2160,1.0,2422.5,525
5545,2678,2419,1.0,2548.5,259
5546,2301,2649,0.0,2475.0,-348
5547,2646,2195,1.0,2420.5,451
5548,2106,2629,0.0,2367.5,-523
5549,2408,2691,0.5,2549.5,-283
5550,2660,2324,1.0,2492.0,336
5551,2128,2621,0.0,2374.5,-493
5552,2597,2170,1.0,2383.5,427
5553,2672,2285,0.5,2478.5,387
5554,2283,2689,0.0,2486.0,-406
5555,2677,2246,1.0,2461.5,431
5556,2223,2549,0.5,2386.0,-326
5557,2400,2674,0.0,2537.0,-274
5558,2692,2203,1.0,2447.5,489
5559,2215,2633,0.0,2424.0,-418
5560,2594,2131,1.0,2362.5,463
5561,2739,2149,1.0,2444.0,590
5562,2319,2612,0.0,2465.5,-293
5563,2614,2207,1.0,2410.5,407
5564,2292,2568,0.0,2430.0,-276
5565,2422,2609,0.5,2515.5,-187
5566,2621,2281,1.0,2451.0,340
5567,2126,2702,0.0,2414.0,-576
5568,2678,2126,0.5,2402.0,552
5569,2780,2328,1.0,2554.0,452
5570,2276,2639,0.0,2457.5,-363
5571,2624,2173,1.0,2398.5,451
5572,2106,2604,0.0,2355.0,-498
5573,2418,2634,0.5,2526.0,-216
5574,2607,2261,1.0,2434.0,346
5575,2128,2589,0.0,2358.5,-461
5576,2590,2093,1.0,2341.5,497
5577,2740,2261,1.0,2500.5,479
5578,2124,2557,0.0,2340.5,-433
5579,2574,2226,1.0,2400.0,348
5580,2221,2556,0.0,2388.5,-335
5581,2061,2639,0.0,2350.0,-578
5582,2618,2171,1.0,2394.5,447
5583,2328,2591,0.0,2459.5,-263
5584,2595,2259,1.0,2427.0,336
5585,2610,2182,1.0,2396.0,428
5586,2351,2602,0.0,2476.5,-251
5587,2583,2203,1.0,2393.0,380
5588,2108,2568,0.5,2338.0,-460
5589,2245,2600,0.0,2422.5,-355
5590,2579,2112,1.0,2345.5,467
5591,2115,2565,0.0,2340.0,-450
5592,2567,2099,1.0,2333.0,468
5593,2494,2206,1.0,2350.0,288
5594,2161,2664,0.0,2412.5,-503
5595,2565,2193,1.0,2379.0,372
5596,2198,2571,0.0,2384.5,-373
5597,2338,2649,0.0,2493.5,-311
5598,2569,2152,1.0,2360.5,417
5599,2138,2562,0.0,2350.0,-424
5600,2548,2121,1.0,2334.5,427
5601,2623,2228,1.0,2425.5,395
5602,2185,2594,0.0,2389.5,-409
5603,2551,2163,1.0,2357.0,388
5604,2143,2576,0.0,2359.5,-433
5605,2236,2633,0.0,2434.5,-397
5606,2588,2170,1.0,2379.0,418
5607,2183,2569,0.0,2376.0,-386
5608,2502,2127,1.0,2314.5,375
5609,2649,2262,1.0,2455.5,387
5610,2250,2589,0.0,2419.5,-339
5611,2582,2158,1.0,2370.0,424
5612,2039,2515,0.0,2277.0,-476
5613,2327,2639,0.0,2483.0,-312
5614,2590,2185,1.0,2387.5,405
5615,2098,2581,0.0,2339.5,-483
5616,2564,2090,1.0,2327.0,474
5617,2634,2139,1.0,2386.5,495
5618,2238,2601,0.0,2419.5,-363
5619,2594,2121,1.0,2357.5,473
5620,2047,2544,0.0,2295.5,-497
5621,2188,2656,0.0,2422.0,-468
5622,2578,2144,1.0,2361.0,434
5623,2071,2565,0.0,2318.0,-494
5624,2456,2059,1.0,2257.5,397
5625,2620,2111,1.0,2365.5,509
5626,2305,2491,0.0,2398.0,-186
5627,2463,2198,1.0,2330.5,265
5628,1926,2477,0.0,2201.5,-551
5629,2077,2629,0.0,2353.0,-552
5630,2513,2237,1.0,2375.0,276
5631,2165,2482,0.0,2323.5,-317
5632,2492,1937,0.0,2214.5,555
5633,2558,2091,1.0,2324.5,467
5634,2000,2548,0.0,2274.0,-548
5635,2543,2153,1.0,2348.0,390
5636,1900,2542,0.0,2221.0,-642
5637,2263,2580,0.5,2421.5,-317
5638,2591,2129,1.0,2360.0,462
5639,2078,2580,0.0,2329.0,-502
5640,2452,1860,1.0,2156.0,592
5641,2566,2206,1.0,2386.0,360
5642,2055,2535,0.0,2295.0,-480
5643,2509,2135,1.0,2322.0,374
5644,2054,2408,0.5,2231.0,-354
5645,2154,2655,0.0,2404.5,-501
5646,2520,2163,1.0,2341.5,357
5647,1830,2499,0.0,2164.5,-669
5648,2504,1836,1.0,2170.0,668
5649,2588,2209,1.0,2398.5,379
5650,2114,2527,0.0,2320.5,-413
5651,2540,2062,1.0,2301.0,478
5652,2008,2523,0.5,2265.5,-515
5653,2249,2615,0.0,2432.0,-366
5654,2547,1787,1.0,2167.0,760
5655,2028,2552,0.0,2290.0,-524
5656,2500,2053,1.0,2276.5,447
5657,2376,2751,0.5,2563.5,-375
5658,2721,2305,1.0,2513.0,416
5659,2264,2699,0.0,2481.5,-435
5660,2676,2194,1.0,2435.0,482
5661,2396,1723,1.0,2059.5,673
5662,2259,2313,0.0,2286.0,-54
5663,2508,2151,1.0,2329.5,357
5664,2106,2243,0.0,2174.5,-137
5665,2512,2501,1.0,2506.5,11
5666,1914,2096,0.0,2005.0,-182
5667,2152,2463,0.0,2307.5,-311
5668,2521,2558,1.0,2539.5,-37
5669,1995,1979,0.0,1987.0,16
5670,2445,2416,1.0,2430.5,29
5671,2538,1831,1.0,2184.5,707
5672,2054,2216,0.0,2135.0,-162
5673,2459,2582,1.0,2520.5,-123
5674,2016,1943,0.0,1979.5,73
5675,1956,2449,0.0,2202.5,-493
5676,2535,2618,1.0,2576.5,-83
5677,2190,2155,0.0,2172.5,35
5678,2493,2525,1.0,2509.0,-32
5679,2619,1820,1.0,2219.5,799
5680,2132,2085,0.5,2108.5,47
5681,2522,2544,1.0,2533.0,-22
5682,1924,2069,0.0,1996.5,-145
5683,2303,2484,0.0,2393.5,-181
5684,2620,2686,1.0,2653.0,-66
5685,1993,2038,0.5,2015.5,-45
5686,2331,2431,1.0,2381.0,-100
5687,2523,1906,1.0,2214.5,617
5688,2140,2412,0.0,2276.0,-272
5689,2507,2512,1.0,2509.5,-5
5690,1840,1847,0.0,1843.5,-7
5691,2058,2494,0.0,2276.0,-436
5692,2497,2508,0.5,2502.5,-11
5693,2012,2096,0.0,2054.0,-84
5694,2495,2495,1.0,2495.0,0
5695,2479,1890,1.0,2184.5,589
5696,2125,2175,0.0,2150.0,-50
5697,2496,2489,1.0,2492.5,7
5698,1712,1991,0.0,1851.5,-279
5699,1964,2388,0.0,2176.0,-424
5700,2502,2573,1.0,2537.5,-71
5701,1905,1986,0.0,1945.5,-81
5702,2428,2448,1.0,2438.0,-20
5703,2517,1948,1.0,2232.5,569
5704,2024,2067,0.0,2045.5,-43
5705,2497,2527,1.0,2512.0,-30
5706,2029,2010,0.5,2019.5,19
5707,1986,2472,0.0,2229.0,-486
5708,2421,2570,1.0,2495.5,-149
5709,2015,1979,0.0,1997.0,36
5710,2470,2452,1.0,2461.0,18
5711,2567,2116,1.0,2341.5,451
5712,1845,2074,0.0,1959.5,-229
5713,2465,2476,1.0,2470.5,-11
5714,2041,2022,0.0,2031.5,19
5715,2169,2449,0.5,2309.0,-280
5716,2481,2451,1.0,2466.0,30
5717,1978,2061,0.0,2019.5,-83
5718,2466,2486,1.0,2476.0,-20
5719,2501,1859,1.0,2180.0,642
5720,1981,2145,0.5,2063.0,-164
5721,2486,2519,1.0,2502.5,-33
5722,1797,2024,0.0,1910.5,-227
5723,2095,2444,1.0,2269.5,-349
5724,2484,2465,1.0,2474.5,19
5725,1940,2038,0.0,1989.0,-98
5726,2443,2467,1.0,2455.0,-24
5727,2619,1885,1.0,2252.0,734
5728,1999,2042,0.0,2020.5,-43
5729,2486,2468,1.0,2477.0,18
5730,1896,1992,0.0,1944.0,-96
5731,2126,2358,0.0,2242.0,-232
5732,2462,2482,1.0,2472.0,-20
5733,1910,1879,0.0,1894.5,31
5734,2423,2467,1.0,2445.0,-44
5735,2472,1809,1.0,2140.5,663
5736,1988,2064,0.0,2026.0,-76
5737,2402,2447,1.0,2424.5,-45
5738,1826,1921,0.0,1873.5,-95
5739,1678,2381,0.0,2029.5,-703
5740,2439,2553,1.0,2496.0,-114
5741,1965,1766,0.0,1865.5,199
5742,2360,2435,1.0,2397.5,-75
5743,2542,1985,1.0,2263.5,557
5744,1950,2018,0.0,1984.0,-68
5745,2380,2457,1.0,2418.5,-77
5746,1844,1926,0.0,1885.0,-82
5747,2218,2190,0.0,2204.0,28
5748,2492,2543,1.0,2517.5,-51
5749,1844,1875,0.0,1859.5,-31
5750,2380,2382,1.0,2381.0,-2
5751,2501,1780,1.0,2140.5,721
5752,1873,1988,0.0,1930.5,-115
5753,2482,2445,1.0,2463.5,37
5754,1710,1819,0.0,1764.5,-109
5755,2112,2413,0.0,2262.5,-301
5756,2424,2465,1.0,2444.5,-41
5757,1783,1785,0.0,1784.0,-2
5758,2313,2438,1.0,2375.5,-125
5759,2431,1690,1.0,2060.5,741
5760,1902,1935,1.0,1918.5,-33
5761,2299,2427,1.0,2363.0,-128
5762,2024,2483,0.0,2253.5,-459
5763,2386,2391,1.0,2388.5,-5
5764,1665,1900,0.0,1782.5,-235
5765,2360,2373,1.0,2366.5,-13
5766,2370,1653,1.0,2011.5,717
5767,1904,2057,0.0,1980.5,-153
5768,2363,2346,1.0,2354.5,17
5769,1651,1892,0.0,1771.5,-241
5770,1993,2345,0.0,2169.0,-352
5771,2349,2443,1.0,2396.0,-94
5772,1955,1793,0.0,1874.0,162
5773,2156,2411,1.0,2283.5,-255
5774,2389,1751,1.0,2070.0,638
5775,1846,1850,0.0,1848.0,-4
5776,2402,2440,1.0,2421.0,-38
5777,1863,1775,0.0,1819.0,88
5778,1823,2365,0.0,2094.0,-542
5779,2263,2477,1.0,2370.0,-214
5780,1730,1772,0.0,1751.0,-42
5781,2273,2452,1.0,2362.5,-179
5782,2471,1323,1.0,1897.0,1148
5783,1825,1661,0.0,1743.0,164
5784,2343,2340,1.0,2341.5,3
5785,1840,1840,0.0,1840.0,0
5786,2095,2373,0.0,2234.0,-278
5787,2360,2452,1.0,2406.0,-92
5788,2014,2000,0.0,2007.0,14
5789,2316,2317,1.0,2316.5,-1
5790,2477,1476,1.0,1976.5,1001
5791,1877,2322,0.0,2099.5,-445
5792,2308,1781,1.0,2044.5,527
5793,1774,2248,0.0,2011.0,-474
5794,1771,2401,0.0,2086.0,-630
5795,2398,1716,1.0,2057.0,682
5796,1828,2290,0.0,2059.0,-462
5797,2206,1766,1.0,1986.0,440
5798,2441,1674,1.0,2057.5,767
5799,1805,2316,0.0,2060.5,-511
5800,2274,1801,1.0,2037.5,473
5801,1737,2239,0.0,1988.0,-502
5802,1848,2441,0.0,2144.5,-593
5803,2345,1758,1.0,2051.5,587
5804,1680,2292,0.0,1986.0,-612
5805,2301,1661,1.0,1981.0,640
5806,2615,1827,1.0,2221.0,788
5807,1779,2430,0.0,2104.5,-651
5808,2229,1655,1.0,1942.0,574
5809,1627,2178,0.0,1902.5,-551
5810,1631,2473,0.0,2052.0,-842
5811,2389,1873,1.0,2131.0,516
5812,1595,2327,0.0,1961.0,-732
5813,2200,1591,1.0,1895.5,609
5814,2421,2066,1.0,2243.5,355
5815,2004,2380,0.0,2192.0,-376
5816,2154,1701,1.0,1927.5,453
5817,1723,2035,0.0,1879.0,-312
5818,2232,2125,1.0,2178.5,107
5819,1723,1723,0.0,1723.0,0
5820,2388,2355,1.0,2371.5,33
5821,2387,1743,1.0,2065.0,644
5822,1627,1779,0.0,1703.0,-152
5823,2319,2324,1.0,2321.5,-5
5824,1587,1627,0.0,1607.0,-40
5825,1910,2229,0.0,2069.5,-319
5826,2248,2331,1.0,2289.5,-83
5827,1819,1844,0.0,1831.5,-25
5828,2237,2239,0.5,2238.0,-2
5829,2297,1250,1.0,1773.5,1047
5830,2138,2405,0.5,2271.5,-267
5831,2349,1353,1.0,1851.0,996
5832,1820,2315,0.0,2067.5,-495
5833,1896,2494,0.0,2195.0,-598
5834,2345,1835,0.0,2090.0,510
5835,2230,2256,1.0,2243.0,-26
5836,2335,1803,1.0,2069.0,532
5837,2297,2321,1.0,2309.0,-24
5838,1695,2134,0.0,1914.5,-439
5839,2058,2408,0.0,2233.0,-350
5840,2402,2060,1.0,2231.0,342
5841,2247,2284,1.0,2265.5,-37
5842,2464,1608,1.0,2036.0,856
5843,1560,2358,0.0,1959.0,-798
5844,2273,1405,1.0,1839.0,868
5845,1408,2220,0.0,1814.0,-812
5846,1680,2434,0.0,2057.0,-754
5847,2310,1662,1.0,1986.0,648
5848,1576,2283,0.0,1929.5,-707
5849,2291,1880,1.0,2085.5,411
5850,2026,2372,0.0,2199.0,-346
5851,2196,2160,0.0,2178.0,36
5852,1992,2344,0.0,2168.0,-352
5853,2262,2245,0.0,2253.5,17
5854,2227,2276,0.0,2251.5,-49
5855,1793,2271,0.0,2032.0,-478
5856,2475,1765,1.0,2120.0,710
5857,2124,2176,1.0,2150.0,-52
5858,1060,2096,0.0,1578.0,-1036
5859,2361,2218,1.0,2289.5,143
5860,2246,2376,1.0,2311.0,-130
5861,2116,1888,0.0,2002.0,228
5862,1943,2535,0.5,2239.0,-592
5863,2528,1869,1.0,2198.5,659
5864,1925,2469,0.0,2197.0,-544
5865,2462,1926,1.0,2194.0,536
5866,2533,2271,1.0,2402.0,262
5867,1872,2451,0.0,2161.5,-579
5868,2403,1812,1.0,2107.5,591
5869,1724,2405,0.0,2064.5,-681
5870,2090,2464,0.0,2277.0,-374
5871,2446,2038,0.5,2242.0,408
5872,1840,2468,0.0,2154.0,-628
5873,2351,1685,1.0,2018.0,666
5874,2509,2050,1.0,2279.5,459
5875,2030,2475,1.0,2252.5,-445
5876,2469,1727,1.0,2098.0,742
5877,1671,2404,0.0,2037.5,-733
5878,1942,2557,0.0,2249.5,-615
5879,2400,1932,1.0,2166.0,468
5880,1899,2374,0.0,2136.5,-475
5881,2338,1790,1.0,2064.0,548
5882,2414,1953,1.0,2183.5,461
5883,1853,2390,0.0,2121.5,-537
5884,2389,1924,0.0,2156.5,465
5885,1813,2237,0.0,2025.0,-424
5886,1888,2424,0.0,2156.0,-536
5887,2407,1626,1.0,2016.5,781
5888,1996,2347,0.0,2171.5,-351
5889,2305,1922,0.0,2113.5,383
5890,2482,2064,1.0,2273.0,418
5891,2020,2394,0.5,2207.0,-374
5892,2263,1751,1.0,2007.0,512
5893,1687,2125,0.0,1906.0,-438
5894,2431,1929,1.0,2180.0,502
5895,1833,2361,0.0,2097.0,-528
5896,2311,1809,0.0,2060.0,502
5897,1785,2268,0.0,2026.5,-483
5898,1647,2358,0.0,2002.5,-711
5899,2326,1676,1.0,2001.0,650
5900,1712,2355,0.0,2033.5,-643
5901,2320,1926,1.0,2123.0,394
5902,2409,2024,1.0,2216.5,385
5903,1877,2331,0.0,2104.0,-454
5904,2289,1770,0.5,2029.5,519
5905,1594,2205,0.0,1899.5,-611
5906,1960,2370,0.0,2165.0,-410
5907,2321,1727,1.0,2024.0,594
5908,1791,2258,0.0,2024.5,-467
5909,2260,1655,1.0,1957.5,605
5910,2317,1933,1.0,2125.0,384
5911,1780,2325,0.0,2052.5,-545
5912,2301,1733,1.0,2017.0,568
5913,1664,2255,0.0,1959.5,-591
5914,1810,2329,0.0,2069.5,-519
5915,2362,1748,1.0,2055.0,614
5916,1815,2235,0.0,2025.0,-420
5917,2192,1755,1.0,1973.5,437
5918,2367,1962,1.0,2164.5,405
5919,1736,2339,0.0,2037.5,-603
5920,2275,1712,1.0,1993.5,563
5921,1727,2260,0.0,1993.5,-533
5922,1813,2422,0.0,2117.5,-609
5923,2377,1785,1.0,2081.0,592
5924,1764,2149,0.0,1956.5,-385
5925,2123,1655,1.0,1889.0,468
5926,2421,1649,1.0,2035.0,772
5927,1726,2321,0.5,2023.5,-595
5928,2294,1708,1.0,2001.0,586
5929,1795,2168,0.0,1981.5,-373
5930,1739,2368,0.0,2053.5,-629
5931,2323,1702,1.0,2012.5,621
5932,1822,2244,0.0,2033.0,-422
5933,2161,1755,1.0,1958.0,406
5934,2374,1772,1.0,2073.0,602
5935,1778,2328,0.0,2053.0,-550
5936,2157,1713,1.0,1935.0,444
5937,1741,1933,0.0,1837.0,-192
5938,1945,2375,0.0,2160.0,-430
5939,2313,1713,1.0,2013.0,600
5940,1655,2258,0.0,1956.5,-603
5941,2151,1605,0.0,1878.0,546
5942,2281,1848,1.0,2064.5,433
5943,1604,2243,0.0,1923.5,-639
5944,2294,1705,1.0,1999.5,589
5945,1515,2239,0.0,1877.0,-724
5946,1893,2348,0.0,2120.5,-455
5947,2261,1797,1.0,2029.0,464
5948,1408,2241,0.0,1824.5,-833
5949,2170,1531,1.0,1850.5,639
5950,2345,1803,1.0,2074.0,542
5951,1729,2287,0.0,2008.0,-558
5952,2096,1725,1.0,1910.5,371
5953,1652,2108,0.0,1880.0,-456
5954,1701,2253,0.0,1977.0,-552
5955,2308,1859,1.0,2083.5,449
5956,1643,2161,0.0,1902.0,-518
5957,2112,1617,1.0,1864.5,495
5958,2303,1779,1.0,2041.0,524
5959,1719,2248,0.0,1983.5,-529
5960,2231,1611,1.0,1921.0,620
5961,1777,2276,0.0,2026.5,-499
5962,1817,2252,0.0,2034.5,-435
5963,2393,1708,1.0,2050.5,685
5964,1670,2194,0.0,1932.0,-524
5965,2149,1623,1.0,1886.0,526
5966,2431,2159,1.0,2295.0,272
5967,1704,2254,0.0,1979.0,-550
5968,2261,1510,1.0,1885.5,751
5969,1397,2135,0.0,1766.0,-738
5970,1788,2290,0.0,2039.0,-502
5971,2268,1683,0.5,1975.5,585
5972,1735,2198,0.0,1966.5,-463
5973,2060,1559,1.0,1809.5,501
5974,2249,2082,1.0,2165.5,167
5975,1720,2219,0.0,1969.5,-499
5976,2215,1683,1.0,1949.0,532
5977,1274,2186,0.0,1730.0,-912
5978,1840,2369,0.0,2104.5,-529
5979,2202,1719,1.0,1960.5,483
5980,1608,2167,0.0,1887.5,-559
5981,2124,1535,1.0,1829.5,589
5982,1872,2513,0.0,2192.5,-641
5983,2355,1801,1.0,2078.0,554
5984,1725,2370,0.0,2047.5,-645
5985,2274,1353,1.0,1813.5,921
5986,1984,2214,1.0,2099.0,-230
5987,1357,1799,1.0,1578.0,-442
5988,2248,1821,1.0,2034.5,427
5989,1668,2227,0.0,1947.5,-559
5990,2298,1660,1.0,1979.0,638
5991,1540,2188,0.0,1864.0,-648
5992,1909,2330,0.0,2119.5,-421
5993,2224,1774,1.0,1999.0,450
5994,1490,2134,0.5,1812.0,-644
5995,2112,1460,1.0,1786.0,652
5996,2278,1745,1.0,2011.5,533
5997,1702,2172,0.0,1937.0,-470
5998,1980,1573,1.0,1776.5,407
5999,1619,1840,1.0,1729.5,-221
6000,1767,2299,0.0,2033.0,-532
6001,2254,1607,1.0,1930.5,647
6002,1505,2148,0.0,1826.5,-643
6003,2116,1509,0.5,1812.5,607
6004,2188,1863,0.5,2025.5,325
6005,1712,2167,0.0,1939.5,-455
6006,2114,1582,1.0,1848.0,532
6007,1388,2040,0.0,1714.0,-652
6008,1884,2151,0.0,2017.5,-267
6009,2039,1505,1.0,1772.0,534
6010,1357,2222,0.0,1789.5,-865
6011,2034,1583,1.0,1808.5,451
6012,2204,1718,1.0,1961.0,486
6013,1577,2172,0.0,1874.5,-595
6014,2113,1626,1.0,1869.5,487
6015,1528,2146,0.0,1837.0,-618
6016,1666,2195,0.0,1930.5,-529
6017,2170,1755,1.0,1962.5,415
6018,1492,2175,0.0,1833.5,-683
6019,2118,1402,1.0,1760.0,716
6020,2225,1637,1.0,1931.0,588
6021,1581,2207,0.0,1894.0,-626
6022,2144,1581,1.0,1862.5,563
6023,1415,2134,0.5,1774.5,-719
6024,1673,2158,0.0,1915.5,-485
6025,2102,1598,1.0,1850.0,504
6026,1475,2113,0.0,1794.0,-638
6027,1907,1481,1.0,1694.0,426
6028,2268,1414,1.0,1841.0,854
6029,1584,2218,0.0,1901.0,-634
6030,2123,1537,1.0,1830.0,586
6031,1704,2081,0.0,1892.5,-377
6032,1752,2287,0.0,2019.5,-535
6033,2157,1451,1.0,1804.0,706
6034,1379,2113,0.0,1746.0,-734
6035,2102,1545,1.0,1823.5,557
6036,2254,1667,1.0,1960.5,587
6037,1340,2167,0.0,1753.5,-827
6038,2114,1495,1.0,1804.5,619
6039,1378,2009,0.0,1693.5,-631
6040,1546,2255,0.0,1900.5,-709
6041,2174,1378,1.0,1776.0,796
6042,1585,2110,1.0,1847.5,-525
6043,2063,1575,1.0,1819.0,488
6044,2266,1503,1.0,1884.5,763
6045,1502,2124,0.0,1813.0,-622
6046,2156,1479,1.0,1817.5,677
6047,1518,2026,0.0,1772.0,-508
6048,1483,2227,0.0,1855.0,-744
6049,2152,1544,1.0,1848.0,608
6050,1508,1968,0.0,1738.0,-460
6051,1805,1408,1.0,1606.5,397
6052,2181,1471,1.0,1826.0,710
6053,1446,2136,0.0,1791.0,-690
6054,2059,1407,1.0,1733.0,652
6055,1322,1947,0.0,1634.5,-625
6056,1400,2143,0.0,1771.5,-743
6057,1595,2101,0.0,1848.0,-506
6058,2060,1451,1.0,1755.5,609
6059,2159,1346,1.0,1752.5,813
6060,1475,1954,0.0,1714.5,-479
6061,2034,1476,1.0,1755.0,558
6062,1105,1750,0.0,1427.5,-645
6063,1482,2188,0.0,1835.0,-706
6064,2143,1502,1.0,1822.5,641
6065,1412,1849,0.0,1630.5,-437
6066,1635,1206,1.0,1420.5,429
6067,2157,2079,1.0,2118.0,78
6068,1456,2136,0.0,1796.0,-680
6069,2129,2020,0.0,2074.5,109
6070,1439,2126,0.0,1782.5,-687
6071,2079,1334,1.0,1706.5,745
6072,1468,2110,0.0,1789.0,-642
6073,2009,1241,1.0,1625.0,768
6074,2139,1518,1.0,1828.5,621
6075,1174,2075,0.0,1624.5,-901
6076,1950,1350,1.0,1650.0,600
6077,1267,1909,0.0,1588.0,-642
6078,1739,2044,0.0,1891.5,-305
6079,2033,1365,1.0,1699.0,668
6080,1123,2023,0.0,1573.0,-900
6081,1467,2081,0.0,1774.0,-614
6082,1931,1671,1.0,1801.0,260
6083,1034,1911,0.0,1472.5,-877
6084,1998,2058,1.0,2028.0,-60
6085,1458,1062,0.0,1260.0,396
6086,1809,1894,1.0,1851.5,-85
6087,2057,1374,1.0,1715.5,683
6088,1362,1372,0.0,1367.0,-10
6089,1856,2026,1.0,1941.0,-170
6090,1053,1239,0.0,1146.0,-186
6091,1326,1966,0.0,1646.0,-640
6092,1986,2283,1.0,2134.5,-297
6093,1222,1284,0.0,1253.0,-62
6094,1819,2004,1.0,1911.5,-185
6095,2152,1182,1.0,1667.0,970
6096,1263,1437,0.0,1350.0,-174
6097,1974,2022,1.0,1998.0,-48
6098,2031,2037,1.0,2034.0,-6
6099,1117,1070,0.5,1093.5,47
6100,1710,1935,1.0,1822.5,-225
6101,1981,1053,1.0,1517.0,928
6102,1900,1945,1.0,1922.5,-45
6103,1397,1724,0.0,1560.5,-327
6104,1960,2130,1.0,2045.0,-170
6105,1921,1946,1.0,1933.5,-25
6106,2044,1355,1.0,1699.5,689
6107,1948,2010,1.0,1979.0,-62
6108,1308,1919,0.0,1613.5,-611
6109,2052,2082,1.0,2067.0,-30
6110,1806,1961,1.0,1883.5,-155
6111,2008,1870,0.0,1939.0,138
6112,1924,1217,1.0,1570.5,707
6113,2056,2056,1.0,2056.0,0
6114,1901,1862,1.0,1881.5,39
6115,2005,1943,0.0,1974.0,62
6116,1869,1866,0.0,1867.5,3
6117,1923,2345,1.0,2134.0,-422
6118,1655,1924,1.0,1789.5,-269
6119,2176,2113,0.0,2144.5,63
6120,1898,1651,0.0,1774.5,247
6121,1771,2053,1.0,1912.0,-282
6122,2029,1940,1.0,1984.5,89
6123,1874,1926,1.0,1900.0,-52
6124,2115,2100,0.5,2107.5,15
6125,2384,2557,0.5,2470.5,-173
6126,2506,2396,0.0,2451.0,110
6127,2310,2495,0.0,2402.5,-185
6128,2480,2384,1.0,2432.0,96
6129,2354,2495,1.0,2424.5,-141
6130,2333,2203,1.0,2268.0,130
6131,2262,2401,0.0,2331.5,-139
6132,2335,2209,0.0,2272.0,126
6133,2079,2283,0.0,2181.0,-204
6134,2203,2025,0.0,2114.0,178
6135,2503,2506,1.0,2504.5,-3
6136,2420,2594,0.0,2507.0,-174
6137,2455,2472,1.0,2463.5,-17
6138,2476,2501,0.0,2488.5,-25
6139,2431,2360,1.0,2395.5,71
6140,2386,2374,0.0,2380.0,12
6141,2230,2407,0.0,2318.5,-177
6142,2279,2347,0.5,2313.0,-68
6143,2282,2297,1.0,2289.5,-15
6144,2371,2308,1.0,2339.5,63
6145,2497,2642,1.0,2569.5,-145
6146,2572,2251,1.0,2411.5,321
6147,2517,2491,0.5,2504.0,26
6148,2483,2412,0.0,2447.5,71
6149,2377,2366,0.5,2371.5,11
6150,2435,2189,1.0,2312.0,246
6151,2314,2303,0.0,2308.5,11
6152,2224,2203,1.0,2213.5,21
6153,2274,1930,1.0,2102.0,344
6154,2768,2718,0.5,2743.0,50
6155,2742,2720,0.5,2731.0,22
6156,2708,2668,0.0,2688.0,40
6157,2666,2680,0.5,2673.0,-14
6158,2744,2743,0.0,2743.5,1
6159,2724,2717,0.5,2720.5,7
6160,2723,2659,1.0,2691.0,64
6161,2649,2707,0.5,2678.0,-58
6162,2671,2877,1.0,2774.0,-206
6163,2628,2606,0.0,2617.0,22
6164,2563,2528,0.5,2545.5,35
6165,2528,2608,0.0,2568.0,-80
6166,2740,2625,0.5,2682.5,115
6167,2574,2637,0.0,2605.5,-63
6168,2690,2579,0.5,2634.5,111
6169,2561,2704,0.0,2632.5,-143
6170,2772,2735,1.0,2753.5,37
6171,2659,2681,1.0,2670.0,-22
6172,2553,2576,0.0,2564.5,-23
6173,2640,2461,0.5,2550.5,179
6174,2787,2574,1.0,2680.5,213
6175,2574,2659,0.5,2616.5,-85
6176,2653,2564,0.0,2608.5,89
6177,2541,2624,0.0,2582.5,-83
6178,2613,2760,0.0,2686.5,-147
6179,2795,2602,0.5,2698.5,193
6180,2602,2751,1.0,2676.5,-149
6181,2786,2539,1.0,2662.5,247
6182,2709,2645,0.5,2677.0,64
6183,2590,2646,0.5,2618.0,-56
6184,2689,2669,0.0,2679.0,20
6185,2619,2612,0.5,2615.5,7
6186,2745,2700,0.5,2722.5,45
6187,2615,2631,0.5,2623.0,-16
6188,2662,2510,0.5,2586.0,152
6189,2471,2638,1.0,2554.5,-167
6190,2716,2678,0.5,2697.0,38
6191,2580,2676,0.5,2628.0,-96
6192,2634,2595,0.5,2614.5,39
6193,2532,2549,0.5,2540.5,-17
6194,2710,2805,0.5,2757.5,-95
6195,2686,2634,0.5,2660.0,52
6196,2501,2672,1.0,2586.5,-171
6197,2655,2507,1.0,2581.0,148
6198,2760,2713,0.5,2736.5,47
6199,2581,2664,0.0,2622.5,-83
6200,2603,2542,1.0,2572.5,61
6201,2563,2550,0.0,2556.5,13
6202,2531,2698,0.0,2614.5,-167
6203,2624,2559,0.5,2591.5,65
6204,2461,2618,0.0,2539.5,-157
6205,2603,2470,0.5,2536.5,133
6206,2709,2753,0.5,2731.0,-44
6207,2671,2650,0.5,2660.5,21
6208,2572,2656,0.5,2614.0,-84
6209,2624,2524,1.0,2574.0,100
6210,2740,2571,1.0,2655.5,169
6211,2595,2665,0.0,2630.0,-70
6212,2665,2549,0.0,2607.0,116
6213,2559,2650,0.0,2604.5,-91
6214,2536,2632,1.0,2584.0,-96
6215,2589,2543,0.5,2566.0,46
6216,2448,2569,0.0,2508.5,-121
6217,2614,2426,0.5,2520.0,188
6218,2602,2649,0.5,2625.5,-47
6219,2570,2571,1.0,2570.5,-1
6220,2586,2568,0.5,2577.0,18
6221,2522,2487,0.5,2504.5,35
6222,2544,2549,0.5,2546.5,-5
6223,2505,2606,0.0,2555.5,-101
6224,2435,2461,0.5,2448.0,-26
6225,2365,2447,1.0,2406.0,-82
6226,2489,2500,0.5,2494.5,-11
6227,2477,2382,0.0,2429.5,95
6228,2387,2440,0.0,2413.5,-53
6229,2353,2391,0.5,2372.0,-38
6230,2544,2527,0.0,2535.5,17
6231,2400,2517,0.0,2458.5,-117
6232,2250,2467,0.5,2358.5,-217
6233,2611,2663,0.0,2637.0,-52
6234,2629,2433,1.0,2531.0,196
6235,2328,2630,0.0,2479.0,-302
6236,2553,2251,1.0,2402.0,302
6237,2521,2801,0.0,2661.0,-280
6238,2587,2437,1.0,2512.0,150
6239,2486,2560,1.0,2523.0,-74
6240,2530,2427,0.5,2478.5,103
6241,2578,2311,0.0,2444.5,267
6242,2309,2474,0.0,2391.5,-165
6243,2448,2143,0.0,2295.5,305
6244,2121,2423,0.0,2272.0,-302
6245,2594,2627,0.0,2610.5,-33
6246,2466,2598,0.0,2532.0,-132
6247,2499,2589,0.0,2544.0,-90
6248,2486,2490,0.5,2488.0,-4
6249,2644,2654,0.0,2649.0,-10
6250,2547,2602,0.5,2574.5,-55
6251,2323,2467,1.0,2395.0,-144
6252,2396,2277,0.0,2336.5,119
6253,2590,2462,1.0,2526.0,128
6254,2439,2410,1.0,2424.5,29
6255,2337,2402,0.0,2369.5,-65
6256,2334,2301,1.0,2317.5,33
6257,2484,2562,0.5,2523.0,-78
6258,2522,2464,0.0,2493.0,58
6259,2500,2525,0.5,2512.5,-25
6260,2477,2426,0.5,2451.5,51
6261,2659,2471,1.0,2565.0,188
6262,2330,2618,0.0,2474.0,-288
6263,2569,2380,1.0,2474.5,189
6264,2189,2490,0.0,2339.5,-301
6265,2622,2545,1.0,2583.5,77
6266,2535,2593,0.5,2564.0,-58
6267,2473,2508,0.5,2490.5,-35
6268,2491,2528,0.0,2509.5,-37
6269,2591,2297,1.0,2444.0,294
6270,2282,2437,1.0,2359.5,-155
6271,2431,2231,1.0,2331.0,200
6272,2246,2445,0.5,2345.5,-199
6273,2329,2523,0.5,2426.0,-194
6274,2522,2126,1.0,2324.0,396
6275,2258,2421,0.0,2339.5,-163
6276,2418,2165,1.0,2291.5,253
6277,2354,2388,1.0,2371.0,-34
6278,2279,2368,0.0,2323.5,-89
6279,2229,2155,1.0,2192.0,74
6280,2590,2106,1.0,2348.0,484
6281,2332,2472,0.0,2402.0,-140
6282,2363,2526,1.0,2444.5,-163
6283,2150,2283,0.0,2216.5,-133
6284,2441,2405,0.0,2423.0,36
6285,2373,2344,1.0,2358.5,29
6286,2419,2431,1.0,2425.0,-12
6287,2024,2252,0.0,2138.0,-228
6288,2197,2347,0.5,2272.0,-150
6289,2416,2581,1.0,2498.5,-165
6290,2187,2168,0.5,2177.5,19
6291,2382,2284,1.0,2333.0,98
6292,2502,2156,0.0,2329.0,346
6293,2405,2317,0.5,2361.0,88
6294,2382,2495,1.0,2438.5,-113
6295,2121,2250,0.5,2185.5,-129
6296,2261,2323,0.0,2292.0,-62
6297,2608,2641,1.0,2624.5,-33
6298,2244,2299,0.0,2271.5,-55
6299,2526,2544,1.0,2535.0,-18
6300,2170,2138,0.0,2154.0,32
6301,2556,2644,1.0,2600.0,-88
6302,2105,2320,0.5,2212.5,-215
6303,2447,2432,1.0,2439.5,15
6304,2215,2145,0.5,2180.0,70
6305,2172,2317,1.0,2244.5,-145
6306,2156,2214,0.5,2185.0,-58
6307,2105,2173,0.5,2139.0,-68
6308,2469,2116,1.0,2292.5,353
6309,2457,2533,1.0,2495.0,-76
6310,2384,2406,0.5,2395.0,-22
6311,2398,2455,0.5,2426.5,-57
6312,2378,2303,0.5,2340.5,75
6313,2106,2216,1.0,2161.0,-110
6314,2289,2399,1.0,2344.0,-110
6315,2188,1946,1.0,2067.0,242
6316,2366,2236,0.0,2301.0,130
6317,2361,2507,0.5,2434.0,-146
6318,2311,2383,0.0,2347.0,-72
6319,2256,2320,0.0,2288.0,-64
6320,2222,2177,0.5,2199.5,45
6321,2392,2413,1.0,2402.5,-21
6322,2195,2193,0.0,2194.0,2
6323,2266,2273,0.0,2269.5,-7
6324,2396,2144,1.0,2270.0,252
6325,2118,2243,0.0,2180.5,-125
6326,2082,2180,1.0,2131.0,-98
6327,2070,2221,0.5,2145.5,-151
6328,2525,2139,1.0,2332.0,386
6329,2166,2259,0.5,2212.5,-93
6330,2374,2296,1.0,2335.0,78
6331,2103,2222,0.0,2162.5,-119
6332,2591,2291,1.0,2441.0,300
6333,1803,2067,0.0,1935.0,-264
6334,2277,2350,0.5,2313.5,-73
6335,2311,2081,0.0,2196.0,230
6336,2387,2225,0.0,2306.0,162
6337,2333,2438,0.0,2385.5,-105
6338,2277,2392,1.0,2334.5,-115
6339,2157,2286,0.5,2221.5,-129
6340,2390,2239,1.0,2314.5,151
6341,2110,2236,0.0,2173.0,-126
6342,2501,2411,1.0,2456.0,90
6343,2069,2104,0.0,2086.5,-35
6344,2448,2418,1.0,2433.0,30
6345,2222,2365,1.0,2293.5,-143
6346,2181,2172,0.0,2176.5,9
6347,2326,2315,1.0,2320.5,11
6348,2225,2280,1.0,2252.5,-55
6349,2140,2226,1.0,2183.0,-86
6350,2263,2245,1.0,2254.0,18
6351,2255,2333,1.0,2294.0,-78
6352,2246,2085,0.5,2165.5,161
6353,2190,2425,0.0,2307.5,-235
6354,2435,2272,1.0,2353.5,163
6355,2275,2346,1.0,2310.5,-71
6356,2068,2305,0.0,2186.5,-237
6357,2318,2449,0.5,2383.5,-131
6358,1980,2061,0.0,2020.5,-81
6359,2316,2365,1.0,2340.5,-49
6360,2164,2137,1.0,2150.5,27
6361,2125,2272,1.0,2198.5,-147
6362,2024,2056,1.0,2040.0,-32
6363,1846,1760,1.0,1803.0,86
6364,2141,2090,0.0,2115.5,51
6365,2251,2143,0.0,2197.0,108
6366,2154,2164,0.0,2159.0,-10
6367,2106,2169,1.0,2137.5,-63
6368,2307,2093,1.0,2200.0,214
6369,1952,2131,0.5,2041.5,-179
6370,2170,2186,1.0,2178.0,-16
6371,2283,2160,0.5,2221.5,123
6372,2268,2335,1.0,2301.5,-67
6373,2166,2239,0.0,2202.5,-73
6374,2414,2202,1.0,2308.0,212
6375,1931,2054,0.0,1992.5,-123
6376,2210,2244,1.0,2227.0,-34
6377,1928,2125,1.0,2026.5,-197
6378,1985,2125,0.0,2055.0,-140
6379,2081,1933,1.0,2007.0,148
6380,1977,2120,0.0,2048.5,-143
6381,2121,2030,0.0,2075.5,91
6382,2083,2113,1.0,2098.0,-30
6383,2105,2121,1.0,2113.0,-16
6384,2087,2057,0.0,2072.0,30
6385,2042,1929,0.5,1985.5,113
6386,1937,2183,1.0,2060.0,-246
6387,2112,1883,1.0,1997.5,229
6388,1969,2253,0.0,2111.0,-284
6389,2014,1892,1.0,1953.0,122
6390,2408,2256,0.5,2332.0,152
6391,2249,2323,0.5,2286.0,-74
6392,2236,2321,0.0,2278.5,-85
6393,2352,2211,1.0,2281.5,141
6394,2523,2121,1.0,2322.0,402
6395,2194,2222,0.5,2208.0,-28
6396,2176,2218,0.0,2197.0,-42
6397,2141,2117,0.0,2129.0,24
6398,2154,2341,0.0,2247.5,-187
6399,2296,2139,1.0,2217.5,157
6400,2084,2125,0.5,2104.5,-41
6401,1965,1979,0.0,1972.0,-14
6402,1779,2024,0.0,1901.5,-245
6403,2002,1688,0.0,1845.0,314
6404,1689,1802,1.0,1745.5,-113
6405,2012,1920,0.0,1966.0,92
6406,1883,1893,0.0,1888.0,-10
6407,1606,1808,1.0,1707.0,-202
6408,2055,1911,0.0,1983.0,144
6409,2190,2055,1.0,2122.5,135
6410,1904,1964,0.0,1934.0,-60
6411,1653,1854,0.0,1753.5,-201
6412,2046,2085,0.5,2065.5,-39
6413,1479,1577,0.5,1528.0,-98
6414,2106,1466,0.5,1786.0,640
6415,1951,2123,1.0,2037.0,-172
6416,1858,2111,0.0,1984.5,-253
6417,1972,2036,0.0,2004.0,-64
6418,2060,1878,1.0,1969.0,182
6419,2060,2070,0.0,2065.0,-10
6420,2115,2017,0.5,2066.0,98
6421,2056,1944,0.0,2000.0,112
6422,2074,2000,1.0,2037.0,74
6423,2034,2051,1.0,2042.5,-17
6424,1565,1917,0.0,1741.0,-352
6425,2201,1950,1.0,2075.5,251
6426,1802,1993,0.0,1897.5,-191
6427,2270,1817,1.0,2043.5,453
6428,1830,2119,0.0,1974.5,-289
6429,1889,1532,1.0,1710.5,357
6430,1829,2114,1.0,1971.5,-285
6431,1751,1873,0.0,1812.0,-122
6432,2011,2183,0.0,2097.0,-172
6433,2048,1987,1.0,2017.5,61
6434,1952,2139,1.0,2045.5,-187
6435,2099,1817,0.0,1958.0,282
6436,1746,2039,0.0,1892.5,-293
6437,1944,2044,0.0,1994.0,-100
6438,2075,1312,0.0,1693.5,763
6439,2085,1707,0.0,1896.0,378
6440,1922,2001,0.0,1961.5,-79
6441,2032,1799,0.5,1915.5,233
6442,1685,2020,0.0,1852.5,-335
6443,1996,1828,1.0,1912.0,168
6444,1630,2036,0.0,1833.0,-406
6445,2031,1724,0.5,1877.5,307
6446,1777,1920,1.0,1848.5,-143
6447,1953,2036,1.0,1994.5,-83
6448,1833,1841,0.0,1837.0,-8
6449,2180,1908,1.0,2044.0,272
6450,1580,1645,1.0,1612.5,-65
6451,1845,1909,0.0,1877.0,-64
6452,1720,1848,0.0,1784.0,-128
6453,1668,1783,0.0,1725.5,-115
6454,1899,1844,1.0,1871.5,55
6455,2604,2372,1.0,2488.0,232
6456,2329,2503,0.0,2416.0,-174
6457,2473,2226,1.0,2349.5,247
6458,2132,2373,0.5,2252.5,-241
6459,2653,2288,1.0,2470.5,365
6460,2357,2448,0.0,2402.5,-91
6461,2390,2299,0.5,2344.5,91
6462,2312,2313,0.0,2312.5,-1
6463,2735,2718,0.5,2726.5,17
6464,2742,2659,1.0,2700.5,83
6465,2576,2668,0.0,2622.0,-92
6466,2666,2640,0.5,2653.0,26
6467,2740,2717,0.5,2728.5,23
6468,2723,2637,0.5,2680.0,86
6469,2690,2680,0.5,2685.0,10
6470,2707,2704,0.5,2705.5,3
6471,2630,2311,1.0,2470.5,319
6472,2309,2628,0.0,2468.5,-319
6473,2528,2143,1.0,2335.5,385
6474,2121,2528,0.0,2324.5,-407
6475,2760,2768,0.5,2764.0,-8
6476,2720,2795,0.5,2757.5,-75
6477,2786,2708,0.5,2747.0,78
6478,2680,2714,0.0,2697.0,-34
6479,2743,2787,1.0,2765.0,-44
6480,2706,2724,0.5,2715.0,-18
6481,2659,2659,0.5,2659.0,0
6482,2624,2649,0.5,2636.5,-25
6483,2645,2700,1.0,2672.5,-55
6484,2615,2590,0.0,2602.5,25
6485,2669,2510,1.0,2589.5,159
6486,2471,2619,0.5,2545.0,-148
6487,2760,2740,0.5,2750.0,20
6488,2665,2664,0.0,2664.5,1
6489,2649,2650,0.5,2649.5,-1
6490,2653,2603,0.5,2628.0,50
6491,2698,2710,1.0,2704.0,-12
6492,2634,2624,1.0,2629.0,10
6493,2620,2501,1.0,2560.5,119
6494,2439,2618,0.5,2528.5,-179
6495,2753,2671,1.0,2712.0,82
6496,2606,2671,0.5,2638.5,-65
6497,2624,2563,1.0,2593.5,61
6498,2608,2651,1.0,2629.5,-43
6499,2805,2716,1.0,2760.5,89
6500,2676,2686,0.0,2681.0,-10
6501,2672,2634,0.5,2653.0,38
6502,2549,2655,0.5,2602.0,-106
6503,2678,2772,0.5,2725.0,-94
6504,2681,2580,0.5,2630.5,101
6505,2595,2553,0.5,2574.0,42
6506,2548,2532,0.0,2540.0,16
6507,2625,2649,0.5,2637.0,-24
6508,2570,2574,0.5,2572.0,-4
6509,2579,2568,0.5,2573.5,11
6510,2583,2554,0.5,2568.5,29
6511,2644,2745,0.0,2694.5,-101
6512,2631,2602,1.0,2616.5,29
6513,2455,2664,0.0,2559.5,-209
6514,2662,2277,1.0,2469.5,385
6515,2513,2646,0.5,2579.5,-133
6516,2639,2462,1.0,2550.5,177
6517,2439,2689,1.0,2564.0,-250
6518,2612,2334,0.5,2473.0,278
6519,2613,2544,1.0,2578.5,69
6520,2517,2602,0.0,2559.5,-85
6521,2602,2519,0.5,2560.5,83
6522,2467,2554,0.0,2510.5,-87
6523,2549,2574,0.5,2561.5,-25
6524,2574,2505,0.5,2539.5,69
6525,2461,2564,0.0,2512.5,-103
6526,2562,2365,1.0,2463.5,197
6527,2627,2536,1.0,2581.5,91
6528,2543,2487,0.5,2515.0,56
6529,2589,2426,1.0,2507.5,163
6530,2555,2486,0.0,2520.5,69
6531,2663,2801,0.5,2732.0,-138
6532,2565,2629,0.0,2597.0,-64
6533,2630,2587,1.0,2608.5,43
6534,2530,2553,0.0,2541.5,-23
6535,2632,2544,0.5,2588.0,88
6536,2606,2589,0.5,2597.5,17
6537,2529,2435,1.0,2482.0,94
6538,2402,2614,0.0,2508.0,-212
6539,2354,2484,1.0,2419.0,-130
6540,2487,2368,0.0,2427.5,119
6541,2229,2464,0.0,2346.5,-235
6542,2500,2106,0.0,2303.0,394
6543,2709,2602,1.0,2655.5,107
6544,2571,2650,1.0,2610.5,-79
6545,2572,2586,1.0,2579.0,-14
6546,2487,2496,1.0,2491.5,-9
6547,2581,2489,0.5,2535.0,92
6548,2427,2416,0.0,2421.5,11
6549,2382,2387,0.5,2384.5,-5
6550,2391,2061,1.0,2226.0,330
6551,2578,2604,0.5,2591.0,-26
6552,2522,2473,0.5,2497.5,49
6553,2448,2503,0.5,2475.5,-55
6554,2473,2423,0.5,2448.0,50
6555,2713,2659,0.5,2686.0,54
6556,2618,2618,0.5,2618.0,0
6557,2542,2569,0.5,2555.5,-27
6558,2490,2563,0.5,2526.5,-73
6559,2500,2591,0.0,2545.5,-91
6560,2431,2450,0.5,2440.5,-19
6561,2440,2425,0.5,2432.5,15
6562,2445,2353,1.0,2399.0,92
6563,2653,2531,0.5,2592.0,122
6564,2559,2390,0.5,2474.5,169
6565,2318,2470,0.5,2394.0,-152
6566,2425,2313,0.5,2369.0,112
6567,2523,2571,0.5,2547.0,-48
6568,2549,2522,1.0,2535.5,27
6569,2421,2559,0.0,2490.0,-138
6570,2554,2453,0.5,2503.5,101
6571,2590,2622,0.5,2606.0,-32
6572,2593,2526,0.5,2559.5,67
6573,2438,2473,1.0,2455.5,-35
6574,2528,2405,1.0,2466.5,123
6575,2644,2431,0.5,2537.5,213
6576,2419,2641,0.0,2530.0,-222
6577,2544,2347,1.0,2445.5,197
6578,2349,2526,0.0,2437.5,-177
6579,2644,2525,1.0,2584.5,119
6580,2374,2556,1.0,2465.0,-182
6581,2432,2374,0.5,2403.0,58
6582,2291,2447,0.5,2369.0,-156
6583,2527,2507,1.0,2517.0,20
6584,2361,2400,0.0,2380.5,-39
6585,2256,2320,1.0,2288.0,-64
6586,2317,2250,0.0,2283.5,67
6587,2598,2594,0.5,2596.0,4
6588,2173,2172,0.0,2172.5,1
6589,2490,2499,1.0,2494.5,-9
6590,2654,2105,1.0,2379.5,549
6591,2405,2317,1.0,2361.0,88
6592,2203,2467,1.0,2335.0,-264
6593,2193,2121,0.5,2157.0,72
6594,2416,2396,0.5,2406.0,20
6595,2180,2396,0.0,2288.0,-216
6596,2392,2413,1.0,2402.5,-21
6597,2139,2254,0.0,2196.5,-115
6598,2216,2273,0.5,2244.5,-57
6599,2433,2611,0.5,2522.0,-178
6600,1946,2106,0.0,2026.0,-160
6601,2251,2328,1.0,2289.5,-77
6602,2590,2188,1.0,2389.0,402
6603,2350,2591,0.5,2470.5,-241
6604,2337,2410,0.5,2373.5,-73
6605,2225,2277,0.0,2251.0,-52
6606,2344,2181,1.0,2262.5,163
6607,2505,2521,1.0,2513.0,-16
6608,2252,2373,0.0,2312.5,-121
6609,2427,2486,0.0,2456.5,-59
6610,2414,2183,1.0,2298.5,231
6611,2495,2502,1.0,2498.5,-7
6612,2210,2244,0.5,2227.0,-34
6613,2323,2419,1.0,2371.0,-96
6614,2535,2177,1.0,2356.0,358
6615,2330,2471,0.5,2400.5,-141
6616,2491,2508,0.0,2499.5,-17
6617,2189,2380,0.0,2284.5,-191
6618,2387,2411,0.0,2399.0,-24
6619,2085,2263,0.0,2174.0,-178
6620,2277,2392,0.0,2334.5,-115
6621,2272,2246,0.0,2259.0,26
6622,2533,2239,1.0,2386.0,294
6623,2253,2112,0.0,2182.5,141
6624,2455,2457,1.0,2456.0,-2
6625,2065,2014,0.0,2039.5,51
6626,2137,2398,0.0,2267.5,-261
6627,2463,2448,1.0,2455.5,15
6628,2057,2105,0.0,2081.0,-48
6629,2222,2365,0.5,2293.5,-143
6630,2329,2042,0.0,2185.5,287
6631,2390,2513,0.5,2451.5,-123
6632,2258,2126,0.5,2192.0,132
6633,2501,2411,1.0,2456.0,90
6634,2388,2165,0.0,2276.5,223
6635,2350,2297,0.0,2323.5,53
6636,2155,2279,0.5,2217.0,-124
6637,2246,2282,1.0,2264.0,-36
6638,2335,2469,0.5,2402.0,-134
6639,2406,2268,1.0,2337.0,138
6640,2224,2303,0.5,2263.5,-79
6641,2472,2315,0.5,2393.5,157
6642,2326,2332,0.0,2329.0,-6
6643,2283,2226,1.0,2254.5,57
6644,2140,2150,1.0,2145.0,-10
6645,2449,2063,1.0,2256.0,386
6646,2125,2318,0.5,2221.5,-193
6647,2365,2081,0.0,2223.0,284
6648,2120,2316,1.0,2218.0,-196
6649,2143,2307,0.0,2225.0,-164
6650,2157,2251,1.0,2204.0,-94
6651,2169,2186,0.0,2177.5,-17
6652,2170,2106,1.0,2138.0,64
6653,2378,2197,0.5,2287.5,181
6654,2168,2333,0.0,2250.5,-165
6655,2289,2187,1.0,2238.0,102
6656,2156,2236,0.5,2196.0,-80
6657,2215,2218,0.0,2216.5,-3
6658,1688,1779,0.0,1733.5,-91
6659,2156,2214,0.5,2185.0,-58
6660,2334,1689,1.0,2011.5,645
6661,2366,2387,1.0,2376.5,-21
6662,2299,2261,1.0,2280.0,38
6663,2177,2383,0.5,2280.0,-206
6664,2243,2244,0.0,2243.5,-1
6665,2249,2256,1.0,2252.5,-7
6666,2261,2118,0.0,2189.5,143
6667,2352,2321,1.0,2336.5,31
6668,2425,2070,1.0,2247.5,355
6669,2170,2508,0.0,2339.0,-338
6670,2166,2259,1.0,2212.5,-93
6671,2105,2320,0.5,2212.5,-215
6672,2067,2103,1.0,2085.0,-36
6673,2056,2164,1.0,2110.0,-108
6674,2081,1803,0.0,1942.0,278
6675,2090,2087,0.5,2088.5,3
6676,2272,2222,1.0,2247.0,50
6677,2193,2085,1.0,2139.0,108
6678,2125,2195,0.5,2160.0,-70
6679,2144,1846,1.0,1995.0,298
6680,2341,2523,0.5,2432.0,-182
6681,2222,2277,1.0,2249.5,-55
6682,2296,2122,0.0,2209.0,174
6683,2117,2125,0.0,2121.0,-8
6684,2438,1937,1.0,2187.5,501
6685,1883,2333,0.0,2108.0,-450
6686,2239,1828,1.0,2033.5,411
6687,1892,2157,0.0,2024.5,-265
6688,1920,2060,0.0,1990.0,-140
6689,2017,1883,1.0,1950.0,134
6690,1808,2115,1.0,1961.5,-307
6691,2280,2181,1.0,2230.5,99
6692,2245,2225,0.0,2235.0,20
6693,2270,2068,1.0,2169.0,202
6694,2061,1976,1.0,2018.5,85
6695,1889,1980,0.0,1934.5,-91
6696,2054,2283,0.0,2168.5,-229
6697,2239,1931,0.0,2085.0,308
6698,1928,2166,0.0,2047.0,-238
6699,2255,2055,1.0,2155.0,200
6700,2063,2425,0.5,2244.0,-362
6701,2272,2190,0.5,2231.0,82
6702,1964,2190,0.0,2077.0,-226
6703,2083,2164,0.0,2123.5,-81
6704,2154,2121,1.0,2137.5,33
6705,2024,2067,0.0,2045.5,-43
6706,2093,1929,0.5,2011.0,164
6707,2194,2131,1.0,2162.5,63
6708,2114,2236,0.0,2175.0,-122
6709,2110,1873,0.0,1991.5,237
6710,1846,2069,0.5,1957.5,-223
6711,2078,1884,0.5,1981.0,194
6712,2123,2201,0.5,2162.0,-78
6713,1993,1951,1.0,1972.0,42
6714,2036,2026,0.5,2031.0,10
6715,2064,1963,1.0,2013.5,101
6716,1933,1985,0.5,1959.0,-52
6717,2046,2085,0.0,2065.5,-39
6718,2030,1977,1.0,2003.5,53
6719,2068,2408,0.0,2238.0,-340
6720,2323,2070,1.0,2196.5,253
6721,2024,2236,0.0,2130.0,-212
6722,2224,2002,1.0,2113.0,222
6723,1944,2085,0.5,2014.5,-141
6724,2001,1910,1.0,1955.5,91
6725,2074,2032,1.0,2053.0,42
6726,2020,2051,1.0,2035.5,-31
6727,2183,2154,1.0,2168.5,29
6728,2139,2048,0.0,2093.5,91
6729,2079,2084,0.5,2081.5,-5
6730,2011,2139,0.5,2075.0,-128
6731,2056,1880,1.0,1968.0,176
6732,1952,1987,0.0,1969.5,-35
6733,1917,2034,0.5,1975.5,-117
6734,2121,1817,1.0,1969.0,304
6735,2044,1746,0.0,1895.0,298
6736,2218,2194,1.0,2206.0,24
6737,1653,2141,0.0,1897.0,-488
6738,2036,1996,0.5,2016.0,40
6739,1479,1577,0.0,1528.0,-98
6740,1920,2031,0.0,1975.5,-111
6741,1909,2039,0.0,1974.0,-130
6742,1729,1312,1.0,1520.5,417
6743,1817,2106,0.5,1961.5,-289
6744,2111,1830,1.0,1970.5,281
6745,1532,1858,0.0,1695.0,-326
6746,1948,1908,0.0,1928.0,40
6747,1844,1645,0.5,1744.5,199
6748,1580,1899,0.5,1739.5,-319
6749,1950,1963,0.0,1956.5,-13
6750,1755,1802,0.0,1778.5,-47
6751,2070,2012,0.0,2041.0,58
6752,1893,2060,1.0,1976.5,-167
6753,2036,1953,1.0,1994.5,83
6754,1707,1922,1.0,1814.5,-215
6755,1799,1751,0.0,1775.0,48
6756,1828,1685,1.0,1756.5,143
6757,1848,1845,0.0,1846.5,3
6758,1724,1630,1.0,1677.0,94
6759,1723,1720,1.0,1721.5,3
6760,1783,1817,1.0,1800.0,-34
6761,1841,1668,0.5,1754.5,173
6762,2425,1833,0.0,2129.0,592
6763,2346,2435,0.0,2390.5,-89
6764,2357,2288,1.0,2322.5,69
6765,2305,2275,0.5,2290.0,30
6766,2329,2299,1.0,2314.0,30
6767,2522,2562,1.0,2542.0,-40
6768,2226,2114,0.0,2170.0,112
6769,2477,2533,1.0,2505.0,-56
6770,2555,2132,0.5,2343.5,423
6771,2524,2540,0.5,2532.0,-16
6772,2487,2530,0.5,2508.5,-43
6773,2484,2531,0.0,2507.5,-47
6774,2189,2468,0.0,2328.5,-279
6775,2334,2229,0.5,2281.5,105
6776,2213,2166,0.5,2189.5,47
6777,2274,2286,1.0,2280.0,-12
6778,2661,2182,1.0,2421.5,479
6779,2424,2395,0.5,2409.5,29
6780,2468,2559,0.0,2513.5,-91
6781,2314,2385,0.5,2349.5,-71
6782,2464,2453,1.0,2458.5,11
6783,2404,2422,0.5,2413.0,-18
6784,2301,2364,1.0,2332.5,-63
6785,2354,2446,1.0,2400.0,-92
6786,2550,2318,1.0,2434.0,232
6787,2398,2470,0.0,2434.0,-72
6788,2475,2494,0.5,2484.5,-19
6789,2359,2380,0.5,2369.5,-21
6790,2336,2435,1.0,2385.5,-99
6791,2375,2480,0.0,2427.5,-105
6792,2289,2375,0.5,2332.0,-86
6793,2318,2316,0.5,2317.0,2
6794,2358,2252,0.5,2305.0,106
6795,2342,2505,0.5,2423.5,-163
6796,2338,2383,0.0,2360.5,-45
6797,2303,2325,0.5,2314.0,-22
6798,2269,2214,1.0,2241.5,55
6799,2453,2490,0.5,2471.5,-37
6800,2113,2318,0.0,2215.5,-205
6801,2313,2275,1.0,2294.0,38
6802,2236,2102,0.0,2169.0,134
6803,2418,2521,0.5,2469.5,-103
6804,2169,2153,0.0,2161.0,16
6805,2318,2392,1.0,2355.0,-74
6806,2215,2123,1.0,2169.0,92
6807,2141,2228,1.0,2184.5,-87
6808,2289,2237,0.5,2263.0,52
6809,2044,2127,0.0,2085.5,-83
6810,2307,2271,0.5,2289.0,36
6811,2466,2474,1.0,2470.0,-8
6812,2171,2269,0.0,2220.0,-98
6813,2252,2366,0.0,2309.0,-114
6814,2367,2331,0.5,2349.0,36
6815,2095,2170,0.5,2132.5,-75
6816,2235,2282,0.5,2258.5,-47
6817,1862,2100,0.0,1981.0,-238
6818,2485,2121,0.0,2303.0,364
6819,2346,2410,0.0,2378.0,-64
6820,2327,2347,0.0,2337.0,-20
6821,2123,2109,0.5,2116.0,14
6822,2407,2274,1.0,2340.5,133
6823,2397,2396,0.5,2396.5,1
6824,2032,2261,0.0,2146.5,-229
6825,2128,2206,0.0,2167.0,-78
6826,2425,2020,0.5,2222.5,405
6827,2240,2299,1.0,2269.5,-59
6828,2323,2297,1.0,2310.0,26
6829,2180,2170,0.0,2175.0,10
6830,2391,2145,1.0,2268.0,246
6831,2210,2368,0.0,2289.0,-158
6832,2317,2324,1.0,2320.5,-7
6833,2186,2210,0.5,2198.0,-24
6834,2251,2314,0.0,2282.5,-63
6835,2177,2012,0.0,2094.5,165
6836,2043,2259,0.5,2151.0,-216
6837,1800,1859,0.0,1829.5,-59
6838,2327,2221,0.5,2274.0,106
6839,2170,2386,1.0,2278.0,-216
6840,2291,2281,0.5,2286.0,10
6841,2032,2117,0.5,2074.5,-85
6842,2278,2074,1.0,2176.0,204
6843,2205,2214,0.5,2209.5,-9
6844,2247,2347,0.5,2297.0,-100
6845,2165,2098,0.0,2131.5,67
6846,2456,2217,0.0,2336.5,239
6847,2136,2241,0.0,2188.5,-105
6848,2135,2189,0.0,2162.0,-54
6849,2109,2089,1.0,2099.0,20
6850,2049,2131,0.0,2090.0,-82
6851,2269,2352,1.0,2310.5,-83
6852,1895,1999,0.0,1947.0,-104
6853,2147,2232,0.5,2189.5,-85
6854,2122,1943,0.5,2032.5,179
6855,2275,2312,1.0,2293.5,-37
6856,2019,1969,0.0,1994.0,50
6857,2198,2276,1.0,2237.0,-78
6858,2345,1960,1.0,2152.5,385
6859,2052,1811,1.0,1931.5,241
6860,2317,2324,1.0,2320.5,-7
6861,1938,1972,0.0,1955.0,-34
6862,2500,2291,1.0,2395.5,209
6863,2094,2205,1.0,2149.5,-111
6864,2257,2235,1.0,2246.0,22
6865,1999,2068,0.5,2033.5,-69
6866,2296,2000,0.5,2148.0,296
6867,1782,2024,0.0,1903.0,-242
6868,2190,2291,1.0,2240.5,-101
6869,1768,1747,0.0,1757.5,21
6870,2021,2156,1.0,2088.5,-135
6871,1916,1964,1.0,1940.0,-48
6872,1698,2004,0.0,1851.0,-306
6873,1860,1886,1.0,1873.0,-26
6874,2394,1785,0.0,2089.5,609
6875,2196,2293,1.0,2244.5,-97
6876,1913,2077,0.0,1995.0,-164
6877,2032,2070,1.0,2051.0,-38
6878,2226,2027,0.5,2126.5,199
6879,2120,2401,0.0,2260.5,-281
6880,2026,2222,0.5,2124.0,-196
6881,2095,2171,1.0,2133.0,-76
6882,2273,2000,1.0,2136.5,273
6883,1903,2020,0.5,1961.5,-117
6884,1915,1982,0.0,1948.5,-67
6885,1877,1692,1.0,1784.5,185
6886,1938,1839,0.0,1888.5,99
6887,2044,2165,1.0,2104.5,-121
6888,1947,2064,0.0,2005.5,-117
6889,1953,2048,0.5,2000.5,-95
6890,1892,1874,0.0,1883.0,18
6891,2205,2294,1.0,2249.5,-89
6892,1798,1840,1.0,1819.0,-42
6893,1815,2127,1.0,1971.0,-312
6894,2169,1627,1.0,1898.0,542
6895,1950,1973,0.5,1961.5,-23
6896,1954,2065,1.0,2009.5,-111
6897,1804,1947,0.0,1875.5,-143
6898,2207,1782,1.0,1994.5,425
6899,2211,2112,1.0,2161.5,99
6900,2118,2096,0.0,2107.0,22
6901,1687,1791,0.0,1739.0,-104
6902,1986,2008,0.5,1997.0,-22
6903,1997,2016,0.5,2006.5,-19
6904,1899,1877,0.0,1888.0,22
6905,1950,1939,1.0,1944.5,11
6906,1899,1906,1.0,1902.5,-7
6907,2076,2188,1.0,2132.0,-112
6908,1846,1920,1.0,1883.0,-74
6909,1874,1922,1.0,1898.0,-48
6910,2178,1764,1.0,1971.0,414
6911,1756,1991,0.0,1873.5,-235
6912,1944,2060,1.0,2002.0,-116
6913,1805,1732,1.0,1768.5,73
6914,2103,1873,0.0,1988.0,230
6915,1968,2085,0.5,2026.5,-117
6916,1904,1975,0.0,1939.5,-71
6917,1920,1971,1.0,1945.5,-51
6918,2229,1663,0.5,1946.0,566
6919,2089,2113,0.0,2101.0,-24
6920,1942,2008,0.0,1975.0,-66
6921,1882,1982,1.0,1932.0,-100
6922,1890,2045,1.0,1967.5,-155
6923,1693,1781,1.0,1737.0,-88
6924,2173,1763,0.5,1968.0,410
6925,1552,2422,0.0,1987.0,-870
6926,2119,2098,1.0,2108.5,21
6927,1519,2122,0.0,1820.5,-603
6928,1715,1777,0.0,1746.0,-62
6929,1478,1723,0.5,1600.5,-245
6930,1624,1727,1.0,1675.5,-103
6931,1838,1874,0.5,1856.0,-36
6932,1677,1749,0.5,1713.0,-72
6933,1752,1565,1.0,1658.5,187
6934,1918,1778,0.5,1848.0,140
6935,1735,1713,0.5,1724.0,22
6936,1769,1762,1.0,1765.5,7
6937,1723,1774,0.0,1748.5,-51
6938,1935,2107,0.5,2021.0,-172
6939,1921,1734,1.0,1827.5,187
6940,1731,1709,0.0,1720.0,22
6941,1687,1830,0.5,1758.5,-143
6942,2010,1820,1.0,1915.0,190
6943,1541,1974,0.0,1757.5,-433
6944,1831,1346,1.0,1588.5,485
6945,1536,1994,0.0,1765.0,-458
6946,1734,1676,1.0,1705.0,58
6947,1632,1616,0.0,1624.0,16
6948,2102,1727,1.0,1914.5,375
6949,1576,1980,0.5,1778.0,-404
6950,1893,1534,1.0,1713.5,359
6951,1538,1626,0.0,1582.0,-88
6952,1862,2112,0.5,1987.0,-250
6953,1941,1869,0.0,1905.0,72
6954,1657,1844,0.0,1750.5,-187
6955,1972,1599,1.0,1785.5,373
6956,2147,2262,1.0,2204.5,-115
6957,1994,2001,1.0,1997.5,-7
6958,1995,1849,1.0,1922.0,146
6959,1812,1984,0.0,1898.0,-172
6960,1964,1712,1.0,1838.0,252
6961,1738,2017,0.0,1877.5,-279
6962,1698,1481,0.5,1589.5,217
6963,2017,1681,0.0,1849.0,336
6964,1808,1833,1.0,1820.5,-25
6965,1860,1724,1.0,1792.0,136
6966,1501,1811,0.0,1656.0,-310
6967,1747,1461,0.5,1604.0,286
6968,1511,1690,0.0,1600.5,-179
6969,1669,1627,1.0,1648.0,42
6970,1989,1759,1.0,1874.0,230
6971,1525,1567,1.0,1546.0,-42
6972,1607,1421,0.0,1514.0,186
6973,1723,1737,1.0,1730.0,-14
6974,1464,1410,1.0,1437.0,54
6975,1633,1627,0.0,1630.0,6
6976,1454,1660,0.0,1557.0,-206
6977,1920,1579,1.0,1749.5,341
6978,1364,1678,0.0,1521.0,-314
6979,1747,1747,1.0,1747.0,0
6980,1634,1478,1.0,1556.0,156
6981,1540,1864,0.0,1702.0,-324
6982,1546,1628,0.0,1587.0,-82
6983,1536,1472,0.0,1504.0,64
6984,1289,1507,1.0,1398.0,-218
6985,1663,1771,1.0,1717.0,-108
6986,1680,1526,1.0,1603.0,154
6987,1726,1710,0.0,1718.0,16
6988,2033,1981,0.0,2007.0,52
6989,1762,1664,0.0,1713.0,98
6990,1519,1759,0.0,1639.0,-240
6991,2540,1603,0.0,2071.5,937
6992,2342,2505,0.0,2423.5,-163
6993,2531,2524,1.0,2527.5,7
6994,2279,2325,0.5,2302.0,-46
6995,2170,2479,0.5,2324.5,-309
6996,2189,2216,0.5,2202.5,-27
6997,2100,2095,0.0,2097.5,5
6998,2182,2213,1.0,2197.5,-31
6999,2555,1801,0.5,2178.0,754
7000,2559,2661,0.5,2610.0,-102
7001,2487,2530,0.5,2508.5,-43
7002,2453,2508,0.5,2480.5,-55
7003,2494,2468,1.0,2481.0,26
7004,2364,2464,0.0,2414.0,-100
7005,2475,2478,1.0,2476.5,-3
7006,2318,2301,0.0,2309.5,17
7007,2490,2435,1.0,2462.5,55
7008,2424,2395,0.5,2409.5,29
7009,2275,2453,0.0,2364.0,-178
7010,2314,2385,0.0,2349.5,-71
7011,2336,2313,0.0,2324.5,23
7012,2237,2215,0.0,2226.0,22
7013,2333,2375,1.0,2354.0,-42
7014,2271,2289,0.0,2280.0,-18
7015,2422,2252,0.5,2337.0,170
7016,2418,2521,0.5,2469.5,-103
7017,2354,2404,0.5,2379.0,-50
7018,2352,2392,0.5,2372.0,-40
7019,2229,2327,0.0,2278.0,-98
7020,2398,2470,0.5,2434.0,-72
7021,2286,2334,0.0,2310.0,-48
7022,2359,2380,1.0,2369.5,-21
7023,2474,2274,1.0,2374.0,200
7024,2282,2367,0.0,2324.5,-85
7025,2366,2466,1.0,2416.0,-100
7026,2235,2218,0.0,2226.5,17
7027,2480,2315,0.5,2397.5,165
7028,2312,2425,0.0,2368.5,-113
7029,2316,2385,1.0,2350.5,-69
7030,2323,2297,0.5,2310.0,26
7031,2386,2318,0.0,2352.0,68
7032,2261,2407,0.0,2334.0,-146
7033,2117,2170,1.0,2143.5,-53
7034,2020,2032,0.0,2026.0,-12
7035,2391,2032,1.0,2211.5,359
7036,2318,2269,0.0,2293.5,49
7037,2317,2324,0.5,2320.5,-7
7038,2113,2184,0.5,2148.5,-71
7039,2241,2314,1.0,2277.5,-73
7040,2383,2358,1.0,2370.5,25
7041,2089,2136,0.0,2112.5,-47
7042,2214,2338,0.5,2276.0,-124
7043,2410,2109,1.0,2259.5,301
7044,2259,2251,0.0,2255.0,8
7045,2109,2346,1.0,2227.5,-237
7046,2221,2043,1.0,2132.0,178
7047,2352,2123,0.5,2237.5,229
7048,2347,2278,1.0,2312.5,69
7049,2232,2324,1.0,2278.0,-92
7050,2217,2247,0.0,2232.0,-30
7051,2158,2147,0.0,2152.5,11
7052,2269,2307,1.0,2288.0,-38
7053,1903,2020,0.0,1961.5,-117
7054,2331,2171,1.0,2251.0,160
7055,2345,1692,0.0,2018.5,653
7056,2235,2500,0.0,2367.5,-265
7057,2317,2270,0.0,2293.5,47
7058,1933,2257,0.0,2095.0,-324
7059,2312,2291,0.0,2301.5,21
7060,2347,2485,0.0,2416.0,-138
7061,2276,2275,0.5,2275.5,1
7062,2274,2321,0.0,2297.5,-47
7063,2228,2198,0.5,2213.0,30
7064,2291,2296,0.5,2293.5,-5
7065,2127,2141,1.0,2134.0,-14
7066,2156,2190,1.0,2173.0,-34
7067,2293,2044,0.0,2168.5,249
7068,2153,2236,0.5,2194.5,-83
7069,2070,2196,0.0,2133.0,-126
7070,2123,2129,1.0,2126.0,-6
7071,2165,2032,1.0,2098.5,133
7072,1916,1945,0.0,1930.5,-29
7073,2048,2044,1.0,2046.0,4
7074,1860,1886,0.0,1873.0,-26
7075,2299,1953,1.0,2126.0,346
7076,2281,2327,1.0,2304.0,-46
7077,2170,2240,0.5,2205.0,-70
7078,2042,2291,0.0,2166.5,-249
7079,2396,2218,0.0,2307.0,178
7080,2189,2456,0.5,2322.5,-267
7081,2206,2397,0.0,2301.5,-191
7082,2083,2135,1.0,2109.0,-52
7083,2368,2128,1.0,2248.0,240
7084,2177,2012,1.0,2094.5,165
7085,2186,2210,1.0,2198.0,-24
7086,1707,1859,0.0,1783.0,-152
7087,2081,2168,0.0,2124.5,-87
7088,2065,2169,1.0,2117.0,-104
7089,1939,2016,0.5,1977.5,-77
7090,1932,1954,1.0,1943.0,-22
7091,2214,1950,0.0,2082.0,264
7092,2060,2178,1.0,2119.0,-118
7093,2098,2205,0.0,2151.5,-107
7094,1873,1944,0.0,1908.5,-71
7095,2401,2055,1.0,2228.0,346
7096,1968,2085,0.0,2026.5,-117
7097,2016,2171,0.5,2093.5,-155
7098,1920,1971,0.5,1945.5,-51
7099,2294,2095,0.5,2194.5,199
7100,2222,2226,0.5,2224.0,-4
7101,2127,2205,0.0,2166.0,-78
7102,1991,2026,0.5,2008.5,-35
7103,2004,2021,1.0,2012.5,-17
7104,1974,2010,0.5,1992.0,-36
7105,1785,1698,0.5,1741.5,87
7106,2112,1839,1.0,1975.5,273
7107,1920,1899,0.0,1909.5,21
7108,1791,2211,1.0,2001.0,-420
7109,1764,1846,1.0,1805.0,-82
7110,2071,1687,0.5,1879.0,384
7111,2041,2049,1.0,2045.0,-8
7112,1781,1890,0.0,1835.5,-109
7113,1943,1895,0.5,1919.0,48
7114,2188,1693,0.5,1940.5,495
7115,2098,2168,1.0,2133.0,-70
7116,1922,2076,0.0,1999.0,-154
7117,2122,2119,1.0,2120.5,3
7118,2113,1874,0.5,1993.5,239
7119,2074,2122,0.0,2098.0,-48
7120,1982,2061,0.0,2021.5,-79
7121,1960,2019,1.0,1989.5,-59
7122,1874,1882,0.5,1878.0,-8
7123,1995,2147,1.0,2071.0,-152
7124,1984,1964,1.0,1974.0,20
7125,2024,1752,0.5,1888.0,272
7126,1982,2273,1.0,2127.5,-291
7127,1747,1782,0.0,1764.5,-35
7128,1862,1915,1.0,1888.5,-53
7129,1981,1768,0.5,1874.5,213
7130,2096,2207,1.0,2151.5,-111
7131,1759,2033,0.0,1896.0,-274
7132,2008,2118,1.0,2063.0,-110
7133,1777,1881,1.0,1829.0,-104
7134,2077,2394,1.0,2235.5,-317
7135,1727,1715,0.0,1721.0,12
7136,1862,2027,1.0,1944.5,-165
7137,1811,1729,0.5,1770.0,82
7138,1713,1833,0.0,1773.0,-120
7139,1972,2052,1.0,2012.0,-80
7140,1774,1769,0.5,1771.5,5
7141,2107,1938,1.0,2022.5,169
7142,1994,1859,1.0,1926.5,135
7143,1709,1921,0.5,1815.0,-212
7144,1616,1734,1.0,1675.0,-118
7145,1938,1658,0.5,1798.0,280
7146,1877,1986,0.5,1931.5,-109
7147,1787,2064,1.0,1925.5,-277
7148,1906,1899,0.0,1902.5,7
7149,2112,1874,0.5,1993.0,238
7150,2003,1973,1.0,1988.0,30
7151,1844,1941,0.5,1892.5,-97
7152,1947,1950,0.5,1948.5,-3
7153,1991,1972,1.0,1981.5,19
7154,1840,1892,1.0,1866.0,-52
7155,1732,1756,0.0,1744.0,-24
7156,1657,1798,1.0,1727.5,-141
7157,2229,1697,0.5,1963.0,532
7158,1975,2103,0.5,2039.0,-128
7159,1942,2008,1.0,1975.0,-66
7160,1663,1794,0.0,1728.5,-131
7161,1747,2045,0.5,1896.0,-298
7162,1759,1627,0.0,1693.0,132
7163,1346,1541,1.0,1443.5,-195
7164,2422,1589,1.0,2005.5,833
7165,1660,1633,0.0,1646.5,27
7166,1731,1552,1.0,1641.5,179
7167,1678,1920,0.0,1799.0,-242
7168,1844,1550,0.5,1697.0,294
7169,1762,1778,0.5,1770.0,-16
7170,1989,1723,1.0,1856.0,266
7171,1734,1935,1.0,1834.5,-201
7172,1525,1567,0.5,1546.0,-42
7173,1795,1731,0.5,1763.0,64
7174,1540,1864,0.0,1702.0,-324
7175,1833,2017,0.5,1925.0,-184
7176,2262,1808,1.0,2035.0,454
7177,1708,1994,0.0,1851.0,-286
7178,1724,1681,0.5,1702.5,43
7179,1964,1849,0.5,1906.5,115
7180,2027,2102,1.0,2064.5,-75
7181,1797,2017,0.0,1907.0,-220
7182,1893,1980,1.0,1936.5,-87
7183,1749,1838,1.0,1793.5,-89
7184,1519,1737,1.0,1628.0,-218
7185,1723,1723,1.0,1723.0,0
7186,1478,1537,0.5,1507.5,-59
7187,1507,1712,0.0,1609.5,-205
7188,1738,1289,0.5,1513.5,449
7189,1698,1862,0.0,1780.0,-164
7190,1869,1536,1.0,1702.5,333
7191,1803,1689,1.0,1746.0,114
7192,1599,1632,1.0,1615.5,-33
7193,1576,1727,1.0,1651.5,-151
7194,1680,1526,1.0,1603.0,154
7195,1538,1534,0.0,1536.0,4
7196,1410,1483,0.5,1446.5,-73
7197,1747,1747,1.0,1747.0,0
7198,1478,1634,0.0,1556.0,-156
7199,1592,1771,0.0,1681.5,-179
7200,1663,1667,1.0,1665.0,-4
7201,1811,1501,1.0,1656.0,310
7202,1461,1690,0.0,1575.5,-229
7203,1511,1594,0.0,1552.5,-83
7204,1832,1627,1.0,1729.5,205
7205,1454,1579,0.0,1516.5,-125
7206,1628,1546,0.0,1587.0,82
7207,1472,1536,1.0,1504.0,-64
7208,2205,1726,1.0,1965.5,479
7209,1664,2094,0.0,1879.0,-430
7210,2068,1762,1.0,1915.0,306
7211,1603,2216,0.0,1909.5,-613
7212,2249,2409,1.0,2329.0,-160
7213,2639,2610,0.0,2624.5,29
7214,2644,2632,0.5,2638.0,12
7215,2617,2539,0.5,2578.0,78
7216,2648,2502,1.0,2575.0,146
7217,2626,2499,1.0,2562.5,127
7218,2561,2619,0.5,2590.0,-58
7219,2595,2572,0.5,2583.5,23
7220,2328,2586,0.0,2457.0,-258
7221,2504,2535,0.5,2519.5,-31
7222,2516,2434,1.0,2475.0,82
7223,2432,2444,0.0,2438.0,-12
7224,2332,2564,0.5,2448.0,-232
7225,2484,2229,1.0,2356.5,255
7226,2277,2443,0.5,2360.0,-166
7227,2306,2431,0.5,2368.5,-125
7228,2258,2426,0.5,2342.0,-168
7229,2421,2279,1.0,2350.0,142
7230,2375,2165,1.0,2270.0,210
7231,2232,2360,1.0,2296.0,-128
7232,2322,2243,0.5,2282.5,79
7233,2719,2717,1.0,2718.0,2
7234,2683,2312,0.5,2497.5,371
7235,2310,2680,0.5,2495.0,-370
7236,2664,2294,1.0,2479.0,370
7237,2286,2657,0.0,2471.5,-371
7238,2655,2285,0.5,2470.0,370
7239,2283,2643,0.0,2463.0,-360
7240,2639,2279,1.0,2459.0,360
7241,2276,2628,0.5,2452.0,-352
7242,2623,2276,1.0,2449.5,347
7243,2267,2619,0.0,2443.0,-352
7244,2598,2265,1.0,2431.5,333
7245,2263,2565,0.0,2414.0,-302
7246,2562,2259,1.0,2410.5,303
7247,2244,2553,0.0,2398.5,-309
7248,2548,2220,1.0,2384.0,328
7249,2219,2531,0.0,2375.0,-312
7250,2529,2218,1.0,2373.5,311
7251,2217,2524,0.5,2370.5,-307
7252,2516,2208,1.0,2362.0,308
7253,2196,2511,0.5,2353.5,-315
7254,2487,2664,0.5,2575.5,-177
7255,2657,2438,1.0,2547.5,219
7256,2643,2412,1.0,2527.5,231
7257,2477,2639,0.5,2558.0,-162
7258,2396,2623,0.0,2509.5,-227
7259,2619,2365,1.0,2492.0,254
7260,2373,2598,0.0,2485.5,-225
7261,2565,2347,0.5,2456.0,218
7262,2360,2562,0.5,2461.0,-202
7263,2553,2340,1.0,2446.5,213
7264,2340,2548,0.0,2444.0,-208
7265,2531,2332,1.0,2431.5,199
7266,2324,2529,0.5,2426.5,-205
7267,2316,2516,0.5,2416.0,-200
7268,1912,2496,0.0,2204.0,-584
7269,2490,2319,1.0,2404.5,171
7270,2680,2135,1.0,2407.5,545
7271,2285,2683,0.0,2484.0,-398
7272,2312,2655,0.0,2483.5,-343
7273,2628,2310,1.0,2469.0,318
7274,2553,2657,1.0,2605.0,-104
7275,2548,2643,0.0,2595.5,-95
7276,2623,2531,0.5,2577.0,92
7277,2496,2619,0.5,2557.5,-123
7278,2598,2490,1.0,2544.0,108
7279,2683,2511,1.0,2597.0,172
7280,2474,2680,0.0,2577.0,-206
7281,2664,2477,1.0,2570.5,187
7282,2655,2487,0.5,2571.0,168
7283,2639,2360,1.0,2499.5,279
7284,2392,2628,0.5,2510.0,-236
7285,2196,2565,0.5,2380.5,-369
7286,2562,2338,0.5,2450.0,224
7287,2529,2316,1.0,2422.5,213
7288,2347,2524,0.5,2435.5,-177
7289,2516,2324,1.0,2420.0,192
7290,2267,2447,0.5,2357.0,-180
7291,2438,2265,0.5,2351.5,173
7292,2412,2259,0.5,2335.5,153
7293,2263,2396,1.0,2329.5,-133
7294,2643,2598,0.5,2620.5,45
7295,2683,2553,1.0,2618.0,130
7296,2680,2529,1.0,2604.5,151
7297,2619,2664,1.0,2641.5,-45
7298,2531,2639,1.0,2585.0,-108
7299,2516,2623,0.5,2569.5,-107
7300,2657,2496,1.0,2576.5,161
7301,2347,2655,0.0,2501.0,-308
7302,2628,2340,1.0,2484.0,288
7303,2565,2319,0.5,2442.0,246
7304,2279,2562,0.0,2420.5,-283
7305,2338,2548,0.0,2443.0,-210
7306,2524,2263,1.0,2393.5,261
7307,2490,2219,1.0,2354.5,271
7308,2276,2487,0.0,2381.5,-211
7309,2049,2392,0.0,2220.5,-343
7310,2477,2196,1.0,2336.5,281
7311,2511,2294,1.0,2402.5,217
7312,2265,2474,0.0,2369.5,-209
7313,2447,2286,0.0,2366.5,161
7314,2619,2683,0.5,2651.0,-64
7315,2598,2680,0.5,2639.0,-82
7316,2531,2643,1.0,2587.0,-112
7317,2548,2657,0.5,2602.5,-109
7318,2655,2524,1.0,2589.5,131
7319,2487,2628,0.5,2557.5,-141
7320,2623,2490,0.5,2556.5,133
7321,2562,2516,0.5,2539.0,46
7322,2392,2553,0.0,2472.5,-161
7323,2664,2474,1.0,2569.0,190
7324,2639,2220,1.0,2429.5,419
7325,2365,2565,0.0,2465.0,-200
7326,2529,2360,1.0,2444.5,169
7327,2319,2511,0.5,2415.0,-192
7328,2496,2174,0.5,2335.0,322
7329,2286,2477,0.5,2381.5,-191
7330,2244,2347,0.5,2295.5,-103
7331,2438,2279,0.5,2358.5,159
7332,2396,2276,1.0,2336.0,120
7333,2263,2373,0.5,2318.0,-110
7334,2680,2531,1.0,2605.5,149
7335,2683,2598,0.5,2640.5,85
7336,2553,2655,0.5,2604.0,-102
7337,2643,2619,0.0,2631.0,24
7338,2562,2664,0.5,2613.0,-102
7339,2657,2529,1.0,2593.0,128
7340,2490,2639,1.0,2564.5,-149
7341,2628,2548,1.0,2588.0,80
7342,2487,2623,0.5,2555.0,-136
7343,2565,2516,0.0,2540.5,49
7344,2524,2319,0.5,2421.5,205
7345,2511,2286,1.0,2398.5,225
7346,2338,2496,0.5,2417.0,-158
7347,2477,2259,0.5,2368.0,218
7348,2396,2244,1.0,2320.0,152
7349,2208,2392,0.0,2300.0,-184
7350,2174,2340,0.5,2257.0,-166
7351,2474,2294,1.0,2384.0,180
7352,2447,2263,0.5,2355.0,184
7353,2285,2438,0.0,2361.5,-153
7354,1919,2139,1.0,2029.0,-220
7355,2807,2822,0.5,2814.5,-15
7356,2791,2810,1.0,2800.5,-19
7357,2809,2742,1.0,2775.5,67
7358,2783,2792,0.5,2787.5,-9
7359,2773,2749,1.0,2761.0,24
7360,2822,2773,1.0,2797.5,49
7361,2809,2807,0.0,2808.0,2
7362,2792,2791,0.5,2791.5,1
7363,2749,2783,0.5,2766.0,-34
7364,2742,2810,0.0,2776.0,-68
7365,2783,2822,0.5,2802.5,-39
7366,2791,2749,0.5,2770.0,42
7367,2807,2742,0.5,2774.5,65
7368,2810,2792,0.5,2801.0,18
7369,2773,2809,0.5,2791.0,-36
7370,2822,2791,0.0,2806.5,31
7371,2807,2773,0.5,2790.0,34
7372,2809,2783,0.5,2796.0,26
7373,2749,2810,0.5,2779.5,-61
7374,2742,2792,1.0,2767.0,-50
7375,2791,2809,0.5,2800.0,-18
7376,2783,2807,1.0,2795.0,-24
7377,2810,2822,0.0,2816.0,-12
7378,2773,2742,0.5,2757.5,31
7379,2792,2749,0.5,2770.5,43
7380,2699,2737,0.0,2718.0,-38
7381,2715,2737,0.5,2726.0,-22
7382,2562,2666,0.0,2614.0,-104
7383,2496,2678,0.5,2587.0,-182
7384,2675,2493,1.0,2584.0,182
7385,2493,2699,0.0,2596.0,-206
7386,2678,2675,1.0,2676.5,3
7387,2666,2496,1.0,2581.0,170
7388,2737,2562,1.0,2649.5,175
7389,2737,2715,0.0,2726.0,22
7390,2600,2546,1.0,2573.0,54
7391,2593,2611,0.5,2602.0,-18
7392,2600,2608,0.0,2604.0,-8
7393,2658,2568,1.0,2613.0,90
7394,2580,2628,0.5,2604.0,-48
7395,2558,2606,0.0,2582.0,-48
7396,2463,2671,1.0,2567.0,-208
7397,2659,2508,0.0,2583.5,151
7398,2638,2400,1.0,2519.0,238
7399,2579,2380,1.0,2479.5,199
7400,2354,2558,0.5,2456.0,-204
7401,2495,2538,0.0,2516.5,-43
7402,2515,2471,1.0,2493.0,44
7403,2401,2621,0.5,2511.0,-220
7404,2623,2415,0.0,2519.0,208
7405,2609,2411,1.0,2510.0,198
7406,2592,2437,1.0,2514.5,155
7407,2416,2570,0.5,2493.0,-154
7408,2407,2502,0.0,2454.5,-95
7409,2397,2491,0.5,2444.0,-94
7410,2608,2600,0.5,2604.0,8
7411,2546,2658,0.5,2602.0,-112
7412,2606,2593,0.5,2599.5,13
7413,2611,2638,0.0,2624.5,-27
7414,2628,2463,0.5,2545.5,165
7415,2568,2600,0.5,2584.0,-32
7416,2538,2580,0.0,2559.0,-42
7417,2508,2579,0.5,2543.5,-71
7418,2592,2515,0.5,2553.5,77
7419,2415,2609,0.0,2512.0,-194
7420,2558,2466,1.0,2512.0,92
7421,2401,2558,0.5,2479.5,-157
7422,2502,2354,0.5,2428.0,148
7423,2671,2416,1.0,2543.5,255
7424,2400,2659,0.0,2529.5,-259
7425,2621,2397,1.0,2509.0,224
7426,2570,2337,0.0,2453.5,233
7427,2191,2495,0.0,2343.0,-304
7428,2491,2319,1.0,2405.0,172
7429,2471,2354,1.0,2412.5,117
7430,1737,1970,0.0,1853.5,-233
7431,2793,2741,1.0,2767.0,52
7432,2762,2720,1.0,2741.0,42
7433,2748,2717,0.5,2732.5,31
7434,2734,2782,0.5,2758.0,-48
7435,2741,2793,0.0,2767.0,-52
7436,2720,2762,0.5,2741.0,-42
7437,2717,2748,1.0,2732.5,-31
7438,2782,2734,0.5,2758.0,48
7439,2734,2782,0.5,2758.0,-48
7440,2782,2734,0.0,2758.0,48
7441,2727,2734,0.5,2730.5,-7
7442,2717,2814,1.0,2765.5,-97
7443,2736,2762,0.5,2749.0,-26
7444,2744,2793,0.5,2768.5,-49
7445,2734,2727,0.5,2730.5,7
7446,2814,2717,0.5,2765.5,97
7447,2762,2736,0.5,2749.0,26
7448,2793,2744,1.0,2768.5,49
7449,2727,2734,0.5,2730.5,-7
7450,2762,2736,0.5,2749.0,26
7451,2734,2727,0.5,2730.5,7
7452,2736,2762,0.5,2749.0,-26
7453,2727,2734,0.5,2730.5,-7
7454,2762,2736,1.0,2749.0,26
7455,2734,2727,0.0,2730.5,7
7456,2736,2762,0.0,2749.0,-26
7457,2793,2727,0.0,2760.0,66
7458,2717,2762,0.5,2739.5,-45
7459,2727,2793,0.5,2760.0,-66
7460,2762,2717,0.5,2739.5,45
7461,2635,2651,1.0,2643.0,-16
7462,2125,2561,1.0,2343.0,-436
7463,2433,2120,1.0,2276.5,313
7464,2114,2413,0.0,2263.5,-299
7465,2408,2099,1.0,2253.5,309
7466,2094,2353,0.0,2223.5,-259
7467,2253,2092,0.5,2172.5,161
7468,2091,2248,0.0,2169.5,-157
7469,2246,2082,0.5,2164.0,164
7470,2053,2241,0.0,2147.0,-188
7471,2234,2045,1.0,2139.5,189
7472,2030,2206,1.0,2118.0,-176
7473,2201,2028,0.5,2114.5,173
7474,1964,2182,0.5,2073.0,-218
7475,2176,1945,0.5,2060.5,231
7476,1938,2162,1.0,2050.0,-224
7477,2155,1924,1.0,2039.5,231
7478,2234,2433,0.0,2333.5,-199
7479,2413,2155,0.5,2284.0,258
7480,2152,2408,0.5,2280.0,-256
7481,2353,2142,0.5,2247.5,211
7482,2248,2125,0.0,2186.5,123
7483,2241,2030,1.0,2135.5,211
7484,2182,1938,1.0,2060.0,244
7485,2082,2253,0.5,2167.5,-171
7486,2092,2246,0.0,2169.0,-154
7487,1945,2201,0.0,2073.0,-256
7488,2028,2176,0.0,2102.0,-148
7489,2140,1964,0.5,2052.0,176
7490,2561,1741,1.0,2151.0,820
7491,2206,2091,1.0,2148.5,115
7492,2162,2053,0.0,2107.5,109
7493,2120,2045,1.0,2082.5,75
7494,2433,2241,1.0,2337.0,192
7495,2125,2413,1.0,2269.0,-288
7496,2408,2182,1.0,2295.0,226
7497,2176,2353,0.5,2264.5,-177
7498,2246,2155,0.5,2200.5,91
7499,2201,2152,0.5,2176.5,49
7500,2142,2248,0.5,2195.0,-106
7501,2099,2561,0.0,2330.0,-462
7502,2253,1924,1.0,2088.5,329
7503,2053,2234,0.0,2143.5,-181
7504,1964,2206,0.5,2085.0,-242
7505,2030,2140,0.5,2085.0,-110
7506,1938,2120,0.0,2029.0,-182
7507,2094,2082,1.0,2088.0,12
7508,1945,2092,0.0,2018.5,-147
7509,1741,2028,0.5,1884.5,-287
7510,2125,2433,0.5,2279.0,-308
7511,2353,2408,1.0,2380.5,-55
7512,2155,2253,1.0,2204.0,-98
7513,2152,2246,0.5,2199.0,-94
7514,2241,2142,1.0,2191.5,99
7515,2120,2234,0.5,2177.0,-114
7516,2206,2176,0.0,2191.0,30
7517,2413,2094,1.0,2253.5,319
7518,2248,1964,1.0,2106.0,284
7519,2182,2030,0.0,2106.0,152
7520,2140,1914,0.0,2027.0,226
7521,2092,2099,1.0,2095.5,-7
7522,2162,1741,1.0,1951.5,421
7523,2028,2091,0.0,2059.5,-63
7524,2082,1938,1.0,2010.0,144
7525,2433,2155,1.0,2294.0,278
7526,2176,2125,0.5,2150.5,51
7527,2561,2353,1.0,2457.0,208
7528,2408,2241,0.5,2324.5,167
7529,2030,2413,0.0,2221.5,-383
7530,1914,2248,0.0,2081.0,-334
7531,2246,2120,0.5,2183.0,126
7532,2234,2092,1.0,2163.0,142
7533,2253,2152,0.5,2202.5,101
7534,2091,2162,0.5,2126.5,-71
7535,2142,2082,0.5,2112.0,60
7536,1964,1924,1.0,1944.0,40
7537,2140,2206,1.0,2173.0,-66
7538,2094,2182,0.0,2138.0,-88
7539,2114,2028,1.0,2071.0,86
7540,2099,1945,1.0,2022.0,154
7541,2230,2118,0.5,2174.0,112
7542,2541,2563,0.0,2552.0,-22
7543,2411,2580,0.5,2495.5,-169
7544,2407,2382,0.5,2394.5,25
7545,2440,2506,0.0,2473.0,-66
7546,2314,2592,0.5,2453.0,-278
7547,2334,2464,0.0,2399.0,-130
7548,2248,2318,0.5,2283.0,-70
7549,2361,2298,0.5,2329.5,63
7550,2301,2363,1.0,2332.0,-62
7551,2215,2362,0.0,2288.5,-147
7552,2583,2264,1.0,2423.5,319
7553,2323,2509,0.5,2416.0,-186
7554,2243,2419,0.0,2331.0,-176
7555,2421,2235,0.5,2328.0,186
7556,2102,2400,0.0,2251.0,-298
7557,2276,2109,1.0,2192.5,167
7558,1972,2230,0.0,2101.0,-258
7559,2256,2363,0.0,2309.5,-107
7560,2185,2202,0.0,2193.5,-17
7561,2449,2516,0.0,2482.5,-67
7562,2436,2420,0.0,2428.0,16
7563,2398,2400,1.0,2399.0,-2
7564,2315,2372,1.0,2343.5,-57
7565,2312,2425,1.0,2368.5,-113
7566,2302,2211,1.0,2256.5,91
7567,2250,2204,0.5,2227.0,46
7568,2152,2213,0.0,2182.5,-61
7569,2370,2168,1.0,2269.0,202
7570,2444,2294,0.5,2369.0,150
7571,2586,2482,0.5,2534.0,104
7572,2453,2606,0.5,2529.5,-153
7573,2490,2509,0.5,2499.5,-19
7574,2297,2429,0.0,2363.0,-132
7575,2415,2386,0.5,2400.5,29
7576,2317,2510,0.5,2413.5,-193
7577,2292,2377,0.0,2334.5,-85
7578,2398,2415,0.5,2406.5,-17
7579,2182,2289,0.5,2235.5,-107
7580,2763,2769,0.5,2766.0,-6
7581,2504,2273,0.0,2388.5,231
7582,2501,2321,0.5,2411.0,180
7583,2478,2377,1.0,2427.5,101
7584,2476,2383,0.5,2429.5,93
7585,2476,2383,0.0,2429.5,93
7586,2470,2394,1.0,2432.0,76
7587,2468,2409,1.0,2438.5,59
7588,2415,2455,0.5,2435.0,-40
7589,2273,2504,0.5,2388.5,-231
7590,2321,2501,0.5,2411.0,-180
7591,2377,2478,0.0,2427.5,-101
7592,2383,2476,0.5,2429.5,-93
7593,2383,2476,0.0,2429.5,-93
7594,2394,2470,1.0,2432.0,-76
7595,2409,2468,0.0,2438.5,-59
7596,2455,2415,0.5,2435.0,40
7597,2501,2321,1.0,2411.0,180
7598,2476,2383,0.0,2429.5,93
7599,2383,2476,0.0,2429.5,-93
7600,2470,2394,1.0,2432.0,76
7601,2455,2415,0.5,2435.0,40
7602,2321,2501,0.0,2411.0,-180
7603,2383,2476,0.0,2429.5,-93
7604,2476,2383,1.0,2429.5,93
7605,2394,2470,1.0,2432.0,-76
7606,2415,2455,0.0,2435.0,-40
7607,2383,2476,1.0,2429.5,-93
7608,2394,2470,0.5,2432.0,-76
7609,2476,2383,1.0,2429.5,93
7610,2470,2394,1.0,2432.0,76
7611,2383,2476,0.5,2429.5,-93
7612,2445,2606,0.0,2525.5,-161
7613,2610,2451,0.0,2530.5,159
7614,2452,2586,0.5,2519.0,-134
7615,2565,2428,1.0,2496.5,137
7616,2455,2553,0.5,2504.0,-98
7617,2539,2457,0.5,2498.0,82
7618,2465,2524,0.5,2494.5,-59
7619,2521,2467,0.5,2494.0,54
7620,2468,2517,0.5,2492.5,-49
7621,2516,2470,1.0,2493.0,46
7622,2470,2515,0.5,2492.5,-45
7623,2512,2476,1.0,2494.0,36
7624,2476,2273,1.0,2374.5,203
7625,2501,2478,0.5,2489.5,23
7626,2489,2501,0.5,2495.0,-12
7627,2491,2491,0.5,2491.0,0
7628,2606,2445,0.0,2525.5,161
7629,2451,2610,1.0,2530.5,-159
7630,2586,2452,0.5,2519.0,134
7631,2428,2565,1.0,2496.5,-137
7632,2553,2455,0.0,2504.0,98
7633,2457,2539,0.5,2498.0,-82
7634,2524,2465,0.0,2494.5,59
7635,2467,2521,0.0,2494.0,-54
7636,2517,2468,0.0,2492.5,49
7637,2470,2516,1.0,2493.0,-46
7638,2515,2470,1.0,2492.5,45
7639,2476,2512,0.5,2494.0,-36
7640,2273,2476,0.5,2374.5,-203
7641,2478,2501,1.0,2489.5,-23
7642,2501,2489,0.5,2495.0,12
7643,2491,2491,0.0,2491.0,0
7644,2606,2445,0.0,2525.5,161
7645,2452,2586,1.0,2519.0,-134
7646,2428,2565,0.0,2496.5,-137
7647,2457,2539,1.0,2498.0,-82
7648,2470,2516,1.0,2493.0,-46
7649,2501,2489,0.5,2495.0,12
7650,2445,2606,1.0,2525.5,-161
7651,2586,2452,0.0,2519.0,134
7652,2565,2428,0.5,2496.5,137
7653,2539,2457,1.0,2498.0,82
7654,2516,2470,0.0,2493.0,46
7655,2489,2501,0.5,2495.0,-12
7656,2539,2457,1.0,2498.0,82
7657,2489,2501,0.0,2495.0,-12
7658,2457,2539,0.5,2498.0,-82
7659,2501,2489,1.0,2495.0,12
7660,2445,2491,0.0,2468.0,-46
7661,2501,2451,1.0,2476.0,50
7662,2452,2478,1.0,2465.0,-26
7663,2476,2565,0.5,2520.5,-89
7664,2455,2512,0.5,2483.5,-57
7665,2515,2539,0.5,2527.0,-24
7666,2465,2470,0.0,2467.5,-5
7667,2468,2521,0.0,2494.5,-53
7668,2491,2445,1.0,2468.0,46
7669,2451,2501,1.0,2476.0,-50
7670,2478,2452,0.5,2465.0,26
7671,2565,2476,1.0,2520.5,89
7672,2512,2455,1.0,2483.5,57
7673,2539,2515,0.5,2527.0,24
7674,2470,2465,0.0,2467.5,5
7675,2521,2468,1.0,2494.5,53
7676,2501,2451,1.0,2476.0,50
7677,2515,2539,0.0,2527.0,-24
7678,2465,2470,1.0,2467.5,-5
7679,2451,2501,0.5,2476.0,-50
7680,2539,2515,0.0,2527.0,24
7681,2470,2465,0.5,2467.5,5
7682,2515,2539,0.0,2527.0,-24
7683,2539,2515,0.5,2527.0,24
7684,2058,2193,1.0,2125.5,-135
7685,2827,2820,1.0,2823.5,7
7686,2751,2776,1.0,2763.5,-25
7687,2763,2721,0.5,2742.0,42
7688,2699,2722,0.0,2710.5,-23
7689,2780,2739,0.5,2759.5,41
7690,2727,2691,0.5,2709.0,36
7691,2660,2612,0.5,2636.0,48
7692,2568,2621,0.5,2594.5,-53
7693,2740,2771,0.5,2755.5,-31
7694,2711,2662,0.5,2686.5,49
7695,2557,2668,0.5,2612.5,-111
7696,2672,2574,1.0,2623.0,98
7697,2639,2661,0.5,2650.0,-22
7698,2639,2590,0.5,2614.5,49
7699,2581,2591,0.0,2586.0,-10
7700,2595,2573,0.5,2584.0,22
7701,2703,2712,0.5,2707.5,-9
7702,2672,2674,1.0,2673.0,-2
7703,2633,2689,0.5,2661.0,-56
7704,2677,2594,0.5,2635.5,83
7705,2780,2703,0.5,2741.5,77
7706,2695,2678,0.0,2686.5,17
7707,2649,2681,0.5,2665.0,-32
7708,2685,2629,0.5,2657.0,56
7709,2804,2780,0.5,2792.0,24
7710,2639,2765,0.5,2702.0,-126
7711,2712,2642,1.0,2677.0,70
7712,2624,2708,0.5,2666.0,-84
7713,2689,2649,1.0,2669.0,40
7714,2589,2600,1.0,2594.5,-11
7715,2565,2576,1.0,2570.5,-11
7716,2582,2567,0.5,2574.5,15
7717,2760,2664,0.5,2712.0,96
7718,2610,2768,0.0,2689.0,-158
7719,2779,2602,1.0,2690.5,177
7720,2583,2726,0.5,2654.5,-143
7721,2655,2686,0.5,2670.5,-31
7722,2508,2544,1.0,2526.0,-36
7723,2499,2512,0.0,2505.5,-13
7724,2463,2504,0.5,2483.5,-41
7725,2618,2634,0.5,2626.0,-16
7726,2594,2525,0.5,2559.5,69
7727,2493,2544,0.5,2518.5,-51
7728,2552,2477,0.0,2514.5,75
7729,2715,2605,0.5,2660.0,110
7730,2538,2620,0.0,2579.0,-82
7731,2491,2582,0.0,2536.5,-91
7732,2449,2463,0.5,2456.0,-14
7733,2633,2615,0.5,2624.0,18
7734,2547,2609,1.0,2578.0,-62
7735,2588,2552,0.5,2570.0,36
7736,2500,2502,0.5,2501.0,-2
7737,2591,2634,1.0,2612.5,-43
7738,2715,2505,0.5,2610.0,210
7739,2580,2589,1.0,2584.5,-9
7740,2590,2452,1.0,2521.0,138
7741,2517,2567,0.0,2542.0,-50
7742,2476,2497,0.5,2486.5,-21
7743,2495,2449,1.0,2472.0,46
7744,2448,2472,0.5,2460.0,-24
7745,2686,2511,0.5,2598.5,175
7746,2465,2620,0.5,2542.5,-155
7747,2431,2424,0.0,2427.5,7
7748,2438,2408,0.0,2423.0,30
7749,2690,2579,0.5,2634.5,111
7750,2472,2621,0.0,2546.5,-149
7751,2702,2402,0.5,2552.0,300
7752,2381,2678,0.0,2529.5,-297
7753,2472,2606,0.5,2539.0,-134
7754,2623,2477,0.5,2550.0,146
7755,2263,2551,1.0,2407.0,-288
7756,2576,2452,0.5,2514.0,124
7757,2431,2578,1.0,2504.5,-147
7758,2570,2427,1.0,2498.5,143
7759,2396,2565,0.0,2480.5,-169
7760,2456,2299,1.0,2377.5,157
7761,2662,2570,0.5,2616.0,92
7762,2489,2558,0.5,2523.5,-69
7763,2521,2421,1.0,2471.0,100
7764,2470,2416,1.0,2443.0,54
7765,2514,2619,1.0,2566.5,-105
7766,2522,2482,1.0,2502.0,40
7767,2467,2484,0.0,2475.5,-17
7768,2456,2423,0.5,2439.5,33
7769,2452,2505,0.0,2478.5,-53
7770,2443,2360,1.0,2401.5,83
7771,2317,2349,0.5,2333.0,-32
7772,2411,2316,1.0,2363.5,95
7773,2471,2501,0.5,2486.0,-30
7774,2445,2389,0.0,2417.0,56
7775,2440,2413,1.0,2426.5,27
7776,2318,2402,0.0,2360.0,-84
7777,2549,2542,0.5,2545.5,7
7778,2500,2523,0.5,2511.5,-23
7779,2512,2457,0.5,2484.5,55
7780,2380,2507,0.5,2443.5,-127
7781,2619,2649,0.5,2634.0,-30
7782,2621,2468,1.0,2544.5,153
7783,2486,2562,0.5,2524.0,-76
7784,2548,2358,0.5,2453.0,190
7785,2543,2209,1.0,2376.0,334
7786,2114,2444,0.5,2279.0,-330
7787,2382,2062,1.0,2222.0,320
7788,1868,2380,0.0,2124.0,-512
7789,2564,2057,1.0,2310.5,507
7790,2237,2508,0.5,2372.5,-271
7791,2495,2165,1.0,2330.0,330
7792,1937,2495,0.0,2216.0,-558
7793,2501,2149,1.0,2325.0,352
7794,2319,2486,0.5,2402.5,-167
7795,2444,2207,1.0,2325.5,237
7796,2292,2443,0.0,2367.5,-151
7797,2498,2340,1.0,2419.0,158
7798,2343,2441,1.0,2392.0,-98
7799,2316,2373,1.0,2344.5,-57
7800,2425,2274,1.0,2349.5,151
7801,2513,2590,0.0,2551.5,-77
7802,2479,2482,1.0,2480.5,-3
7803,2666,2489,1.0,2577.5,177
7804,2496,2492,0.0,2494.0,4
7805,2646,2273,1.0,2459.5,373
7806,2276,2566,0.0,2421.0,-290
7807,2535,2400,1.0,2467.5,135
7808,2220,2509,0.0,2364.5,-289
7809,2525,2347,0.5,2436.0,178
7810,2329,2465,0.5,2397.0,-136
7811,2484,2258,1.0,2371.0,226
7812,2222,2467,0.0,2344.5,-245
7813,2346,2451,0.0,2398.5,-105
7814,2481,2387,0.0,2434.0,94
7815,2319,2486,0.0,2402.5,-167
7816,2466,2229,1.0,2347.5,237
7817,2422,2376,1.0,2399.0,46
7818,2305,2281,1.0,2293.0,24
7819,2126,2194,0.0,2160.0,-68
7820,2145,2126,0.5,2135.5,19
7821,1956,2396,0.0,2176.0,-440
7822,2313,2155,1.0,2234.0,158
7823,2190,2288,1.0,2239.0,-98
7824,2259,1820,0.5,2039.5,439
7825,2422,2291,1.0,2356.5,131
7826,2163,2344,0.0,2253.5,-181
7827,2262,1830,1.0,2046.0,432
7828,1836,2245,0.0,2040.5,-409
7829,2477,2553,0.0,2515.0,-76
7830,2464,2322,0.5,2393.0,142
7831,2308,2439,0.5,2373.5,-131
7832,2435,2248,1.0,2341.5,187
7833,2434,2218,0.0,2326.0,216
7834,2361,2310,1.0,2335.5,51
7835,2283,2376,1.0,2329.5,-93
7836,2246,2140,0.0,2193.0,106
7837,2419,2573,0.0,2496.0,-154
7838,2530,2291,1.0,2410.5,239
7839,2372,2502,1.0,2437.0,-130
7840,2448,2160,1.0,2304.0,288
7841,2238,2494,0.5,2366.0,-256
7842,2345,2171,1.0,2258.0,174
7843,2121,2256,0.0,2188.5,-135
7844,2230,2047,1.0,2138.5,183
7845,2393,2161,1.0,2277.0,232
7846,2147,2273,0.0,2210.0,-126
7847,2160,2193,1.0,2176.5,-33
7848,2198,2237,0.0,2217.5,-39
7849,2338,2588,0.5,2463.0,-250
7850,2566,2152,1.0,2359.0,414
7851,2138,2540,0.0,2339.0,-402
7852,2523,2121,1.0,2322.0,402
7853,2609,2388,1.0,2498.5,221
7854,2315,2494,0.5,2404.5,-179
7855,2664,2192,1.0,2428.0,472
7856,2244,2571,0.5,2407.5,-327
7857,2620,2285,1.0,2452.5,335
7858,2283,2558,0.0,2420.5,-275
7859,2548,2223,1.0,2385.5,325
7860,2216,2543,0.0,2379.5,-327
7861,2300,2401,0.0,2350.5,-101
7862,2398,2275,0.0,2336.5,123
7863,2267,2452,0.0,2359.5,-185
7864,2290,2252,0.5,2271.0,38
7865,2391,2370,1.0,2380.5,21
7866,2346,2358,0.0,2352.0,-12
7867,2244,2363,0.5,2303.5,-119
7868,2345,2193,0.5,2269.0,152
7869,2328,2335,0.5,2331.5,-7
7870,2321,2177,0.0,2249.0,144
7871,2173,2297,0.0,2235.0,-124
7872,2134,2106,1.0,2120.0,28
7873,2182,2188,1.0,2185.0,-6
7874,2158,2351,0.0,2254.5,-193
7875,2203,2144,1.0,2173.5,59
7876,2071,2108,0.5,2089.5,-37
7877,2358,2356,0.5,2357.0,2
7878,2245,2273,0.5,2259.0,-28
7879,2220,2115,0.5,2167.5,105
7880,2099,2205,0.0,2152.0,-106
7881,2064,2408,0.5,2236.0,-344
7882,2324,1988,1.0,2156.0,336
7883,1908,2128,0.0,2018.0,-220
7884,2161,1826,0.0,1993.5,335
7885,2061,2419,0.5,2240.0,-358
7886,2301,2171,1.0,2236.0,130
7887,2328,2195,0.0,2261.5,133
7888,2158,2259,0.0,2208.5,-101
7889,2473,1986,1.0,2229.5,487
7890,1979,2389,0.0,2184.0,-410
7891,2200,2015,0.5,2107.5,185
7892,2116,2235,1.0,2175.5,-119
7893,2615,2095,1.0,2355.0,520
7894,2038,2430,0.0,2234.0,-392
7895,2178,1940,0.5,2059.0,238
7896,1773,2182,0.0,1977.5,-409
7897,1827,2408,0.0,2117.5,-581
7898,2402,1779,1.0,2090.5,623
7899,1655,2284,0.0,1969.5,-629
7900,2157,1655,1.0,1906.0,502
7901,2391,2000,1.0,2195.5,391
7902,1694,2386,0.0,2040.0,-692
7903,2373,1517,1.0,1945.0,856
7904,2400,2360,1.0,2380.0,40
7905,2132,2085,1.0,2108.5,47
7906,2131,2203,1.0,2167.0,-72
7907,2002,2069,1.0,2035.5,-67
7908,2112,2157,0.5,2134.5,-45
7909,2129,2263,1.0,2196.0,-134
7910,1783,1785,0.0,1784.0,-2
7911,1860,1999,1.0,1929.5,-139
7912,2421,1690,1.0,2055.5,731
7913,1787,2249,0.0,2018.0,-462
7914,2154,2380,0.5,2267.0,-226
7915,2048,2053,0.0,2050.5,-5
7916,2303,2035,0.0,2169.0,268
7917,1986,1964,1.0,1975.0,22
7918,2294,2244,1.0,2269.0,50
7919,2233,1948,0.0,2090.5,285
7920,2475,2222,1.0,2348.5,253
7921,2226,2261,1.0,2243.5,-35
7922,2176,2428,0.0,2302.0,-252
7923,2175,2221,0.0,2198.0,-46
7924,2441,2096,1.0,2268.5,345
7925,2014,2000,0.0,2007.0,14
7926,2292,2345,1.0,2318.5,-53
7927,2055,2301,0.0,2178.0,-246
7928,1879,2126,0.0,2002.5,-247
7929,2054,2135,0.5,2094.5,-81
7930,1988,1910,0.5,1949.0,78
7931,2185,1984,0.0,2084.5,201
7932,2125,2175,0.5,2150.0,-50
7933,2143,2163,1.0,2153.0,-20
7934,1712,1854,0.0,1783.0,-142
7935,1805,2129,0.5,1967.0,-324
7936,2305,2111,1.0,2208.0,194
7937,1737,1801,0.0,1769.0,-64
7938,1926,2198,1.0,2062.0,-272
7939,1981,1441,0.0,1711.0,540
7940,2098,2185,1.0,2141.5,-87
7941,1797,2024,1.0,1910.5,-227
7942,2083,2090,0.0,2086.5,-7
7943,1896,1863,1.0,1879.5,33
7944,1846,1850,0.0,1848.0,-4
7945,1791,1835,0.0,1813.0,-44
7946,1863,1775,1.0,1819.0,88
7947,2074,2418,0.0,2246.0,-344
7948,2128,1845,1.0,1986.5,283
7949,2022,2093,0.0,2057.5,-71
7950,2051,2041,1.0,2046.0,10
7951,2331,2038,0.5,2184.5,293
7952,1993,2248,0.0,2120.5,-255
7953,2239,1906,1.0,2072.5,333
7954,1875,2237,0.0,2056.0,-362
7955,2405,2297,1.0,2351.0,108
7956,1780,1844,0.0,1812.0,-64
7957,2276,2349,1.0,2312.5,-73
7958,2057,1618,0.0,1837.5,439
7959,2183,2236,0.5,2209.5,-53
7960,1892,1904,0.0,1898.0,-12
7961,2054,2127,1.0,2090.5,-73
7962,2058,1631,1.0,1844.5,427
7963,1979,2211,0.0,2095.0,-232
7964,2012,2096,0.5,2054.0,-84
7965,1831,1995,0.0,1913.0,-164
7966,1766,1890,0.5,1828.0,-124
7967,2026,1880,0.5,1953.0,146
7968,1985,1965,0.5,1975.0,20
7969,2243,2031,1.0,2137.0,212
7970,1999,2042,1.0,2020.5,-43
7971,2096,2106,0.5,2101.0,-10
7972,1896,1902,0.0,1899.0,-6
7973,2262,1914,0.5,2088.0,348
7974,2153,2091,0.0,2122.0,62
7975,2158,2250,0.5,2204.0,-92
7976,1900,2231,0.0,2065.5,-331
7977,2125,2039,1.0,2082.0,86
7978,1926,1950,0.0,1938.0,-24
7979,2355,2232,1.0,2293.5,123
7980,1776,1844,0.0,1810.0,-68
7981,1661,2388,0.0,2024.5,-727
7982,1829,2138,0.0,1983.5,-309
7983,1840,1840,1.0,1840.0,0
7984,1950,1405,0.0,1677.5,545
7985,1790,1902,1.0,1846.0,-112
7986,1760,2054,0.0,1907.0,-294
7987,1943,1495,1.0,1719.0,448
7988,2016,2034,1.0,2025.0,-18
7989,1910,1723,1.0,1816.5,187
7990,1723,1844,1.0,1783.5,-121
7991,1819,1723,1.0,1771.0,96
7992,2412,2169,1.0,2290.5,243
7993,2061,1847,0.0,1954.0,214
7994,1840,1978,0.0,1909.0,-138
7995,1608,1631,0.5,1619.5,-23
7996,1873,1560,0.0,1716.5,313
7997,1525,1721,0.0,1623.0,-196
7998,1595,1408,0.0,1501.5,187
7999,1993,1793,1.0,1893.0,200
8000,1747,1793,0.0,1770.0,-46
8001,2024,1955,1.0,1989.5,69
8002,1716,1771,0.0,1743.5,-55
8003,1665,1900,0.5,1782.5,-235
8004,1766,1828,0.5,1797.0,-62
8005,1848,1653,1.0,1750.5,195
8006,2024,2067,1.0,2045.5,-43
8007,1661,1758,0.0,1709.5,-97
8008,1996,2029,1.0,2012.5,-33
8009,1803,1635,1.0,1719.0,168
8010,1951,1988,0.0,1969.5,-37
8011,1903,1873,0.0,1888.0,30
8012,1710,1695,0.0,1702.5,15
8013,2066,1765,1.0,1915.5,301
8014,1250,1720,0.0,1485.0,-470
8015,1353,2138,0.0,1745.5,-785
8016,2060,1820,1.0,1940.0,240
8017,1662,1576,0.0,1619.0,86
8018,1877,1765,0.0,1821.0,112
8019,1774,1781,1.0,1777.5,-7
8020,1823,1882,1.0,1852.5,-59
8021,1323,1772,0.0,1547.5,-449
8022,1779,1789,0.0,1784.0,-10
8023,1849,1627,1.0,1738.0,222
8024,1627,1677,1.0,1652.0,-50
8025,1756,1587,0.0,1671.5,169
8026,2116,1060,1.0,1588.0,1056
8027,2739,1888,0.5,2313.5,851
8028,2776,2827,0.5,2801.5,-51
8029,2612,2727,1.0,2669.5,-115
8030,2722,2763,0.5,2742.5,-41
8031,2820,2614,0.5,2717.0,206
8032,2765,2804,0.5,2784.5,-39
8033,2721,2751,0.5,2736.0,-30
8034,2712,2742,1.0,2727.0,-30
8035,2771,2676,0.5,2723.5,95
8036,2691,2780,0.5,2735.5,-89
8037,2668,2743,0.5,2705.5,-75
8038,2597,2660,1.0,2628.5,-63
8039,2661,2672,1.0,2666.5,-11
8040,2678,2780,0.5,2729.0,-102
8041,2591,2618,0.5,2604.5,-27
8042,2629,2649,1.0,2639.0,-20
8043,2712,2595,0.5,2653.5,117
8044,2535,2618,0.5,2576.5,-83
8045,2689,2672,1.0,2680.5,17
8046,2477,2493,0.0,2485.0,-16
8047,2615,2677,0.0,2646.0,-62
8048,2768,2760,0.5,2764.0,8
8049,2552,2547,0.5,2549.5,5
8050,2726,2779,1.0,2752.5,-53
8051,2686,2500,0.5,2593.0,186
8052,2579,2689,1.0,2634.0,-110
8053,2512,2508,0.5,2510.0,4
8054,2567,2565,1.0,2566.0,2
8055,2780,2463,1.0,2621.5,317
8056,2505,2591,0.5,2548.0,-86
8057,2642,2639,0.5,2640.5,3
8058,2452,2580,0.0,2516.0,-128
8059,2703,2624,0.5,2663.5,79
8060,2621,2690,0.0,2655.5,-69
8061,2692,2674,1.0,2683.0,18
8062,2678,2702,0.5,2690.0,-24
8063,2639,2594,1.0,2616.5,45
8064,2477,2472,0.5,2474.5,5
8065,2573,2590,1.0,2581.5,-17
8066,2452,2263,0.0,2357.5,189
8067,2544,2564,0.0,2554.0,-20
8068,2620,2715,1.0,2667.5,-95
8069,2484,2522,0.0,2503.0,-38
8070,2463,2491,1.0,2477.0,-28
8071,2710,2456,1.0,2583.0,254
8072,2465,2567,0.0,2516.0,-102
8073,2681,2695,0.0,2688.0,-14
8074,2448,2449,0.0,2448.5,-1
8075,2389,2685,0.0,2537.0,-296
8076,2662,2740,1.0,2701.0,-78
8077,2402,2440,0.5,2421.0,-38
8078,2556,2574,1.0,2565.0,-18
8079,2578,2365,0.5,2471.5,213
8080,2620,2686,1.0,2653.0,-66
8081,2565,2570,1.0,2567.5,-5
8082,2331,2408,0.5,2369.5,-77
8083,2605,2456,0.5,2530.5,149
8084,2443,2505,0.0,2474.0,-62
8085,2459,2582,1.0,2520.5,-123
8086,2411,2349,0.5,2380.0,62
8087,2511,2449,0.5,2480.0,62
8088,2497,2527,0.5,2512.0,-30
8089,2424,2465,0.5,2444.5,-41
8090,2472,2495,1.0,2483.5,-23
8091,2589,2313,0.5,2451.0,276
8092,2489,2570,0.5,2529.5,-81
8093,2582,2576,1.0,2579.0,6
8094,2470,2452,1.0,2461.0,18
8095,2634,2515,0.5,2574.5,119
8096,2558,2662,0.5,2610.0,-104
8097,2594,2601,0.5,2597.5,-7
8098,2445,2521,0.5,2483.0,-76
8099,2542,2552,1.0,2547.0,-10
8100,2609,2633,0.5,2621.0,-24
8101,2457,2500,0.5,2478.5,-43
8102,2502,2569,1.0,2535.5,-67
8103,2523,2380,1.0,2451.5,143
8104,2444,2543,0.5,2493.5,-99
8105,2486,2451,1.0,2468.5,35
8106,2380,2382,0.0,2381.0,-2
8107,2573,2466,0.5,2519.5,107
8108,2520,2655,0.5,2587.5,-135
8109,2502,2530,0.0,2516.0,-28
8110,2504,2499,1.0,2501.5,5
8111,2607,2448,0.5,2527.5,159
8112,2602,2664,0.0,2633.0,-62
8113,2589,2715,0.5,2652.0,-126
8114,2568,2583,0.5,2575.5,-15
8115,2649,2590,1.0,2619.5,59
8116,2519,2501,0.0,2510.0,18
8117,2569,2621,0.5,2595.0,-52
8118,2444,2486,1.0,2465.0,-42
8119,2564,2562,1.0,2563.0,2
8120,2566,2646,0.5,2606.0,-80
8121,2495,2497,0.5,2496.0,-2
8122,2408,2535,0.5,2471.5,-127
8123,2549,2495,0.5,2522.0,54
8124,2465,2525,1.0,2495.0,-60
8125,2507,2512,0.5,2509.5,-5
8126,2443,2484,0.5,2463.5,-41
8127,2553,2494,0.5,2523.5,59
8128,2273,2393,0.5,2333.0,-120
8129,2439,2464,1.0,2451.5,-25
8130,2237,2160,0.5,2198.5,77
8131,2494,2435,0.5,2464.5,59
8132,2344,2422,0.5,2383.0,-78
8133,2256,2345,0.5,2300.5,-89
8134,2227,2245,0.0,2236.0,-18
8135,2606,2254,1.0,2430.0,352
8136,2358,2464,0.0,2411.0,-106
8137,2594,2623,1.0,2608.5,-29
8138,2220,2273,0.0,2246.5,-53
8139,2431,2576,0.0,2503.5,-145
8140,2482,2514,0.5,2498.0,-32
8141,2299,2396,0.0,2347.5,-97
8142,2467,2462,1.0,2464.5,5
8143,2588,2483,0.5,2535.5,105
8144,2316,2498,0.5,2407.0,-182
8145,2540,2527,1.0,2533.5,13
8146,2239,2274,0.0,2256.5,-35
8147,2408,2523,0.5,2465.5,-115
8148,2664,2609,1.0,2636.5,55
8149,2170,2324,1.0,2247.0,-154
8150,2571,2565,1.0,2568.0,6
8151,2471,2161,0.5,2316.0,310
8152,2445,2501,1.0,2473.0,-56
8153,2343,2340,1.0,2341.5,3
8154,2413,2482,0.0,2447.5,-69
8155,2590,2425,0.5,2507.5,165
8156,2389,2473,0.5,2431.0,-84
8157,2489,2479,1.0,2484.0,10
8158,2200,2327,0.0,2263.5,-127
8159,2376,2388,0.5,2382.0,-12
8160,2360,2433,0.0,2396.5,-73
8161,2194,2264,1.0,2229.0,-70
8162,2316,2317,0.5,2316.5,-1
8163,2396,2145,0.5,2270.5,251
8164,2548,2558,1.0,2553.0,-10
8165,2288,2313,0.5,2300.5,-25
8166,2542,2543,1.0,2542.5,-1
8167,2335,2151,0.0,2243.0,184
8168,2472,2579,1.0,2525.5,-107
8169,2297,2321,0.0,2309.0,-24
8170,2381,2447,1.0,2414.0,-66
8171,2629,2134,1.0,2381.5,495
8172,2351,2182,1.0,2266.5,169
8173,2666,2482,1.0,2574.0,184
8174,1826,2203,0.0,2014.5,-377
8175,2218,2492,0.0,2355.0,-274
8176,2398,2401,0.5,2399.5,-3
8177,2376,2361,0.0,2368.5,15
8178,2290,2452,1.0,2371.0,-162
8179,2391,2146,0.5,2268.5,245
8180,2310,2434,0.5,2372.0,-124
8181,2196,2358,1.0,2277.0,-162
8182,2283,2283,0.0,2283.0,0
8183,2263,2244,0.0,2253.5,19
8184,2301,2419,0.0,2360.0,-118
8185,2078,2129,1.0,2103.5,-51
8186,2158,2195,0.5,2176.5,-37
8187,2273,1999,0.0,2136.0,274
8188,2468,2619,0.5,2543.5,-151
8189,2271,2400,0.5,2335.5,-129
8190,2358,2486,0.5,2422.0,-128
8191,2111,2220,0.0,2165.5,-109
8192,2229,2430,0.0,2329.5,-201
8193,2198,2305,0.0,2251.5,-107
8194,2182,2178,1.0,2180.0,4
8195,2408,1926,1.0,2167.0,482
8196,2062,2114,0.0,2088.0,-52
8197,2284,2402,0.5,2343.0,-118
8198,1868,2008,0.0,1938.0,-140
8199,2346,2157,1.0,2251.5,189
8200,2386,2391,1.0,2388.5,-5
8201,2319,2324,0.0,2321.5,-5
8202,2360,2373,1.0,2366.5,-13
8203,2154,2229,0.5,2191.5,-75
8204,2372,2291,1.0,2331.5,81
8205,2163,2291,0.0,2227.0,-128
8206,2160,2196,1.0,2178.0,-36
8207,2057,1830,0.0,1943.5,227
8208,2329,2347,0.0,2338.0,-18
8209,2237,2077,1.0,2157.0,160
8210,2039,2222,0.0,2130.5,-183
8211,2421,1937,0.5,2179.0,484
8212,2439,2477,1.0,2458.0,-38
8213,2380,2437,0.5,2408.5,-57
8214,2308,2322,1.0,2315.0,-14
8215,2206,2154,1.0,2180.0,52
8216,2382,2345,0.5,2363.5,37
8217,2193,2161,0.5,2177.0,32
8218,2301,2292,1.0,2296.5,9
8219,2139,2198,1.0,2168.5,-59
8220,2185,2228,0.0,2206.5,-43
8221,2171,2238,0.0,2204.5,-67
8222,2143,2163,0.0,2153.0,-20
8223,2149,2121,0.0,2135.0,28
8224,2215,2400,0.0,2307.5,-185
8225,2207,2319,1.0,2263.0,-112
8226,2157,2131,0.5,2144.0,26
8227,2422,2292,1.0,2357.0,130
8228,2155,1956,1.0,2055.5,199
8229,2126,2281,1.0,2203.5,-155
8230,1820,2016,0.0,1918.0,-196
8231,2370,2126,1.0,2248.0,244
8232,1825,1661,0.0,1743.0,164
8233,2363,2346,0.0,2354.5,17
8234,1405,1840,0.0,1622.5,-435
8235,2418,2345,0.0,2381.5,73
8236,2152,2338,1.0,2245.0,-186
8237,2128,2261,1.0,2194.5,-133
8238,2024,2121,0.5,2072.5,-97
8239,2261,2093,0.0,2177.0,168
8240,2405,2297,1.0,2351.0,108
8241,2226,2124,0.0,2175.0,102
8242,2276,2315,1.0,2295.5,-39
8243,1678,2221,0.0,1949.5,-543
8244,2171,2061,1.0,2116.0,110
8245,1965,1766,0.0,1865.5,199
8246,2259,2328,1.0,2293.5,-69
8247,2331,2031,0.0,2181.0,300
8248,1988,2064,1.0,2026.0,-76
8249,2239,2248,1.0,2243.5,-9
8250,1826,1908,1.0,1867.0,-82
8251,2244,2237,0.0,2240.5,7
8252,2012,2096,0.0,2054.0,-84
8253,2294,2274,1.0,2284.0,20
8254,1890,1992,0.5,1941.0,-102
8255,2236,2222,0.0,2229.0,14
8256,2245,2356,0.5,2300.5,-111
8257,2127,2170,0.0,2148.5,-43
8258,2099,2115,1.0,2107.0,-16
8259,2327,2054,0.0,2190.5,273
8260,2315,2388,0.5,2351.5,-73
8261,2098,2185,0.0,2141.5,-87
8262,2244,2192,1.0,2218.0,52
8263,2285,2083,0.0,2184.0,202
8264,2428,2475,1.0,2451.5,-47
8265,2216,2223,0.5,2219.5,-7
8266,2096,2124,1.0,2110.0,-28
8267,2328,2246,0.5,2287.0,82
8268,2299,2300,1.0,2299.5,-1
8269,2177,2276,0.0,2226.5,-99
8270,2252,2275,0.5,2263.5,-23
8271,1986,2106,0.0,2046.0,-120
8272,1835,1896,1.0,1865.5,-61
8273,1948,1905,1.0,1926.5,43
8274,1850,2233,0.0,2041.5,-383
8275,2135,2206,1.0,2170.5,-71
8276,1775,1846,0.5,1810.5,-71
8277,1984,2054,0.0,2019.0,-70
8278,2085,1863,0.0,1974.0,222
8279,2144,2158,1.0,2151.0,-14
8280,2069,2132,0.0,2100.5,-63
8281,2059,2071,1.0,2065.0,-12
8282,2243,1924,0.0,2083.5,319
8283,1981,2145,0.0,2063.0,-164
8284,2096,2106,0.0,2101.0,-10
8285,1863,1797,0.0,1830.0,66
8286,1986,1914,0.0,1950.0,72
8287,2250,2262,1.0,2256.0,-12
8288,2015,1979,0.0,1997.0,36
8289,2039,2158,0.5,2098.5,-119
8290,2126,2116,0.0,2121.0,10
8291,2232,2125,1.0,2178.5,107
8292,1910,1879,0.0,1894.5,31
8293,2388,2355,1.0,2371.5,33
8294,1992,1809,1.0,1900.5,183
8295,2125,2175,0.5,2150.0,-50
8296,1712,1854,0.5,1783.0,-142
8297,2249,1904,1.0,2076.5,345
8298,1655,1779,0.0,1717.0,-124
8299,2053,2028,0.5,2040.5,25
8300,1627,1655,0.0,1641.0,-28
8301,2095,2048,0.0,2071.5,47
8302,1785,2112,0.0,1948.5,-327
8303,1911,1783,1.0,1847.0,128
8304,1995,2095,0.0,2045.0,-100
8305,2038,1694,1.0,1866.0,344
8306,1517,1940,0.0,1728.5,-423
8307,2216,2074,1.0,2145.0,142
8308,1845,1943,0.0,1894.0,-98
8309,2034,2022,0.0,2028.0,12
8310,2041,2016,1.0,2028.5,25
8311,2024,1674,1.0,1849.0,350
8312,1805,1900,0.5,1852.5,-95
8313,1665,1801,0.5,1733.0,-136
8314,1737,1653,1.0,1695.0,84
8315,2067,2010,1.0,2038.5,57
8316,2029,1996,0.0,2012.5,33
8317,1803,1560,0.0,1681.5,243
8318,1903,1405,1.0,1654.0,498
8319,2211,2412,0.0,2311.5,-201
8320,1847,2152,1.0,1999.5,-305
8321,1979,1840,1.0,1909.5,139
8322,2138,1995,1.0,2066.5,143
8323,1993,2038,0.5,2015.5,-45
8324,1753,1829,0.5,1791.0,-76
8325,1765,1906,1.0,1835.5,-141
8326,1844,1910,0.0,1877.0,-66
8327,1999,1819,1.0,1909.0,180
8328,1723,1723,0.0,1723.0,0
8329,1902,1992,1.0,1947.0,-90
8330,2169,1896,1.0,2032.5,273
8331,1844,1875,0.5,1859.5,-31
8332,1859,1978,0.0,1918.5,-119
8333,1618,1780,0.0,1699.0,-162
8334,2091,1648,0.5,1869.5,443
8335,1904,2057,0.0,1980.5,-153
8336,2153,2000,1.0,2076.5,153
8337,1651,1631,0.0,1641.0,20
8338,1880,2231,0.0,2055.5,-351
8339,2018,2026,1.0,2022.0,-8
8340,1935,1950,0.0,1942.5,-15
8341,1844,1950,1.0,1897.0,-106
8342,1790,1902,0.5,1846.0,-112
8343,2058,1776,1.0,1917.0,282
8344,1495,1760,0.0,1627.5,-265
8345,1848,2060,0.0,1954.0,-212
8346,1747,1793,1.0,1770.0,-46
8347,1661,1758,0.5,1709.5,-97
8348,1751,1955,1.0,1853.0,-204
8349,1877,1635,0.0,1756.0,242
8350,1701,2066,1.0,1883.5,-365
8351,1774,1781,0.5,1777.5,-7
8352,1988,1654,1.0,1821.0,334
8353,1716,1771,0.0,1743.5,-55
8354,1873,1951,0.0,1912.0,-78
8355,1553,1828,0.0,1690.5,-275
8356,1631,1819,1.0,1725.0,-188
8357,1662,1873,0.0,1767.5,-211
8358,1721,1576,1.0,1648.5,145
8359,1882,1595,1.0,1738.5,287
8360,2138,1250,1.0,1694.0,888
8361,1772,1823,1.0,1797.5,-51
8362,1820,1353,0.5,1586.5,467
8363,1818,1730,1.0,1774.0,88
8364,1849,1789,0.0,1819.0,60
8365,1765,1756,0.0,1760.5,9
8366,1888,2116,0.0,2002.0,-228
8367,1060,1779,0.0,1419.5,-719
8368,1627,1627,0.0,1627.0,0
8369,2804,2739,1.0,2771.5,65
8370,2727,2765,0.5,2746.0,-38
8371,2712,2612,0.5,2662.0,100
8372,2568,2708,0.0,2638.0,-140
8373,2780,2827,0.5,2803.5,-47
8374,2776,2691,0.5,2733.5,85
8375,2660,2722,0.0,2691.0,-62
8376,2682,2621,0.5,2651.5,61
8377,2760,2712,0.5,2736.0,48
8378,2672,2768,0.5,2720.0,-96
8379,2779,2689,1.0,2734.0,90
8380,2677,2726,0.5,2701.5,-49
8381,2780,2689,0.5,2734.5,91
8382,2600,2678,0.5,2639.0,-78
8383,2649,2579,1.0,2614.0,70
8384,2565,2646,0.5,2605.5,-81
8385,2715,2661,0.5,2688.0,54
8386,2639,2620,0.5,2629.5,19
8387,2491,2618,0.5,2554.5,-127
8388,2591,2463,0.5,2527.0,128
8389,2820,2710,0.5,2765.0,110
8390,2703,2751,0.5,2727.0,-48
8391,2721,2695,0.0,2708.0,26
8392,2681,2699,0.5,2690.0,-18
8393,2780,2743,0.5,2761.5,37
8394,2711,2639,0.5,2675.0,72
8395,2642,2668,0.0,2655.0,-26
8396,2672,2624,1.0,2648.0,48
8397,2605,2703,0.5,2654.0,-98
8398,2674,2538,0.5,2606.0,136
8399,2582,2633,1.0,2607.5,-51
8400,2594,2449,0.5,2521.5,145
8401,2740,2639,0.5,2689.5,101
8402,2590,2662,1.0,2626.0,-72
8403,2557,2581,1.0,2569.0,-24
8404,2564,2556,0.0,2560.0,8
8405,2535,2517,0.5,2526.0,18
8406,2527,2525,0.5,2526.0,2
8407,2493,2497,1.0,2495.0,-4
8408,2495,2477,0.5,2486.0,18
8409,2686,2634,1.0,2660.0,52
8410,2607,2620,0.5,2613.5,-13
8411,2431,2715,0.5,2573.0,-284
8412,2590,2331,1.0,2460.5,259
8413,2649,2564,0.0,2606.5,85
8414,2508,2621,0.5,2564.5,-113
8415,2569,2497,1.0,2533.0,72
8416,2495,2548,0.5,2521.5,-53
8417,2655,2615,0.5,2635.0,40
8418,2501,2520,0.0,2510.5,-19
8419,2499,2547,0.5,2523.0,-48
8420,2552,2504,0.0,2528.0,48
8421,2580,2578,0.5,2579.0,2
8422,2570,2591,0.0,2580.5,-21
8423,2580,2565,1.0,2572.5,15
8424,2456,2452,0.0,2454.0,4
8425,2523,2686,0.0,2604.5,-163
8426,2508,2451,0.5,2479.5,57
8427,2481,2501,0.5,2491.0,-20
8428,2512,2466,1.0,2489.0,46
8429,2494,2553,0.5,2523.5,-59
8430,2464,2345,0.5,2404.5,119
8431,2256,2439,0.0,2347.5,-183
8432,2435,2254,1.0,2344.5,181
8433,2525,2606,0.0,2565.5,-81
8434,2623,2484,0.5,2553.5,139
8435,2467,2594,0.5,2530.5,-127
8436,2576,2443,0.0,2509.5,133
8437,2649,2471,1.0,2560.0,178
8438,2343,2589,0.5,2466.0,-246
8439,2576,2373,1.0,2474.5,203
8440,2425,2582,1.0,2503.5,-157
8441,2633,2619,1.0,2626.0,14
8442,2544,2588,0.5,2566.0,-44
8443,2569,2522,0.0,2545.5,47
8444,2484,2502,0.5,2493.0,-18
8445,2620,2634,0.5,2627.0,-14
8446,2601,2558,1.0,2579.5,43
8447,2548,2594,0.5,2571.0,-46
8448,2544,2542,0.5,2543.0,2
8449,2662,2471,0.5,2566.5,191
8450,2389,2558,0.5,2473.5,-169
8451,2521,2440,1.0,2480.5,81
8452,2402,2445,0.0,2423.5,-43
8453,2590,2588,1.0,2589.0,2
8454,2566,2479,1.0,2522.5,87
8455,2489,2540,0.5,2514.5,-51
8456,2523,2496,0.5,2509.5,27
8457,2570,2514,0.5,2542.0,56
8458,2462,2489,0.0,2475.5,-27
8459,2452,2467,0.5,2459.5,-15
8460,2423,2470,0.0,2446.5,-47
8461,2505,2690,0.5,2597.5,-185
8462,2609,2443,1.0,2526.0,166
8463,2411,2621,0.5,2516.0,-210
8464,2678,2156,1.0,2417.0,522
8465,2609,2542,1.0,2575.5,67
8466,2500,2494,1.0,2497.0,6
8467,2664,2457,1.0,2560.5,207
8468,2380,2571,0.5,2475.5,-191
8469,2567,2511,1.0,2539.0,56
8470,2465,2476,1.0,2470.5,-11
8471,2449,2424,0.0,2436.5,25
8472,2438,2448,0.0,2443.0,-10
8473,2579,2472,0.5,2525.5,107
8474,2477,2472,0.5,2474.5,5
8475,2402,2263,0.5,2332.5,139
8476,2452,2381,0.0,2416.5,71
8477,2401,2391,0.5,2396.0,10
8478,2358,2398,0.5,2378.0,-40
8479,2452,2196,1.0,2324.0,256
8480,2244,2290,0.0,2267.0,-46
8481,2501,2077,1.0,2289.0,424
8482,2237,2519,0.0,2378.0,-282
8483,2444,2165,1.0,2304.5,279
8484,1937,2443,0.0,2190.0,-506
8485,2419,2646,0.0,2532.5,-227
8486,2566,2291,1.0,2428.5,275
8487,2372,2535,0.0,2453.5,-163
8488,2408,2196,0.0,2302.0,212
8489,2543,2139,1.0,2341.0,404
8490,2238,2444,0.5,2341.0,-206
8491,2382,2121,1.0,2251.5,261
8492,2047,2380,0.5,2213.5,-333
8493,2664,2430,1.0,2547.0,234
8494,2229,2610,0.5,2419.5,-381
8495,2583,2178,0.5,2380.5,405
8496,2182,2568,0.0,2375.0,-386
8497,2619,2422,1.0,2520.5,197
8498,2262,2468,0.0,2365.0,-206
8499,2486,2245,1.0,2365.5,241
8500,2227,2358,0.0,2292.5,-131
8501,2376,2629,0.0,2502.5,-253
8502,2482,2305,1.0,2393.5,177
8503,2264,2666,0.0,2465.0,-402
8504,2492,2145,1.0,2318.5,347
8505,2335,2396,1.0,2365.5,-61
8506,2313,2321,0.0,2317.0,-8
8507,2297,2259,1.0,2278.0,38
8508,2151,2134,0.0,2142.5,17
8509,2393,2549,0.0,2471.0,-156
8510,2512,2273,0.5,2392.5,239
8511,2208,2507,0.0,2357.5,-299
8512,2494,2237,0.5,2365.5,257
8513,2408,2573,0.0,2490.5,-165
8514,2530,2402,1.0,2466.0,128
8515,2284,2502,0.0,2393.0,-218
8516,2428,2157,0.5,2292.5,271
8517,2391,2149,1.0,2270.0,242
8518,2319,2386,0.5,2352.5,-67
8519,2373,2207,1.0,2290.0,166
8520,2292,2360,0.5,2326.0,-68
8521,2477,2263,1.0,2370.0,214
8522,2078,2439,0.5,2258.5,-361
8523,2322,1999,1.0,2160.5,323
8524,1860,2308,0.0,2084.0,-448
8525,2501,2422,0.0,2461.5,79
8526,2281,2445,0.0,2363.0,-164
8527,2413,2126,1.0,2269.5,287
8528,2013,2318,0.0,2165.5,-305
8529,2452,2218,0.0,2335.0,234
8530,2361,2433,1.0,2397.0,-72
8531,2360,2246,0.0,2303.0,114
8532,2146,2317,0.0,2231.5,-171
8533,2464,2636,0.0,2550.0,-172
8534,2370,2358,0.0,2364.0,12
8535,2273,2346,0.5,2309.5,-73
8536,2363,2205,1.0,2284.0,158
8537,2473,2408,0.0,2440.5,65
8538,2324,2389,0.5,2356.5,-65
8539,2327,2128,0.5,2227.5,199
8540,2170,2235,1.0,2202.5,-65
8541,2405,2498,0.0,2451.5,-93
8542,2441,2349,1.0,2395.0,92
8543,2315,2316,0.0,2315.5,-1
8544,2274,2276,1.0,2275.0,-2
8545,2182,2427,0.0,2304.5,-245
8546,2396,2351,1.0,2373.5,45
8547,2108,2299,0.0,2203.5,-191
8548,2483,1826,1.0,2154.5,657
8549,2356,2061,1.0,2208.5,295
8550,2171,2245,0.5,2208.0,-74
8551,2115,2328,1.0,2221.5,-213
8552,2259,2099,0.0,2179.0,160
8553,2206,2434,0.0,2320.0,-228
8554,2310,2055,1.0,2182.5,255
8555,2054,2283,1.0,2168.5,-229
8556,2283,1984,1.0,2133.5,299
8557,2315,2064,1.0,2189.5,251
8558,1988,2192,0.0,2090.0,-204
8559,2244,1908,0.0,2076.0,336
8560,1826,2174,1.0,2000.0,-348
8561,2441,2262,0.0,2351.5,179
8562,2250,2345,0.5,2297.5,-95
8563,2382,2158,0.0,2270.0,224
8564,2039,2301,0.0,2170.0,-262
8565,2475,2206,1.0,2340.5,269
8566,2161,2428,0.0,2294.5,-267
8567,2124,2147,0.0,2135.5,-23
8568,2193,2096,1.0,2144.5,97
8569,2419,2300,1.0,2359.5,119
8570,2299,2301,1.0,2300.0,-2
8571,2195,2275,0.5,2235.0,-80
8572,2252,2106,0.5,2179.0,146
8573,2188,2303,0.5,2245.5,-115
8574,2274,2158,0.5,2216.0,116
8575,2144,2294,0.0,2219.0,-150
8576,2222,2059,1.0,2140.5,163
8577,2338,2232,1.0,2285.0,106
8578,2355,2138,0.0,2246.5,217
8579,2121,2388,0.5,2254.5,-267
8580,2405,2024,0.0,2214.5,381
8581,1992,2421,0.0,2206.5,-429
8582,2437,2380,1.0,2408.5,57
8583,2209,2111,1.0,2160.0,98
8584,2305,2114,1.0,2209.5,191
8585,2062,2198,0.5,2130.0,-136
8586,1926,2008,1.0,1967.0,-82
8587,2228,2346,0.0,2287.0,-118
8588,2387,2185,1.0,2286.0,202
8589,2163,2324,0.5,2243.5,-161
8590,2319,2143,1.0,2231.0,176
8591,2276,1803,0.0,2039.5,473
8592,1903,2400,0.0,2151.5,-497
8593,1695,2220,0.0,1957.5,-525
8594,1896,2243,0.0,2069.5,-347
8595,2106,1835,1.0,1970.5,271
8596,1914,2096,1.0,2005.0,-182
8597,2145,1964,1.0,2054.5,181
8598,1905,2024,0.0,1964.5,-119
8599,1797,1948,1.0,1872.5,-151
8600,2233,1863,1.0,2048.0,370
8601,2347,1787,1.0,2067.0,560
8602,2028,2329,0.0,2178.5,-301
8603,2258,2053,0.5,2155.5,205
8604,2048,2222,0.0,2135.0,-174
8605,2095,2154,0.5,2124.5,-59
8606,2291,2038,1.0,2164.5,253
8607,1940,2163,1.0,2051.5,-223
8608,1836,1885,0.0,1860.5,-49
8609,2400,2067,1.0,2233.5,333
8610,2024,2203,1.0,2113.5,-179
8611,2131,2010,0.0,2070.5,121
8612,2029,2157,0.0,2093.0,-128
8613,2418,2328,1.0,2373.0,90
8614,2276,2128,0.0,2202.0,148
8615,2093,2177,0.5,2135.0,-84
8616,2173,2051,1.0,2112.0,122
8617,2042,2550,0.0,2296.0,-508
8618,2248,1999,1.0,2123.5,249
8619,1902,2239,0.0,2070.5,-337
8620,2237,1896,1.0,2066.5,341
8621,2170,1678,1.0,1924.0,492
8622,1766,2183,0.0,1974.5,-417
8623,2127,1965,1.0,2046.0,162
8624,2031,2054,0.5,2042.5,-23
8625,2285,2138,0.5,2211.5,147
8626,1829,2283,0.5,2056.0,-454
8627,2216,1753,1.0,1984.5,463
8628,2155,2246,0.5,2200.5,-91
8629,2000,2091,1.0,2045.5,-91
8630,2016,2190,0.5,2103.0,-174
8631,2231,2153,1.0,2192.0,78
8632,1986,1820,1.0,1903.0,166
8633,1900,2024,1.0,1962.0,-124
8634,2015,1979,0.0,1997.0,36
8635,1653,1665,1.0,1659.0,-12
8636,2261,2116,1.0,2188.5,145
8637,1879,2126,0.0,2002.5,-247
8638,2226,2124,1.0,2175.0,102
8639,1988,1910,0.5,1949.0,78
8640,2058,2175,0.0,2116.5,-117
8641,2014,2000,1.0,2007.0,14
8642,2012,2096,1.0,2054.0,-84
8643,2132,1890,0.0,2011.0,242
8644,2054,2216,0.5,2135.0,-162
8645,2002,2069,0.5,2035.5,-67
8646,2034,1943,1.0,1988.5,91
8647,2112,1924,0.5,2018.0,188
8648,2185,2327,1.0,2256.0,-142
8649,1911,1785,1.0,1848.0,126
8650,2090,2098,1.0,2094.0,-8
8651,2074,1690,0.0,1882.0,384
8652,1846,1850,0.5,1848.0,-4
8653,2022,1845,0.0,1933.5,177
8654,1863,1775,0.0,1819.0,88
8655,1661,2041,0.5,1851.0,-380
8656,1801,1674,0.0,1737.5,127
8657,1840,1825,0.0,1832.5,15
8658,1441,1737,0.0,1589.0,-296
8659,1723,1840,0.0,1781.5,-117
8660,2061,2169,0.0,2115.0,-108
8661,1859,1978,1.0,1918.5,-119
8662,2175,2018,1.0,2096.5,157
8663,1950,2125,0.0,2037.5,-175
8664,1854,1926,0.5,1890.0,-72
8665,1776,1712,0.5,1744.0,64
8666,1910,2211,1.0,2060.5,-301
8667,2152,1844,0.5,1998.0,308
8668,1819,1979,0.5,1899.0,-160
8669,1995,2412,0.0,2203.5,-417
8670,1793,1840,0.0,1816.5,-47
8671,1608,1995,0.0,1801.5,-387
8672,1694,1560,1.0,1627.0,134
8673,1525,1517,1.0,1521.0,8
8674,1793,1408,1.0,1600.5,385
8675,1873,1631,1.0,1752.0,242
8676,1955,1747,1.0,1851.0,208
8677,1595,1721,0.0,1658.0,-126
8678,2066,1751,0.0,1908.5,315
8679,2060,2058,1.0,2059.0,2
8680,1827,1701,0.5,1764.0,126
8681,1951,1988,1.0,1969.5,-37
8682,1655,1779,1.0,1717.0,-124
8683,1710,1819,1.0,1764.5,-109
8684,1723,1655,1.0,1689.0,68
8685,1723,1723,0.0,1723.0,0
8686,2038,1743,1.0,1890.5,295
8687,1627,1779,0.0,1703.0,-152
8688,1906,1993,0.0,1949.5,-87
8689,1587,1627,0.0,1607.0,-40
8690,2218,1880,1.0,2049.0,338
8691,2026,1875,0.5,1950.5,151
8692,1844,1780,1.0,1812.0,64
8693,2057,1882,1.0,1969.5,175
8694,1823,1904,1.0,1863.5,-81
8695,1892,1730,1.0,1811.0,162
8696,1323,1651,0.0,1487.0,-328
8697,1950,2116,1.0,2033.0,-166
8698,1888,1935,0.5,1911.5,-47
8699,1771,1760,0.0,1765.5,11
8700,1495,1828,0.0,1661.5,-333
8701,1766,1553,0.0,1659.5,213
8702,1680,1848,1.0,1764.0,-168
8703,1635,1661,1.0,1648.0,-26
8704,1818,1877,0.5,1847.5,-59
8705,1781,1849,1.0,1815.0,-68
8706,1677,1774,1.0,1725.5,-97
8707,1654,1756,0.5,1705.0,-102
8708,1576,1662,1.0,1619.0,-86
8709,2138,1060,1.0,1599.0,1078
8710,1820,1353,1.0,1586.5,467
8711,2827,2804,0.5,2815.5,23
8712,2765,2776,0.5,2770.5,-11
8713,2763,2712,0.5,2737.5,51
8714,2708,2722,0.5,2715.0,-14
8715,2780,2760,0.5,2770.0,20
8716,2768,2678,1.0,2723.0,90
8717,2649,2779,0.5,2714.0,-130
8718,2726,2629,0.5,2677.5,97
8719,2771,2739,0.5,2755.0,32
8720,2727,2743,0.5,2735.0,-16
8721,2711,2612,0.5,2661.5,99
8722,2614,2668,0.5,2641.0,-54
8723,2661,2780,0.5,2720.5,-119
8724,2691,2639,0.5,2665.0,52
8725,2618,2660,0.5,2639.0,-42
8726,2597,2595,0.5,2596.0,2
8727,2710,2740,0.5,2725.0,-30
8728,2662,2703,0.5,2682.5,-41
8729,2695,2574,1.0,2634.5,121
8730,2556,2681,1.0,2618.5,-125
8731,2712,2605,1.0,2658.5,107
8732,2538,2672,0.5,2605.0,-134
8733,2689,2582,1.0,2635.5,107
8734,2449,2677,0.0,2563.0,-228
8735,2553,2715,0.0,2634.0,-162
8736,2620,2464,1.0,2542.0,156
8737,2439,2491,1.0,2465.0,-52
8738,2463,2435,1.0,2449.0,28
8739,2689,2655,0.0,2672.0,34
8740,2520,2600,0.5,2560.0,-80
8741,2565,2499,0.0,2532.0,66
8742,2504,2567,0.5,2535.5,-63
8743,2686,2535,1.0,2610.5,151
8744,2525,2508,0.5,2516.5,17
8745,2501,2493,0.0,2497.0,8
8746,2477,2512,0.0,2494.5,-35
8747,2580,2662,0.0,2621.0,-82
8748,2558,2591,0.5,2574.5,-33
8749,2580,2521,0.0,2550.5,59
8750,2416,2452,0.5,2434.0,-36
8751,2517,2751,0.0,2634.0,-234
8752,2721,2527,1.0,2624.0,194
8753,2495,2699,0.0,2597.0,-204
8754,2676,2472,1.0,2574.0,204
8755,2634,2703,1.0,2668.5,-69
8756,2674,2601,0.5,2637.5,73
8757,2544,2692,1.0,2618.0,-148
8758,2594,2552,1.0,2573.0,42
8759,2634,2639,0.5,2636.5,-5
8760,2590,2607,0.5,2598.5,-17
8761,2715,2581,0.5,2648.0,134
8762,2573,2590,0.5,2581.5,-17
8763,2570,2780,0.5,2675.0,-210
8764,2639,2489,0.5,2564.0,150
8765,2421,2642,1.0,2531.5,-221
8766,2624,2470,0.5,2547.0,154
8767,2564,2649,0.5,2606.5,-85
8768,2589,2508,1.0,2548.5,81
8769,2497,2576,1.0,2536.5,-79
8770,2582,2495,1.0,2538.5,87
8771,2525,2649,0.5,2587.0,-124
8772,2621,2465,1.0,2543.0,156
8773,2484,2569,1.0,2526.5,-85
8774,2562,2467,0.0,2514.5,95
8775,2690,2401,1.0,2545.5,289
8776,2398,2621,0.5,2509.5,-223
8777,2702,2452,1.0,2577.0,250
8778,2206,2678,0.0,2442.0,-472
8779,2686,2609,0.5,2647.5,77
8780,2494,2620,0.0,2557.0,-126
8781,2431,2565,1.0,2498.0,-134
8782,2571,2408,0.0,2489.5,163
8783,2629,2472,1.0,2550.5,157
8784,2447,2513,0.5,2480.0,-66
8785,2666,2402,0.0,2534.0,264
8786,2381,2492,0.0,2436.5,-111
8787,2606,2619,0.5,2612.5,-13
8788,2468,2623,0.5,2545.5,-155
8789,2594,2486,1.0,2540.0,108
8790,2358,2551,0.0,2454.5,-193
8791,2578,2566,0.5,2572.0,12
8792,2527,2570,0.0,2548.5,-43
8793,2565,2540,0.5,2552.5,25
8794,2523,2456,0.5,2489.5,67
8795,2610,2501,0.5,2555.5,109
8796,2519,2602,0.0,2560.5,-83
8797,2583,2486,1.0,2534.5,97
8798,2444,2568,0.0,2506.0,-124
8799,2646,2567,0.0,2606.5,79
8800,2391,2566,0.5,2478.5,-175
8801,2535,2386,1.0,2460.5,149
8802,2373,2408,0.5,2390.5,-35
8803,2633,2590,1.0,2611.5,43
8804,2479,2609,0.5,2544.0,-130
8805,2588,2489,0.5,2538.5,99
8806,2496,2502,1.0,2499.0,-6
8807,2573,2567,0.5,2570.0,6
8808,2476,2530,1.0,2503.0,-54
8809,2502,2465,0.5,2483.5,37
8810,2449,2428,0.5,2438.5,21
8811,2619,2523,1.0,2571.0,96
8812,2451,2544,0.0,2497.5,-93
8813,2522,2481,0.5,2501.5,41
8814,2486,2456,0.0,2471.0,30
8815,2615,2543,0.5,2579.0,72
8816,2444,2501,0.5,2472.5,-57
8817,2547,2382,1.0,2464.5,165
8818,2380,2500,0.5,2440.0,-120
8819,2549,2477,1.0,2513.0,72
8820,2439,2523,0.0,2481.0,-84
8821,2512,2322,1.0,2417.0,190
8822,2308,2507,0.5,2407.5,-199
8823,2465,2494,0.0,2479.5,-29
8824,2345,2424,1.0,2384.5,-79
8825,2438,2256,1.0,2347.0,182
8826,2230,2313,0.5,2271.5,-83
8827,2431,2620,0.5,2525.5,-189
8828,2548,2427,0.0,2487.5,121
8829,2396,2543,0.0,2469.5,-147
8830,2542,2299,0.5,2420.5,243
8831,2356,2471,0.5,2413.5,-115
8832,2389,2245,1.0,2317.0,144
8833,2115,2402,0.0,2258.5,-287
8834,2365,2099,1.0,2232.0,266
8835,2471,2335,1.0,2403.0,136
8836,2321,2340,1.0,2330.5,-19
8837,2343,2297,0.5,2320.0,46
8838,2134,2425,0.0,2279.5,-291
8839,2514,2636,1.0,2575.0,-122
8840,2346,2482,0.0,2414.0,-136
8841,2462,2363,1.0,2412.5,99
8842,2345,2423,0.0,2384.0,-78
8843,2475,2376,0.0,2425.5,99
8844,2305,2428,0.5,2366.5,-123
8845,2176,2264,0.0,2220.0,-88
8846,2194,2124,0.5,2159.0,70
8847,2396,2418,0.5,2407.0,-22
8848,2261,2313,0.0,2287.0,-52
8849,2288,2128,1.0,2208.0,160
8850,2093,2151,1.0,2122.0,-58
8851,2303,2505,0.0,2404.0,-202
8852,2443,2244,0.5,2343.5,199
8853,2294,2349,1.0,2321.5,-55
8854,2411,2222,1.0,2316.5,189
8855,2262,2542,0.0,2402.0,-280
8856,2500,2250,1.0,2375.0,250
8857,2158,2457,1.0,2307.5,-299
8858,2380,2039,1.0,2209.5,341
8859,2472,2391,0.0,2431.5,81
8860,2358,2477,0.0,2417.5,-119
8861,2263,2244,1.0,2253.5,19
8862,2193,2452,0.5,2322.5,-259
8863,2218,2408,0.0,2313.0,-190
8864,2324,2361,0.5,2342.5,-37
8865,2246,2128,1.0,2187.0,118
8866,2161,2146,1.0,2153.5,15
8867,2498,2501,1.0,2499.5,-3
8868,2445,2441,0.5,2443.0,4
8869,2316,2482,0.5,2399.0,-166
8870,2413,2274,0.0,2343.5,139
8871,2310,2338,0.0,2324.0,-28
8872,2138,2283,0.0,2210.5,-145
8873,2283,2121,0.5,2202.0,162
8874,2024,2140,1.0,2082.0,-116
8875,2344,2243,0.0,2293.5,101
8876,2106,2262,0.0,2184.0,-156
8877,2245,2096,1.0,2170.5,149
8878,1912,2227,0.0,2069.5,-315
8879,2430,2273,1.0,2351.5,157
8880,2400,2229,1.0,2314.5,171
8881,2178,2271,1.0,2224.5,-93
8882,2220,2182,0.0,2201.0,38
8883,2206,2408,0.0,2307.0,-202
8884,2402,2161,1.0,2281.5,241
8885,2147,2284,1.0,2215.5,-137
8886,2157,2193,0.5,2175.0,-36
8887,2095,2291,1.0,2193.0,-196
8888,2372,2038,1.0,2205.0,334
8889,1940,2196,0.0,2068.0,-256
8890,2160,1885,1.0,2022.5,275
8891,2300,2263,1.0,2281.5,37
8892,2129,2299,0.5,2214.0,-170
8893,2275,2078,0.5,2176.5,197
8894,1999,2267,0.0,2133.0,-268
8895,2388,2273,1.0,2330.5,115
8896,2208,2315,0.0,2261.5,-107
8897,2192,2160,1.0,2176.0,32
8898,2237,2244,0.0,2240.5,-7
8899,2111,2421,0.0,2266.0,-310
8900,2437,2305,0.0,2371.0,132
8901,2198,2380,0.0,2289.0,-182
8902,2035,1926,1.0,1980.5,109
8903,2346,2145,0.5,2245.5,201
8904,1981,2387,0.0,2184.0,-406
8905,2324,2024,1.0,2174.0,300
8906,1797,2229,1.0,2013.0,-432
8907,2064,2347,1.0,2205.5,-283
8908,2258,1988,1.0,2123.0,270
8909,1908,2222,1.0,2065.0,-314
8910,2039,1826,0.0,1932.5,213
8911,2149,2077,1.0,2113.0,72
8912,2237,2319,1.0,2278.0,-82
8913,2207,2165,1.0,2186.0,42
8914,1937,2292,0.0,2114.5,-355
8915,2139,2419,0.0,2279.0,-280
8916,2301,2238,1.0,2269.5,63
8917,2171,2195,0.0,2183.0,-24
8918,2158,2047,0.5,2102.5,111
8919,2024,2281,0.0,2152.5,-257
8920,2126,1900,0.0,2013.0,226
8921,1665,2126,0.0,1895.5,-461
8922,2013,1653,1.0,1833.0,360
8923,2550,2261,0.0,2405.5,289
8924,2124,2331,0.5,2227.5,-207
8925,2248,2226,0.5,2237.0,22
8926,2221,2239,0.0,2230.0,-18
8927,1850,2452,0.0,2151.0,-602
8928,2360,1846,1.0,2103.0,514
8929,1775,2317,0.0,2046.0,-542
8930,2316,1863,1.0,2089.5,453
8931,2297,2285,1.0,2291.0,12
8932,2283,2405,0.5,2344.0,-122
8933,2315,2223,0.5,2269.0,92
8934,2216,2276,0.0,2246.0,-60
8935,2216,2358,0.0,2287.0,-142
8936,2273,2054,1.0,2163.5,219
8937,2034,2220,0.0,2127.0,-186
8938,2205,2016,1.0,2110.5,189
8939,2473,2441,0.5,2457.0,32
8940,2345,2389,0.5,2367.0,-44
8941,2327,2382,0.5,2354.5,-55
8942,2292,2200,1.0,2246.0,92
8943,1661,2236,0.0,1948.5,-575
8944,2170,1825,1.0,1997.5,345
8945,1840,2183,0.0,2011.5,-343
8946,2127,1840,1.0,1983.5,287
8947,2091,2351,0.5,2221.0,-260
8948,2203,2000,1.0,2101.5,203
8949,2153,2108,0.0,2130.5,45
8950,1826,2231,0.0,2028.5,-405
8951,2061,2188,0.0,2124.5,-127
8952,2158,2171,1.0,2164.5,-13
8953,2328,2071,1.0,2199.5,257
8954,2059,2118,1.0,2088.5,-59
8955,2024,2206,0.0,2115.0,-182
8956,2135,2010,1.0,2072.5,125
8957,2029,2054,0.5,2041.5,-25
8958,1984,1996,1.0,1990.0,-12
8959,2125,2327,0.0,2226.0,-202
8960,2185,2355,1.0,2270.0,-170
8961,2388,2098,1.0,2243.0,290
8962,2090,2405,1.0,2247.5,-315
8963,2203,1992,0.0,2097.5,211
8964,2131,2215,1.0,2173.0,-84
8965,1904,2157,0.0,2030.5,-253
8966,1964,1910,0.5,1937.0,54
8967,1844,1986,0.0,1915.0,-142
8968,1948,1819,0.5,1883.5,129
8969,2095,2233,1.0,2164.0,-138
8970,2291,2154,0.0,2222.5,137
8971,2014,2000,1.0,2007.0,14
8972,1836,1830,0.5,1833.0,6
8973,1896,1993,0.0,1944.5,-97
8974,1793,1835,0.0,1814.0,-42
8975,1751,1747,1.0,1749.0,4
8976,2058,2175,0.0,2116.5,-117
8977,2125,2060,0.5,2092.5,65
8978,1712,1854,0.0,1783.0,-142
8979,1988,2058,0.5,2023.0,-70
8980,2096,1951,0.5,2023.5,145
8981,1873,1992,1.0,1932.5,-119
8982,1890,1710,1.0,1800.0,180
8983,2249,1723,1.0,1986.0,526
8984,2053,2028,1.0,2040.5,25
8985,2209,2048,0.0,2128.5,161
8986,2163,2185,0.5,2174.0,-22
8987,2062,2114,0.5,2088.0,-52
8988,2129,2143,1.0,2136.0,-14
8989,2000,2008,0.0,2004.0,-8
8990,2061,2169,0.0,2115.0,-108
8991,1694,1995,1.0,1844.5,-301
8992,1859,1978,1.0,1918.5,-119
8993,1803,1517,1.0,1660.0,286
8994,1979,1986,1.0,1982.5,-7
8995,1903,2015,1.0,1959.0,-112
8996,2116,1695,1.0,1905.5,421
8997,2138,2328,0.0,2233.0,-190
8998,2177,1829,1.0,2003.0,348
8999,1753,2173,0.0,1963.0,-420
9000,1880,1956,0.0,1918.0,-76
9001,2190,2026,1.0,2108.0,164
9002,1820,2016,0.0,1918.0,-196
9003,1674,2085,0.0,1879.5,-411
9004,2069,1805,1.0,1937.0,264
9005,1801,2002,0.5,1901.5,-201
9006,1924,1737,1.0,1830.5,187
9007,1765,2038,0.5,1901.5,-273
9008,1720,1906,0.0,1813.0,-186
9009,2412,1785,0.0,2098.5,627
9010,1783,1847,1.0,1815.0,-64
9011,1840,1911,0.0,1875.5,-71
9012,1690,2042,1.0,1866.0,-352
9013,1793,1902,1.0,1847.5,-109
9014,1766,2074,0.0,1920.0,-308
9015,1845,1965,0.5,1905.0,-120
9016,1985,2022,0.5,2003.5,-37
9017,2041,2031,0.5,2036.0,10
9018,2018,2057,0.0,2037.5,-39
9019,1904,1926,1.0,1915.0,-22
9020,1844,1892,0.0,1868.0,-48
9021,1631,1776,1.0,1703.5,-145
9022,2126,1950,0.0,2038.0,176
9023,1935,1879,0.0,1907.0,56
9024,1910,1790,1.0,1850.0,120
9025,2152,1988,1.0,2070.0,164
9026,1873,1631,0.5,1752.0,242
9027,1995,1979,0.5,1987.0,16
9028,1591,1721,0.0,1656.0,-130
9029,1608,1831,1.0,1719.5,-223
9030,1758,1848,0.0,1803.0,-90
9031,1525,1560,1.0,1542.5,-35
9032,1661,1680,0.5,1670.5,-19
9033,1723,1408,0.0,1565.5,315
9034,1779,1827,1.0,1803.0,-48
9035,1743,1723,1.0,1733.0,20
9036,1655,1655,0.0,1655.0,0
9037,1760,2066,0.0,1913.0,-306
9038,1701,1495,1.0,1598.0,206
9039,2218,1818,1.0,2018.0,400
9040,1789,1875,1.0,1832.0,-86
9041,1844,1677,1.0,1760.5,167
9042,1756,1780,0.0,1768.0,-24
9043,1771,1250,1.0,1510.5,521
9044,2138,1716,0.5,1927.0,422
9045,1766,1353,1.0,1559.5,413
9046,1820,1553,1.0,1686.5,267
9047,2116,1877,1.0,1996.5,239
9048,1781,1888,1.0,1834.5,-107
9049,1654,1774,1.0,1714.0,-120
9050,1779,1882,0.0,1830.5,-103
9051,1823,1627,1.0,1725.0,196
9052,1627,1772,1.0,1699.5,-145
9053,1323,1587,0.0,1455.0,-264
9054,1662,1576,0.5,1619.0,86
9055,2555,2409,1.0,2482.0,146
9056,2384,2533,0.5,2458.5,-149
9057,2451,2331,1.0,2391.0,120
9058,2205,2403,0.5,2304.0,-198
9059,2561,2394,1.0,2477.5,167
9060,2374,2446,0.5,2410.0,-72
9061,2468,2328,1.0,2398.0,140
9062,2157,2351,0.0,2254.0,-194
9063,2431,2421,0.5,2426.0,10
9064,2267,2423,0.0,2345.0,-156
9065,2361,2321,1.0,2341.0,40
9066,2294,2268,0.5,2281.0,26
9067,2423,2557,1.0,2490.0,-134
9068,2500,2370,0.5,2435.0,130
9069,2321,2400,1.0,2360.5,-79
9070,2374,2260,0.5,2317.0,114
9071,2391,2438,0.0,2414.5,-47
9072,2358,2317,0.0,2337.5,41
9073,2325,2326,0.0,2325.5,-1
9074,2355,2301,0.5,2328.0,54
9075,2509,2474,0.5,2491.5,35
9076,2482,2475,1.0,2478.5,7
9077,2482,2394,0.5,2438.0,88
9078,2263,2404,1.0,2333.5,-141
9079,2345,2559,0.0,2452.0,-214
9080,2535,2339,1.0,2437.0,196
9081,2275,2469,0.0,2372.0,-194
9082,2462,2260,1.0,2361.0,202
9083,2431,2391,1.0,2411.0,40
9084,2151,2261,0.0,2206.0,-110
9085,2135,2039,1.0,2087.0,96
9086,2222,2101,0.5,2161.5,121
9087,2446,2422,0.0,2434.0,24
9088,2377,2424,1.0,2400.5,-47
9089,2407,2149,1.0,2278.0,258
9090,2367,2347,1.0,2357.0,20
9091,2368,2415,0.0,2391.5,-47
9092,2281,2347,0.0,2314.0,-66
9093,2323,2243,0.5,2283.0,80
9094,2294,2244,0.5,2269.0,50
9095,2369,2303,1.0,2336.0,66
9096,2248,2202,1.0,2225.0,46
9097,2265,2231,1.0,2248.0,34
9098,2276,2167,1.0,2221.5,109
9099,2225,2462,0.0,2343.5,-237
9100,2172,2207,0.0,2189.5,-35
9101,2144,1980,1.0,2062.0,164
9102,1840,2134,0.5,1987.0,-294
9103,2480,2369,0.0,2424.5,111
9104,2159,2414,0.0,2286.5,-255
9105,2390,1954,1.0,2172.0,436
9106,2034,2237,0.0,2135.5,-203
9107,2404,2157,1.0,2280.5,247
9108,2136,2329,1.0,2232.5,-193
9109,2235,2129,1.0,2182.0,106
9110,1946,2192,0.0,2069.0,-246
9111,2268,2254,0.0,2261.0,14
9112,2167,2218,0.0,2192.5,-51
9113,2123,2114,1.0,2118.5,9
9114,2009,2081,1.0,2045.0,-72
9115,2348,2124,1.0,2236.0,224
9116,2156,2339,0.0,2247.5,-183
9117,2241,2051,1.0,2146.0,190
9118,2026,2170,0.0,2098.0,-144
9119,2056,2313,0.5,2184.5,-257
9120,2081,2056,1.0,2068.5,25
9121,1862,1911,0.5,1886.5,-49
9122,1876,1854,0.5,1865.0,22
9123,2090,2054,0.5,2072.0,36
9124,2005,2038,1.0,2021.5,-33
9125,1840,1943,0.5,1891.5,-103
9126,1866,1685,1.0,1775.5,181
9127,2287,2350,0.0,2318.5,-63
9128,2219,2157,1.0,2188.0,62
9129,2102,2215,1.0,2158.5,-113
9130,2186,2080,0.5,2133.0,106
9131,2288,2375,0.5,2331.5,-87
9132,2313,2290,1.0,2301.5,23
9133,2268,2288,1.0,2278.0,-20
9134,2258,2198,1.0,2228.0,60
9135,2254,2050,1.0,2152.0,204
9136,2030,2185,0.5,2107.5,-155
9137,2148,1727,0.0,1937.5,421
9138,1671,2116,0.0,1893.5,-445
9139,2244,2255,0.0,2249.5,-11
9140,2174,2227,0.0,2200.5,-53
9141,1968,2110,0.0,2039.0,-142
9142,2063,1805,0.0,1934.0,258
9143,2402,2252,1.0,2327.0,150
9144,2260,2308,0.5,2284.0,-48
9145,2161,2194,0.5,2177.5,-33
9146,2149,2112,0.5,2130.5,37
9147,2220,2447,0.5,2333.5,-227
9148,2345,2058,1.0,2201.5,287
9149,1998,2287,0.0,2142.5,-289
9150,2108,1894,1.0,2001.0,214
9151,2176,2248,1.0,2212.0,-72
9152,2191,2113,1.0,2152.0,78
9153,1898,2298,0.5,2098.0,-400
9154,2188,1600,1.0,1894.0,588
9155,2008,2404,0.0,2206.0,-396
9156,2188,2068,1.0,2128.0,120
9157,1870,2114,0.0,1992.0,-244
9158,2040,1890,1.0,1965.0,150
9159,2300,2513,0.5,2406.5,-213
9160,2348,2188,1.0,2268.0,160
9161,1849,2355,0.0,2102.0,-506
9162,2274,1635,1.0,1954.5,639
9163,2139,1869,1.0,2004.0,270
9164,1925,2098,0.0,2011.5,-173
9165,2075,1926,1.0,2000.5,149
9166,1907,1950,0.0,1928.5,-43
9167,2181,2345,0.0,2263.0,-164
9168,1923,2136,0.0,2029.5,-213
9169,2059,1924,1.0,1991.5,135
9170,1655,1947,0.0,1801.0,-292
9171,2064,2283,0.5,2173.5,-219
9172,1986,2020,0.5,2003.0,-34
9173,1751,2004,0.0,1877.5,-253
9174,1731,1687,1.0,1709.0,44
9175,1667,1966,1.0,1816.5,-299
9176,1801,1620,0.0,1710.5,181
9177,1495,1725,1.0,1610.0,-230
9178,1353,1378,0.0,1365.5,-25
9179,1803,2214,0.0,2008.5,-411
9180,1799,1725,0.5,1762.0,74
9181,1652,1772,0.0,1712.0,-120
9182,1357,1556,0.0,1456.5,-199
9183,1932,1676,0.5,1804.0,256
9184,1712,1899,1.0,1805.5,-187
9185,1790,1926,0.0,1858.0,-136
9186,1979,1727,1.0,1853.0,252
9187,2230,1953,1.0,2091.5,277
9188,1853,2170,0.5,2011.5,-317
9189,2175,1924,1.0,2049.5,251
9190,1573,2118,0.0,1845.5,-545
9191,2159,2259,1.0,2209.0,-100
9192,2330,1704,1.0,2017.0,626
9193,1510,2224,0.0,1867.0,-714
9194,2134,1397,1.0,1765.5,737
9195,2053,2022,1.0,2037.5,31
9196,1974,1771,1.0,1872.5,203
9197,1940,1909,0.0,1924.5,31
9198,1838,1788,0.5,1813.0,50
9199,2204,1813,1.0,2008.5,391
9200,1785,2172,1.0,1978.5,-387
9201,2113,1764,0.5,1938.5,349
9202,1655,2146,0.0,1900.5,-491
9203,2035,1960,1.0,1997.5,75
9204,1727,2031,0.0,1879.0,-304
9205,1935,1716,1.0,1825.5,219
9206,1655,1710,0.0,1682.5,-55
9207,2057,2157,0.5,2107.0,-100
9208,2143,2106,0.0,2124.5,37
9209,2026,2137,1.0,2081.5,-111
9210,2101,1966,0.5,2033.5,135
9211,2320,1693,1.0,2006.5,627
9212,1859,2158,0.0,2008.5,-299
9213,2102,1643,0.5,1872.5,459
9214,1617,1907,0.0,1762.0,-290
9215,1833,2082,0.0,1957.5,-249
9216,1720,1809,0.0,1764.5,-89
9217,1785,1683,0.5,1734.0,102
9218,1274,1633,0.0,1453.5,-359
9219,2029,2271,1.0,2150.0,-242
9220,1872,1961,0.5,1916.5,-89
9221,1926,1812,0.0,1869.0,114
9222,1526,1760,0.0,1643.0,-234
9223,1888,1400,1.0,1644.0,488
9224,1922,1996,1.0,1959.0,-74
9225,1432,1595,0.0,1513.5,-163
9226,2126,1718,0.0,1922.0,408
9227,2052,2082,0.5,2067.0,-30
9228,2110,2079,1.0,2094.5,31
9229,1806,1961,1.0,1883.5,-155
9230,1767,2013,0.5,1890.0,-246
9231,1604,1848,1.0,1726.0,-244
9232,1509,1505,0.5,1507.0,4
9233,1515,1705,0.0,1610.0,-190
9234,2137,1734,0.0,1935.5,403
9235,1960,2130,0.0,2045.0,-170
9236,2023,2033,0.0,2028.0,-10
9237,1921,1946,0.0,1933.5,-25
9238,1902,1956,0.0,1929.0,-54
9239,1748,1810,1.0,1779.0,-62
9240,1871,1881,0.0,1876.0,-10
9241,1755,1815,0.0,1785.0,-60
9242,1666,1853,0.0,1759.5,-187
9243,1490,1774,0.5,1632.0,-284
9244,1402,1755,0.0,1578.5,-353
9245,1494,1460,1.0,1477.0,34
9246,2044,1318,0.5,1681.0,726
9247,1713,1945,0.5,1829.0,-232
9248,1948,2010,0.5,1979.0,-62
9249,1533,1605,1.0,1569.0,-72
9250,2024,1334,1.0,1679.0,690
9251,1608,1840,0.0,1724.0,-232
9252,1594,1877,1.0,1735.5,-283
9253,1446,1535,0.0,1490.5,-89
9254,1483,1572,0.5,1527.5,-89
9255,1945,1981,1.0,1963.0,-36
9256,1508,1544,0.5,1526.0,-36
9257,1724,1900,1.0,1812.0,-176
9258,1933,1365,1.0,1649.0,568
9259,1702,1778,0.0,1740.0,-76
9260,1733,1707,0.5,1720.0,26
9261,1741,1713,0.0,1727.0,28
9262,1718,1664,0.0,1691.0,54
9263,1797,1893,1.0,1845.0,-96
9264,1528,1577,1.0,1552.5,-49
9265,1689,1531,0.5,1610.0,158
9266,1821,1577,1.0,1699.0,244
9267,1702,1745,0.0,1723.5,-43
9268,1540,1660,0.0,1600.0,-120
9269,1419,1619,1.0,1519.0,-200
9270,1584,1442,0.0,1513.0,142
9271,1708,1817,0.0,1762.5,-109
9272,1704,1537,0.5,1620.5,167
9273,1546,1411,0.5,1478.5,135
9274,1581,1637,0.5,1609.0,-56
9275,1585,1378,0.0,1481.5,207
9276,1512,1581,1.0,1546.5,-69
9277,1346,1575,0.0,1460.5,-229
9278,1736,1962,1.0,1849.0,-226
9279,1476,1475,0.0,1475.5,1
9280,1727,1712,1.0,1719.5,15
9281,1779,1105,1.0,1442.0,674
9282,1502,1482,0.0,1492.0,20
9283,1611,1719,1.0,1665.0,-108
9284,1306,1206,0.0,1256.0,100
9285,1649,1777,1.0,1713.0,-128
9286,1451,1752,0.5,1601.5,-301
9287,1708,1726,1.0,1717.0,-18
9288,1425,1545,0.0,1485.0,-120
9289,1739,1797,0.5,1768.0,-58
9290,1475,1673,1.0,1574.0,-198
9291,1123,1365,0.0,1244.0,-242
9292,1499,1481,1.0,1490.0,18
9293,1551,1174,1.0,1362.5,377
9294,1350,1306,0.0,1328.0,44
9295,1355,1263,0.0,1309.0,92
9296,1452,1788,0.0,1620.0,-336
9297,1735,1559,0.0,1647.0,176
9298,1372,1739,0.5,1555.5,-367
9299,1822,1362,1.0,1592.0,460
9300,1053,1755,0.0,1404.0,-702
9301,1884,1439,1.0,1661.5,445
9302,1334,1505,0.0,1419.5,-171
9303,1583,1468,0.5,1525.5,115
9304,1246,1601,0.0,1423.5,-355
9305,1222,1326,0.0,1274.0,-104
9306,1053,1070,0.0,1061.5,-17
9307,1137,1182,1.0,1159.5,-45
9308,1712,1442,0.0,1577.0,270
9309,1502,1503,1.0,1502.5,-1
9310,1446,1582,0.5,1514.0,-136
9311,1364,1479,1.0,1421.5,-115
9312,1568,1388,1.0,1478.0,180
9313,1407,1446,1.0,1426.5,-39
9314,2079,1322,1.0,1700.5,757
9315,1308,1456,1.0,1382.0,-148
9316,1062,1034,0.0,1048.0,28
9317,1671,1467,1.0,1569.0,204
9318,1173,1374,0.5,1273.5,-201
9319,1217,1397,0.0,1307.0,-180
9320,2474,2561,0.5,2517.5,-87
9321,2464,2482,0.5,2473.0,-18
9322,2394,2446,0.0,2420.0,-52
9323,2468,2263,1.0,2365.5,205
9324,2438,2555,0.0,2496.5,-117
9325,2533,2326,0.5,2429.5,207
9326,2355,2451,1.0,2403.0,-96
9327,2405,2320,0.5,2362.5,85
9328,2431,2423,0.5,2427.0,8
9329,2370,2423,0.5,2396.5,-53
9330,2361,2321,1.0,2341.0,40
9331,2260,2268,0.5,2264.0,-8
9332,2409,2431,1.0,2420.0,-22
9333,2261,2384,0.5,2322.5,-123
9334,2331,2135,1.0,2233.0,196
9335,2101,2205,0.5,2153.0,-104
9336,2559,2394,1.0,2476.5,165
9337,2374,2528,0.5,2451.0,-154
9338,2469,2328,0.5,2398.5,141
9339,1933,2462,0.0,2197.5,-529
9340,2422,2509,0.0,2465.5,-87
9341,2475,2377,0.5,2426.0,98
9342,2149,2482,0.5,2315.5,-333
9343,2469,2367,1.0,2418.0,102
9344,2391,2348,0.5,2369.5,43
9345,2261,2317,0.5,2289.0,-56
9346,2301,2339,1.0,2320.0,-38
9347,2241,2255,1.0,2248.0,-14
9348,2421,2557,0.5,2489.0,-136
9349,2500,2267,1.0,2383.5,233
9350,2294,2400,1.0,2347.0,-106
9351,2338,2168,0.5,2253.0,170
9352,2369,2480,0.5,2424.5,-111
9353,2414,2202,0.5,2308.0,212
9354,2265,2390,1.0,2327.5,-125
9355,2389,2124,1.0,2256.5,265
9356,2313,2347,0.5,2330.0,-34
9357,2323,2081,1.0,2202.0,242
9358,1931,2244,0.0,2087.5,-313
9359,2161,1911,1.0,2036.0,250
9360,2375,2404,0.5,2389.5,-29
9361,2329,2313,0.5,2321.0,16
9362,2288,2362,0.0,2325.0,-74
9363,2235,2258,0.5,2246.5,-23
9364,2299,2207,0.5,2253.0,92
9365,2144,2254,0.0,2199.0,-110
9366,2185,2134,0.5,2159.5,51
9367,2128,2148,0.0,2138.0,-20
9368,2295,2054,1.0,2174.5,241
9369,2005,2248,0.0,2126.5,-243
9370,2231,1869,1.0,2050.0,362
9371,1866,2276,0.0,2071.0,-410
9372,2350,2415,1.0,2382.5,-65
9373,2243,2249,0.5,2246.0,-6
9374,2219,2294,0.5,2256.5,-75
9375,2239,2186,1.0,2212.5,53
9376,2462,2446,0.5,2454.0,16
9377,2424,2278,0.5,2351.0,146
9378,1980,2407,0.0,2193.5,-427
9379,2305,1840,1.0,2072.5,465
9380,2255,2218,0.5,2236.5,37
9381,2123,2174,0.0,2148.5,-51
9382,2110,2081,1.0,2095.5,29
9383,2064,2037,1.0,2050.5,27
9384,2391,2367,1.0,2379.0,24
9385,2345,2039,1.0,2192.0,306
9386,2222,2339,1.0,2280.5,-117
9387,2260,2034,0.5,2147.0,226
9388,2283,2404,0.0,2343.5,-121
9389,2188,1986,1.0,2087.0,202
9390,1819,2167,0.5,1993.0,-348
9391,2114,1731,1.0,1922.5,383
9392,2447,2139,1.0,2293.0,308
9393,2098,2345,1.0,2221.5,-247
9394,2287,2075,0.0,2181.0,212
9395,1950,2108,0.5,2029.0,-158
9396,1647,2254,0.0,1950.5,-607
9397,2167,1676,1.0,1921.5,491
9398,1712,2114,0.0,1913.0,-402
9399,2009,1926,1.0,1967.5,83
9400,2248,2253,1.0,2250.5,-5
9401,2308,2191,1.0,2249.5,117
9402,2298,2161,1.0,2229.5,137
9403,2112,2188,0.0,2150.0,-76
9404,2513,2184,0.0,2348.5,329
9405,2136,2348,0.5,2242.0,-212
9406,2355,2059,1.0,2207.0,296
9407,1947,2274,0.0,2110.5,-327
9408,2259,2195,0.0,2227.0,64
9409,2230,2330,1.0,2280.0,-100
9410,2134,2175,0.0,2154.5,-41
9411,2118,2112,1.0,2115.0,6
9412,2159,2244,0.0,2201.5,-85
9413,2227,1954,0.5,2090.5,273
9414,2034,2152,0.0,2093.0,-118
9415,1805,1750,1.0,1777.5,55
9416,2050,2287,0.0,2168.5,-237
9417,2113,2030,1.0,2071.5,83
9418,1793,2102,1.0,1947.5,-309
9419,2080,1671,1.0,1875.5,409
9420,2267,2090,1.0,2178.5,177
9421,2038,2204,0.5,2121.0,-166
9422,2113,1685,1.0,1899.0,428
9423,1672,2146,0.0,1909.0,-474
9424,1929,2320,0.0,2124.5,-391
9425,2158,1809,1.0,1983.5,349
9426,1785,2113,0.0,1949.0,-328
9427,1907,1633,1.0,1770.0,274
9428,2157,2290,0.0,2223.5,-133
9429,2268,2136,0.5,2202.0,132
9430,2129,2198,1.0,2163.5,-69
9431,2060,2020,1.0,2040.0,40
9432,2152,2035,0.0,2093.5,117
9433,2037,2022,0.0,2029.5,15
9434,1974,2031,1.0,2002.5,-57
9435,1935,1909,0.5,1922.0,26
9436,2266,2029,0.0,2147.5,237
9437,1926,2156,0.5,2041.0,-230
9438,2051,1874,1.0,1962.5,177
9439,1760,2026,0.0,1893.0,-266
9440,1966,2053,0.0,2009.5,-87
9441,2013,1801,1.0,1907.0,212
9442,1725,1771,1.0,1748.0,-46
9443,1940,1353,1.0,1646.5,587
9444,2214,1727,1.0,1970.5,487
9445,1716,1984,0.5,1850.0,-268
9446,1799,1791,0.0,1795.0,8
9447,1655,1772,1.0,1713.5,-117
9448,2106,2056,1.0,2081.0,50
9449,2056,2026,0.5,2041.0,30
9450,1856,1862,0.5,1859.0,-6
9451,1901,1966,0.5,1933.5,-65
9452,1810,1667,0.0,1738.5,143
9453,1620,1748,0.0,1684.0,-128
9454,1815,1495,1.0,1655.0,320
9455,1378,1765,0.5,1571.5,-387
9456,1943,2393,0.0,2168.0,-450
9457,2260,1869,1.0,2064.5,391
9458,1925,2194,0.5,2059.5,-269
9459,2149,1907,1.0,2028.0,242
9460,2176,1942,1.0,2059.0,234
9461,1932,2113,0.5,2022.5,-181
9462,1898,1899,0.5,1898.5,-1
9463,1727,1600,0.5,1663.5,127
9464,1817,1888,1.0,1852.5,-71
9465,1996,1670,1.0,1833.0,326
9466,1623,1922,0.5,1772.5,-299
9467,2211,1953,1.0,2082.0,258
9468,1853,1981,1.0,1917.0,-128
9469,1945,1924,0.0,1934.5,21
9470,1813,1724,1.0,1768.5,89
9471,1909,2024,1.0,1966.5,-115
9472,1877,1774,0.5,1825.5,103
9473,1490,1770,0.0,1630.0,-280
9474,1572,1494,1.0,1533.0,78
9475,2345,2008,1.0,2176.5,337
9476,1870,1923,0.5,1896.5,-53
9477,1924,1924,0.5,1924.0,0
9478,1890,1488,1.0,1689.0,402
9479,2064,2300,0.0,2182.0,-236
9480,2188,2020,0.5,2104.0,168
9481,1751,2143,0.0,1947.0,-392
9482,1635,1687,1.0,1661.0,-52
9483,1945,2220,0.0,2082.5,-275
9484,2058,1713,1.0,1885.5,345
9485,1655,1894,0.5,1774.5,-239
9486,1809,1533,0.0,1671.0,276
9487,1893,1933,0.0,1913.0,-40
9488,1780,1797,1.0,1788.5,-17
9489,1408,1707,0.0,1557.5,-299
9490,1733,1689,0.0,1711.0,44
9491,2082,2137,0.0,2109.5,-55
9492,2044,1961,0.0,2002.5,83
9493,1806,2033,0.0,1919.5,-227
9494,2023,1763,0.5,1893.0,260
9495,2157,1649,1.0,1903.0,508
9496,1708,2143,0.0,1925.5,-435
9497,2101,1795,1.0,1948.0,306
9498,1797,2060,0.0,1928.5,-263
9499,2130,1831,1.0,1980.5,299
9500,1848,1946,0.0,1897.0,-98
9501,1921,1604,0.5,1762.5,317
9502,1705,1862,0.0,1783.5,-157
9503,1678,1821,1.0,1749.5,-143
9504,1668,1813,0.0,1740.5,-145
9505,1785,1540,1.0,1662.5,245
9506,1442,1764,0.0,1603.0,-322
9507,1962,1767,0.0,1864.5,195
9508,1607,1736,0.0,1671.5,-129
9509,1712,1509,1.0,1610.5,203
9510,1734,1727,1.0,1730.5,7
9511,1581,1779,0.0,1680.0,-198
9512,1719,1581,1.0,1650.0,138
9513,1415,1611,1.0,1513.0,-196
9514,1777,1512,0.0,1644.5,265
9515,2271,1745,1.0,2008.0,526
9516,1702,1812,0.5,1757.0,-110
9517,1724,1619,1.0,1671.5,105
9518,1419,1526,1.0,1472.5,-107
9519,1174,2159,0.0,1666.5,-985
9520,1704,1350,1.0,1527.0,354
9521,1267,1510,0.0,1388.5,-243
9522,1397,1306,0.5,1351.5,91
9523,2082,1673,1.0,1877.5,409
9524,1598,1683,0.5,1640.5,-85
9525,1274,1475,0.5,1374.5,-201
9526,1499,1274,1.0,1386.5,225
9527,1263,1693,0.0,1478.0,-430
9528,1701,1138,0.5,1419.5,563
9529,1643,1859,1.0,1751.0,-216
9530,2126,1483,1.0,1804.5,643
9531,1544,2079,0.0,1811.5,-535
9532,2110,1508,1.0,1809.0,602
9533,1408,2013,0.0,1710.5,-605
9534,1772,2044,1.0,1908.0,-272
9535,2010,1778,1.0,1894.0,232
9536,1702,1948,1.0,1825.0,-246
9537,1919,1713,0.5,1816.0,206
9538,1702,1577,1.0,1639.5,125
9539,1626,1822,0.5,1724.0,-196
9540,1755,1528,0.5,1641.5,227
9541,1577,1698,1.0,1637.5,-121
9542,1788,1884,1.0,1836.0,-96
9543,1505,1683,1.0,1594.0,-178
9544,1735,1583,1.0,1659.0,152
9545,1601,1414,0.5,1507.5,187
9546,1568,1881,0.5,1724.5,-313
9547,1871,1471,1.0,1671.0,400
9548,1446,1853,0.0,1649.5,-407
9549,1830,1407,1.0,1618.5,423
9550,1755,1666,0.5,1710.5,89
9551,1451,1595,1.0,1523.0,-144
9552,1318,1492,1.0,1405.0,-174
9553,1840,1432,1.0,1636.0,408
9554,1584,1414,0.5,1499.0,170
9555,1535,1608,1.0,1571.5,-73
9556,1704,1537,0.5,1620.5,167
9557,1503,1446,0.5,1474.5,57
9558,1284,1326,1.0,1305.0,-42
9559,1518,1502,1.0,1510.0,16
9560,1137,1222,1.0,1179.5,-85
9561,1546,1364,1.0,1455.0,182
9562,1467,1378,0.0,1422.5,89
9563,1585,1671,1.0,1628.0,-86
9564,1482,1575,0.0,1528.5,-93
9565,1725,1729,1.0,1727.0,-4
9566,1206,1502,0.0,1354.0,-296
9567,1556,1652,1.0,1604.0,-96
9568,1308,1306,0.0,1307.0,2
9569,1456,2079,1.0,1767.5,-623
9570,1752,1451,0.0,1601.5,301
9571,1545,1425,0.0,1485.0,120
9572,1739,1365,0.0,1552.0,374
9573,1346,1355,1.0,1350.5,-9
9574,1559,1476,1.0,1517.5,83
9575,1117,1070,1.0,1093.5,47
9576,1372,1452,0.0,1412.0,-80
9577,1712,1863,1.0,1787.5,-151
9578,1239,1362,0.5,1300.5,-123
9579,1388,1446,1.0,1417.0,-58
9580,1334,1468,0.5,1401.0,-134
9581,1062,1458,0.0,1260.0,-396
9582,1374,1173,0.0,1273.5,201
9583,2561,2431,0.5,2496.0,130
9584,2423,2446,0.5,2434.5,-23
9585,2468,2361,0.5,2414.5,107
9586,2268,2351,0.5,2309.5,-83
9587,2555,2559,0.5,2557.0,-4
9588,2535,2533,0.5,2534.0,2
9589,2451,2528,0.5,2489.5,-77
9590,2462,2403,0.5,2432.5,59
9591,2438,2409,0.5,2423.5,29
9592,2384,2358,0.5,2371.0,26
9593,2326,2331,0.5,2328.5,-5
9594,2289,2355,0.5,2322.0,-66
9595,2368,2423,0.0,2395.5,-55
9596,2370,2347,0.0,2358.5,23
9597,2244,2321,0.5,2282.5,-77
9598,2258,2161,0.5,2209.5,97
9599,2404,2474,0.0,2439.0,-70
9600,2482,2329,0.5,2405.5,153
9601,2362,2394,1.0,2378.0,-32
9602,2125,2235,0.5,2180.0,-110
9603,2509,2303,1.0,2406.0,206
9604,2295,2482,1.0,2388.5,-187
9605,2469,2248,1.0,2358.5,221
9606,2231,2404,1.0,2317.5,-173
9607,2404,2299,0.5,2351.5,105
9608,2254,2188,0.5,2221.0,66
9609,2167,2185,0.5,2176.0,-18
9610,2116,2114,0.5,2115.0,2
9611,2557,2391,0.0,2474.0,166
9612,2151,2500,0.0,2325.5,-349
9613,2400,2039,1.0,2219.5,361
9614,2222,2338,0.0,2280.0,-116
9615,2421,2317,0.5,2369.0,104
9616,2325,2321,1.0,2323.0,4
9617,2294,2301,1.0,2297.5,-7
9618,2255,2168,1.0,2211.5,87
9619,2394,2431,0.0,2412.5,-37
9620,2254,2374,0.5,2314.0,-120
9621,2328,2261,0.5,2294.5,67
9622,2135,1933,0.0,2034.0,202
9623,2350,2377,0.5,2363.5,-27
9624,2149,2249,1.0,2199.0,-100
9625,2219,2123,0.0,2171.0,96
9626,2367,2215,1.0,2291.0,152
9627,2254,2446,0.0,2350.0,-192
9628,2424,2167,1.0,2295.5,257
9629,2114,2407,0.0,2260.5,-293
9630,2347,2009,0.5,2178.0,338
9631,2513,2369,0.5,2441.0,144
9632,2202,2348,1.0,2275.0,-146
9633,2355,2265,0.5,2310.0,90
9634,2124,2274,0.0,2199.0,-150
9635,2480,2248,1.0,2364.0,232
9636,2227,2414,0.0,2320.5,-187
9637,2390,2298,1.0,2344.0,92
9638,2188,2389,0.5,2288.5,-201
9639,2415,2255,0.5,2335.0,160
9640,2174,2281,0.0,2227.5,-107
9641,2294,2110,0.0,2202.0,184
9642,2037,2239,0.0,2138.0,-202
9643,2139,2261,0.5,2200.0,-122
9644,2339,2098,1.0,2218.5,241
9645,2075,2241,1.0,2158.0,-166
9646,2170,1950,1.0,2060.0,220
9647,2195,2057,1.0,2126.0,138
9648,2106,2230,0.5,2168.0,-124
9649,2170,1856,1.0,2013.0,314
9650,1966,2118,0.5,2042.0,-152
9651,2244,2267,1.0,2255.5,-23
9652,2204,2227,1.0,2215.5,-23
9653,2152,2113,0.5,2132.5,39
9654,2146,1805,1.0,1975.5,341
9655,2287,2266,0.0,2276.5,21
9656,2124,2157,0.0,2140.5,-33
9657,2113,2156,0.5,2134.5,-43
9658,2026,2080,1.0,2053.0,-54
9659,2225,2375,0.5,2300.0,-150
9660,2313,2207,1.0,2260.0,106
9661,2144,2258,0.0,2201.0,-114
9662,2151,2134,0.5,2142.5,17
9663,2320,2313,1.0,2316.5,7
9664,2081,2158,0.5,2119.5,-77
9665,2102,1931,0.0,2016.5,171
9666,1911,2113,1.0,2012.0,-202
9667,2288,2152,1.0,2220.0,136
9668,2022,2290,0.0,2156.0,-268
9669,2268,1974,1.0,2121.0,294
9670,1909,2060,0.5,1984.5,-151
9671,2054,2268,0.5,2161.0,-214
9672,2218,2005,1.0,2111.5,213
9673,1943,2123,1.0,2033.0,-180
9674,2064,1866,0.5,1965.0,198
9675,2024,2462,1.0,2243.0,-438
9676,2278,1877,1.0,2077.5,401
9677,1770,2172,1.0,1971.0,-402
9678,1980,1594,1.0,1787.0,386
9679,2283,2447,0.0,2365.0,-164
9680,2287,2004,1.0,2145.5,283
9681,1819,2096,0.0,1957.5,-277
9682,2108,1731,1.0,1919.5,377
9683,2393,1888,1.0,2140.5,505
9684,1626,2260,0.0,1943.0,-634
9685,2194,1922,0.5,2058.0,272
9686,1718,2149,0.0,1933.5,-431
9687,2367,2220,1.0,2293.5,147
9688,1998,2345,0.0,2171.5,-347
9689,2339,1894,1.0,2116.5,445
9690,1809,2275,0.0,2042.0,-466
9691,2402,1647,1.0,2024.5,755
9692,1676,2253,0.0,1964.5,-577
9693,2308,1926,1.0,2117.0,382
9694,1979,2161,1.0,2070.0,-182
9695,1933,2184,0.0,2058.5,-251
9696,2181,1780,1.0,1980.5,401
9697,1707,2136,0.5,1921.5,-429
9698,1947,1733,1.0,1840.0,214
9699,1953,2300,0.0,2126.5,-347
9700,2188,1853,1.0,2020.5,335
9701,1924,2143,0.5,2033.5,-219
9702,1849,1813,0.0,1831.0,36
9703,1966,1739,1.0,1852.5,227
9704,1365,1801,0.0,1583.0,-436
9705,1725,1123,1.0,1424.0,602
9706,2214,1353,1.0,1783.5,861
9707,1263,1437,0.0,1350.0,-174
9708,1799,1984,0.0,1891.5,-185
9709,1810,1772,0.0,1791.0,38
9710,2113,2176,0.5,2144.5,-63
9711,1815,1748,1.0,1781.5,67
9712,1600,1898,0.5,1749.0,-298
9713,2013,1755,1.0,1884.0,258
9714,2030,2050,1.0,2040.0,-20
9715,1940,1771,0.5,1855.5,169
9716,1793,1727,1.0,1760.0,66
9717,2137,1788,0.5,1962.5,349
9718,2224,2330,1.0,2277.0,-106
9719,2023,2033,0.0,2028.0,-10
9720,2112,2134,0.5,2123.0,-22
9721,1667,1956,1.0,1811.5,-289
9722,2038,2090,0.0,2064.0,-52
9723,1495,1620,1.0,1557.5,-125
9724,1685,1840,1.0,1762.5,-155
9725,2035,1378,0.0,1706.5,657
9726,1923,2345,0.0,2134.0,-422
9727,1935,2037,0.5,1986.0,-102
9728,1488,1655,0.0,1571.5,-167
9729,2159,1710,1.0,1934.5,449
9730,2136,2157,1.0,2146.5,-21
9731,1510,1704,0.0,1607.0,-194
9732,2020,2129,1.0,2074.5,-109
9733,2056,1397,0.5,1726.5,659
9734,1960,2130,0.5,2045.0,-170
9735,1862,2056,0.5,1959.0,-194
9736,1862,1946,0.5,1904.0,-84
9737,2143,1901,1.0,2022.0,242
9738,1870,2068,0.5,1969.0,-198
9739,2101,2137,0.5,2119.0,-36
9740,1890,1924,1.0,1907.0,-34
9741,2271,2060,1.0,2165.5,211
9742,1785,1813,0.0,1799.0,-28
9743,1812,1872,0.0,1842.0,-60
9744,1655,1764,0.5,1709.5,-109
9745,2029,1724,1.0,1876.5,305
9746,1809,1833,1.0,1821.0,-24
9747,1874,1961,0.5,1917.5,-87
9748,1633,1785,0.5,1709.0,-152
9749,1960,1760,0.0,1860.0,200
9750,2159,2369,1.0,2264.0,-210
9751,1716,1727,0.0,1721.5,-11
9752,1750,1954,1.0,1852.0,-204
9753,1693,1791,0.0,1742.0,-98
9754,2079,2126,1.0,2102.5,-47
9755,1859,1701,0.5,1780.0,158
9756,2013,2110,1.0,2061.5,-97
9757,2082,1643,1.0,1862.5,439
9758,1774,1909,0.5,1841.5,-135
9759,1683,1720,0.0,1701.5,-37
9760,1460,1490,1.0,1475.0,-30
9761,1673,1274,0.0,1473.5,399
9762,2020,2064,1.0,2042.0,-44
9763,1475,1598,0.5,1536.5,-123
9764,1687,1751,1.0,1719.0,-64
9765,1945,1481,0.5,1713.0,464
9766,1797,1893,0.5,1845.0,-96
9767,1605,1655,0.5,1630.0,-50
9768,1689,1531,0.5,1610.0,158
9769,1943,1533,0.0,1738.0,410
9770,1736,1962,0.5,1849.0,-226
9771,1925,1869,1.0,1897.0,56
9772,1598,1712,0.0,1655.0,-114
9773,2082,1926,0.5,2004.0,156
9774,1683,1788,0.0,1735.5,-105
9775,1806,2052,1.0,1929.0,-246
9776,1414,1559,0.5,1486.5,-145
9777,1942,1763,1.0,1852.5,179
9778,1708,1817,0.0,1762.5,-109
9779,1790,1932,0.0,1861.0,-142
9780,1623,1670,0.5,1646.5,-47
9781,1326,1727,0.0,1526.5,-401
9782,1981,2211,1.0,2096.0,-230
9783,1222,1284,0.0,1253.0,-62
9784,1900,1945,1.0,1922.5,-45
9785,1637,1137,1.0,1387.0,500
9786,1871,1881,0.0,1876.0,-10
9787,1581,1581,1.0,1581.0,0
9788,1830,1853,1.0,1841.5,-23
9789,1666,1512,1.0,1589.0,154
9790,1607,1767,1.0,1687.0,-160
9791,1402,1755,0.0,1578.5,-353
9792,1734,1509,1.0,1621.5,225
9793,1779,1318,0.0,1548.5,461
9794,1719,1840,0.0,1779.5,-121
9795,1777,1719,1.0,1748.0,58
9796,1535,1608,0.5,1571.5,-73
9797,1745,1593,0.5,1669.0,152
9798,1778,1772,1.0,1775.0,6
9799,1619,1702,0.0,1660.5,-83
9800,1713,1702,1.0,1707.5,11
9801,1718,1419,0.5,1568.5,299
9802,1378,1546,0.0,1462.0,-168
9803,1528,1626,1.0,1577.0,-98
9804,1575,1585,0.5,1580.0,-10
9805,1831,1577,1.0,1704.0,254
9806,1350,1518,0.0,1434.0,-168
9807,1604,1848,1.0,1726.0,-244
9808,1306,1267,0.0,1286.5,39
9809,1739,1515,1.0,1627.0,224
9810,1476,1475,0.0,1475.5,1
9811,1755,1702,1.0,1728.5,53
9812,1105,1559,0.0,1332.0,-454
9813,1803,1698,0.0,1750.5,105
9814,1668,1821,0.0,1744.5,-153
9815,1652,1729,0.0,1690.5,-77
9816,1540,1660,1.0,1600.0,-120
9817,1726,1556,0.5,1641.0,170
9818,1456,2079,0.0,1767.5,-623
9819,1795,1708,1.0,1751.5,87
9820,1752,1797,1.0,1774.5,-45
9821,1070,1379,0.0,1224.5,-309
9822,1545,1117,0.5,1331.0,428
9823,1053,1425,1.0,1239.0,-372
9824,1452,2044,0.0,1748.0,-592
9825,2010,1948,0.0,1979.0,62
9826,1400,1568,1.0,1484.0,-168
9827,1451,1446,1.0,1448.5,5
9828,1322,1432,0.0,1377.0,-110
9829,1884,1863,0.0,1873.5,21
9830,1712,1357,1.0,1534.5,355
9831,1583,1582,0.0,1582.5,1
9832,1388,1601,1.0,1494.5,-213
9833,1502,1483,1.0,1492.5,19
9834,1544,1479,1.0,1511.5,65
9835,1518,1508,0.5,1513.0,10
9836,1365,1364,1.0,1364.5,1
9837,1414,1439,0.0,1426.5,-25
9838,1334,1584,1.0,1459.0,-250
9839,1537,1468,1.0,1502.5,69
9840,1241,1704,0.0,1472.5,-463
9841,1502,1482,1.0,1492.0,20
9842,1206,1412,1.0,1309.0,-206
9843,1467,1308,1.0,1387.5,159
9844,1458,1062,1.0,1260.0,396
9845,1173,1374,1.0,1273.5,-201
9846,2559,2561,0.0,2560.0,-2
9847,2464,2535,0.0,2499.5,-71
9848,2528,2446,0.5,2487.0,82
9849,2468,2462,0.5,2465.0,6
9850,2431,2555,0.0,2493.0,-124
9851,2533,2423,1.0,2478.0,110
9852,2361,2451,1.0,2406.0,-90
9853,2403,2268,1.0,2335.5,135
9854,2368,2438,0.0,2403.0,-70
9855,2358,2347,0.5,2352.5,11
9856,2323,2355,0.5,2339.0,-32
9857,2320,2244,0.0,2282.0,76
9858,2423,2299,0.5,2361.0,124
9859,2254,2370,0.0,2312.0,-116
9860,2321,2185,1.0,2253.0,136
9861,2116,2260,0.0,2188.0,-144
9862,2446,2404,1.0,2425.0,42
9863,2329,2424,1.0,2376.5,-95
9864,2407,2362,1.0,2384.5,45
9865,2192,2347,1.0,2269.5,-155
9866,2409,2509,0.0,2459.0,-100
9867,2475,2384,1.0,2429.5,91
9868,2331,2482,0.5,2406.5,-151
9869,2469,2205,0.5,2337.0,264
9870,2422,2500,0.5,2461.0,-78
9871,2400,2377,1.0,2388.5,23
9872,2149,2374,0.5,2261.5,-225
9873,2338,2123,1.0,2230.5,215
9874,2303,2391,0.5,2347.0,-88
9875,2317,2295,1.0,2306.0,22
9876,2231,2325,1.0,2278.0,-94
9877,2301,2276,1.0,2288.5,25
9878,2348,2474,0.5,2411.0,-126
9879,2482,2261,1.0,2371.5,221
9880,2339,2394,1.0,2366.5,-55
9881,2263,2241,1.0,2252.0,22
9882,2415,2480,0.0,2447.5,-65
9883,2414,2281,1.0,2347.5,133
9884,2243,2390,0.5,2316.5,-147
9885,2237,2239,0.0,2238.0,-2
9886,2431,2313,0.5,2372.0,118
9887,2081,2254,0.0,2167.5,-173
9888,2261,1931,1.0,2096.0,330
9889,1911,2101,0.5,2006.0,-190
9890,2369,2195,1.0,2282.0,174
9891,2230,2202,0.5,2216.0,28
9892,2265,2170,1.0,2217.5,95
9893,2175,2167,1.0,2171.0,8
9894,2375,2404,0.5,2389.5,-29
9895,2188,2313,0.5,2250.5,-125
9896,2288,2167,0.5,2227.5,121
9897,2114,2258,1.0,2186.0,-144
9898,2374,2513,0.0,2443.5,-139
9899,2348,2328,0.0,2338.0,20
9900,2157,2355,0.0,2256.0,-198
9901,2274,1933,0.0,2103.5,341
9902,2267,2288,1.0,2277.5,-21
9903,2290,2204,1.0,2247.0,86
9904,2172,2268,0.5,2220.0,-96
9905,2198,2146,1.0,2172.0,52
9906,2447,2266,1.0,2356.5,181
9907,2156,2345,0.0,2250.5,-189
9908,2287,2051,1.0,2169.0,236
9909,2026,2108,1.0,2067.0,-82
9910,2402,2421,1.0,2411.5,-19
9911,2267,2253,0.0,2260.0,14
9912,2308,2321,0.5,2314.5,-13
9913,2294,2112,1.0,2203.0,182
9914,2367,2054,1.0,2210.5,313
9915,2005,2345,0.0,2175.0,-340
9916,2275,1943,1.0,2109.0,332
9917,1866,2260,0.0,2063.0,-394
9918,2391,2139,1.0,2265.0,252
9919,2075,2151,1.0,2113.0,-76
9920,2222,1950,1.0,2086.0,272
9921,1909,2034,0.0,1971.5,-125
9922,2252,2254,0.0,2253.0,-2
9923,2167,2393,0.5,2280.0,-226
9924,2260,2009,0.5,2134.5,251
9925,2118,2194,0.0,2156.0,-76
9926,2184,2248,0.0,2216.0,-64
9927,2191,2181,0.5,2186.0,10
9928,2059,2298,0.0,2178.5,-239
9929,2188,1947,1.0,2067.5,241
9930,2300,2350,1.0,2325.0,-50
9931,2249,2188,1.0,2218.5,61
9932,2143,2219,1.0,2181.0,-76
9933,2186,1635,1.0,1910.5,551
9934,2255,2320,0.0,2287.5,-65
9935,2158,2174,0.5,2166.0,-16
9936,2110,2113,0.5,2111.5,-3
9937,1907,2063,1.0,1985.0,-156
9938,2330,2287,1.0,2308.5,43
9939,2113,2224,0.0,2168.5,-111
9940,2134,2102,0.5,2118.0,32
9941,2080,2112,0.5,2096.0,-32
9942,2057,2244,1.0,2150.5,-187
9943,2227,2106,1.0,2166.5,121
9944,2026,1968,0.5,1997.0,58
9945,1805,1966,1.0,1885.5,-161
9946,2462,2152,1.0,2307.0,310
9947,2022,2278,0.5,2150.0,-256
9948,2172,1974,1.0,2073.0,198
9949,1909,1980,0.0,1944.5,-71
9950,2030,2225,0.0,2127.5,-195
9951,2207,1727,1.0,1967.0,480
9952,1793,2144,1.0,1968.5,-351
9953,2134,1671,1.0,1902.5,463
9954,2268,1810,1.0,2039.0,458
9955,1748,2218,0.5,1983.0,-470
9956,2081,1815,1.0,1948.0,266
9957,1755,2064,0.0,1909.5,-309
9958,2136,1667,1.0,1901.5,469
9959,1620,2129,0.0,1874.5,-509
9960,2020,1495,1.0,1757.5,525
9961,1378,1946,0.0,1662.0,-568
9962,2035,2024,0.5,2029.5,11
9963,1877,2031,0.0,1954.0,-154
9964,1935,1770,0.0,1852.5,165
9965,1572,1710,1.0,1641.0,-138
9966,1831,1966,1.0,1898.5,-135
9967,1801,1848,1.0,1824.5,-47
9968,1604,1725,0.0,1664.5,-121
9969,1353,1705,0.0,1529.0,-352
9970,1718,2214,0.0,1966.0,-496
9971,1984,1577,0.0,1780.5,407
9972,1626,1799,1.0,1712.5,-173
9973,1772,1528,1.0,1650.0,244
9974,2369,2176,0.5,2272.5,193
9975,2113,2159,0.5,2136.0,-46
9976,1954,1898,0.5,1926.0,56
9977,1600,1750,0.5,1675.0,-150
9978,2126,2271,0.0,2198.5,-145
9979,1872,2079,0.0,1975.5,-207
9980,2013,1812,0.5,1912.5,201
9981,1724,2009,0.0,1866.5,-285
9982,2008,2056,0.5,2032.0,-48
9983,2056,1870,1.0,1963.0,186
9984,1924,1862,0.0,1893.0,62
9985,1854,1890,0.5,1872.0,-36
9986,2064,2157,0.5,2110.5,-93
9987,2143,2020,0.5,2081.5,123
9988,1751,2137,0.5,1944.0,-386
9989,2060,1687,0.0,1873.5,373
9990,1719,1961,0.0,1840.0,-242
9991,1926,1611,1.0,1768.5,315
9992,1777,1874,1.0,1825.5,-97
9993,1760,1593,1.0,1676.5,167
9994,1942,2283,0.5,2112.5,-341
9995,1986,1932,1.0,1959.0,54
9996,1899,1819,1.0,1859.0,80
9997,1731,1790,1.0,1760.5,-59
9998,1888,1953,1.0,1920.5,-65
9999,1853,1626,0.0,1739.5,227
10000,1922,1924,1.0,1923.0,-2
10001,1813,1718,1.0,1765.5,95
10002,1767,1676,1.0,1721.5,91
10003,1712,1607,1.0,1659.5,105
10004,1509,1926,0.0,1717.5,-417
10005,1979,1734,1.0,1856.5,245
10006,1772,1909,0.0,1840.5,-137
10007,1774,1778,0.0,1776.0,-4
10008,1702,1490,1.0,1596.0,212
10009,1494,1741,0.0,1617.5,-247
10010,2211,1833,1.0,2022.0,378
10011,1809,1981,0.5,1895.0,-172
10012,1945,1785,0.5,1865.0,160
10013,1633,1900,0.0,1766.5,-267
10014,2130,1943,0.5,2036.5,187
10015,1869,1960,0.0,1914.5,-91
10016,1921,1926,0.5,1923.5,-5
10017,1907,1862,1.0,1884.5,45
10018,1933,1637,1.0,1785.0,296
10019,1581,1780,0.0,1680.5,-199
10020,1707,1581,0.0,1644.0,126
10021,1415,1664,0.5,1539.5,-249
10022,2220,2082,0.0,2151.0,138
10023,2052,2058,1.0,2055.0,-6
10024,1998,1961,1.0,1979.5,37
10025,1806,1894,0.5,1850.0,-88
10026,2090,2159,0.0,2124.5,-69
10027,1704,2038,0.0,1871.0,-334
10028,1840,1510,1.0,1675.0,330
10029,1397,1685,0.0,1541.0,-288
10030,2345,1693,1.0,2019.0,652
10031,1701,1923,0.0,1812.0,-222
10032,1924,1859,0.5,1891.5,65
10033,1643,1655,0.0,1649.0,-12
10034,1678,1649,0.0,1663.5,29
10035,1726,1813,0.5,1769.5,-87
10036,1785,1708,1.0,1746.5,77
10037,1795,1764,0.0,1779.5,31
10038,2053,1752,0.5,1902.5,301
10039,1451,2013,0.0,1732.0,-562
10040,1940,1379,1.0,1659.5,561
10041,1545,1788,0.0,1666.5,-243
10042,1821,2044,0.0,1932.5,-223
10043,2033,1668,1.0,1850.5,365
10044,1660,2023,1.0,1841.5,-363
10045,1956,1540,1.0,1748.0,416
10046,1960,1945,0.5,1952.5,15
10047,1713,1727,0.0,1720.0,-14
10048,1716,1655,1.0,1685.5,61
10049,1605,1791,0.5,1698.0,-186
10050,1893,1739,1.0,1816.0,154
10051,1822,1797,0.5,1809.5,25
10052,1531,1755,0.0,1643.0,-224
10053,1698,1689,0.0,1693.5,9
10054,2044,1400,1.0,1722.0,644
10055,1595,2010,0.5,1802.5,-415
10056,1948,1451,1.0,1699.5,497
10057,1432,1334,1.0,1383.0,98
10058,1962,1673,1.0,1817.5,289
10059,1598,1736,0.0,1667.0,-138
10060,1712,1475,0.0,1593.5,237
10061,1499,1727,1.0,1613.0,-228
10062,1708,2082,0.0,1895.0,-374
10063,1720,1670,0.0,1695.0,50
10064,1623,1683,0.5,1653.0,-60
10065,1863,1788,1.0,1825.5,75
10066,1683,1712,0.0,1697.5,-29
10067,1582,1735,0.0,1658.5,-153
10068,1414,1388,1.0,1401.0,26
10069,1902,1840,0.0,1871.0,62
10070,1608,1881,1.0,1744.5,-273
10071,1871,1535,0.0,1703.0,336
10072,1446,1853,0.0,1649.5,-407
10073,1483,1666,0.0,1574.5,-183
10074,1755,1544,0.0,1649.5,211
10075,1508,1402,0.0,1455.0,106
10076,1318,1365,1.0,1341.5,-47
10077,1326,1745,0.5,1535.5,-419
10078,1702,1284,1.0,1493.0,418
10079,1182,1573,0.0,1377.5,-391
10080,1419,1137,1.0,1278.0,282
10081,1739,1546,1.0,1642.5,193
10082,1378,1365,0.5,1371.5,13
10083,1123,1585,0.0,1354.0,-462
10084,1518,1803,0.0,1660.5,-285
10085,1729,1174,1.0,1451.5,555
10086,1267,1725,0.0,1496.0,-458
10087,1652,1306,1.0,1479.0,346
10088,1437,1308,0.5,1372.5,129
10089,2079,1138,1.0,1608.5,941
10090,1475,1346,0.0,1410.5,129
10091,1559,1476,1.0,1517.5,83
10092,1482,1584,0.0,1533.0,-102
10093,1537,1502,1.0,1519.5,35
10094,1412,1704,0.5,1558.0,-292
10095,1411,1306,1.0,1358.5,105
10096,1458,1062,0.0,1260.0,396
10097,1173,1374,0.0,1273.5,-201
10098,1070,1334,1.0,1202.0,-264
10099,1468,1117,1.0,1292.5,351
10100,1053,1241,1.0,1147.0,-188
10101,1479,1503,1.0,1491.0,-24
10102,1364,1518,1.0,1441.0,-154
10103,1505,1884,1.0,1694.5,-379
10104,1601,1357,1.0,1479.0,244
10105,1568,1452,1.0,1510.0,116
10106,1446,1471,1.0,1458.5,-25
10107,1355,1407,1.0,1381.0,-52
10108,1239,1362,1.0,1300.5,-123
10109,1671,1467,1.0,1569.0,204
10110,2130,2154,1.0,2142.0,-24
10111,2373,2238,0.5,2305.5,135
10112,2166,2231,0.0,2198.5,-65
10113,1928,2132,0.0,2030.0,-204
10114,2265,2155,1.0,2210.0,110
10115,2055,2132,0.5,2093.5,-77
10116,2060,2217,1.0,2138.5,-157
10117,2127,1991,1.0,2059.0,136
10118,2390,1992,1.0,2191.0,398
10119,1877,2416,0.0,2146.5,-539
10120,2333,1958,1.0,2145.5,375
10121,1931,2280,0.0,2105.5,-349
10122,2383,2302,0.5,2342.5,81
10123,2117,2038,0.5,2077.5,79
10124,2176,1884,1.0,2030.0,292
10125,1972,2015,1.0,1993.5,-43
10126,1925,2015,0.0,1970.0,-90
10127,1919,1948,1.0,1933.5,-29
10128,2256,2038,0.5,2147.0,218
10129,2109,2260,0.5,2184.5,-151
10130,1914,2159,0.0,2036.5,-245
10131,2073,1884,0.0,1978.5,189
10132,1795,1717,0.0,1756.0,78
10133,2273,2232,1.0,2252.5,41
10134,1933,1935,0.0,1934.0,-2
10135,1596,2124,0.0,1860.0,-528
10136,2018,1647,0.5,1832.5,371
10137,1811,1986,0.0,1898.5,-175
10138,1784,1826,0.0,1805.0,-42
10139,1981,1976,1.0,1978.5,5
10140,1698,1866,0.5,1782.0,-168
10141,1724,1633,1.0,1678.5,91
10142,1511,1650,0.0,1580.5,-139
10143,1667,1803,0.0,1735.0,-136
10144,1786,1709,0.5,1747.5,77
10145,1982,1910,1.0,1946.0,72
10146,1905,1589,0.5,1747.0,316
10147,2238,1885,1.0,2061.5,353
10148,1972,2166,1.0,2069.0,-194
10149,2170,2015,0.5,2092.5,155
10150,1919,2134,1.0,2026.5,-215
10151,2265,2390,0.5,2327.5,-125
10152,2333,2132,1.0,2232.5,201
10153,2110,2337,0.5,2223.5,-227
10154,2280,2060,1.0,2170.0,220
10155,2302,2373,0.5,2337.5,-71
10156,2231,2117,0.0,2174.0,114
10157,2128,1928,1.0,2028.0,200
10158,2228,2137,0.0,2182.5,91
10159,2055,2155,0.5,2105.0,-100
10160,2260,2256,0.5,2258.0,4
10161,2127,2217,1.0,2172.0,-90
10162,1914,2191,0.0,2052.5,-277
10163,1935,2273,1.0,2104.0,-338
10164,1871,1884,0.0,1877.5,-13
10165,1877,1717,0.0,1797.0,160
10166,2038,2383,1.0,2210.5,-345
10167,1958,1756,0.0,1857.0,202
10168,2124,1931,0.5,2027.5,193
10169,1803,1855,0.0,1829.0,-52
10170,1986,2018,1.0,2002.0,-32
10171,1709,1786,1.0,1747.5,-77
10172,2232,1784,0.0,2008.0,448
10173,1925,2176,1.0,2050.5,-251
10174,1948,1944,0.0,1946.0,4
10175,2159,1821,0.5,1990.0,338
10176,1866,1981,0.0,1923.5,-115
10177,1717,1650,0.5,1683.5,67
10178,1905,1795,0.0,1850.0,110
10179,2109,2038,1.0,2073.5,71
10180,1976,1803,1.0,1889.5,173
10181,1811,1647,1.0,1729.0,164
10182,1633,1698,0.0,1665.5,-65
10183,1807,1826,1.0,1816.5,-19
10184,1910,1511,1.0,1710.5,399
10185,1547,1871,0.0,1709.0,-324
10186,1884,1518,0.0,1701.0,366
10187,2416,2390,0.5,2403.0,26
10188,2015,1972,0.5,1993.5,43
10189,2337,2333,1.0,2335.0,4
10190,2238,1919,0.5,2078.5,319
10191,2117,2302,1.0,2209.5,-185
10192,2132,2166,1.0,2149.0,-34
10193,2137,2128,1.0,2132.5,9
10194,2373,2170,0.5,2271.5,203
10195,2110,2265,0.5,2187.5,-155
10196,1991,2060,1.0,2025.5,-69
10197,2155,2124,0.5,2139.5,31
10198,2018,2055,1.0,2036.5,-37
10199,2217,1986,0.5,2101.5,231
10200,1784,2127,0.0,1955.5,-343
10201,2273,2383,0.0,2328.0,-110
10202,2038,1935,0.5,1986.5,103
10203,2228,1914,1.0,2071.0,314
10204,1884,2256,0.5,2070.0,-372
10205,2260,1871,1.0,2065.5,389
10206,1717,2165,0.0,1941.0,-448
10207,2038,2073,0.5,2055.5,-35
10208,2176,1795,1.0,1985.5,381
10209,1877,1992,1.0,1934.5,-115
10210,1925,2015,1.0,1970.0,-90
10211,1958,1756,1.0,1857.0,202
10212,1647,1944,0.0,1795.5,-297
10213,1826,1811,0.0,1818.5,15
10214,1821,1807,0.5,1814.0,14
10215,1981,1910,1.0,1945.5,71
10216,1871,1866,0.5,1868.5,5
10217,1724,1547,1.0,1635.5,177
10218,1518,1717,0.0,1617.5,-199
10219,1910,1855,1.0,1882.5,55
10220,1803,1905,0.5,1854.0,-102
10221,1803,1786,1.0,1794.5,17
10222,1709,1589,1.0,1649.0,120
10223,1982,1667,0.0,1824.5,315
10224,2390,2302,0.5,2346.0,88
10225,2117,2416,0.5,2266.5,-299
10226,2337,2128,0.5,2232.5,209
10227,2137,2280,0.5,2208.5,-143
10228,2155,2238,1.0,2196.5,-83
10229,2132,2055,0.5,2093.5,77
10230,2217,2170,0.0,2193.5,47
10231,2134,2127,1.0,2130.5,7
10232,2383,2265,1.0,2324.0,118
10233,2132,2038,0.5,2085.0,94
10234,1972,2038,0.5,2005.0,-66
10235,2109,2015,0.0,2062.0,94
10236,2124,2373,0.0,2248.5,-249
10237,2231,2018,1.0,2124.5,213
10238,1986,1928,0.5,1957.0,58
10239,2232,1784,0.0,2008.0,448
10240,2256,2228,1.0,2242.0,28
10241,2165,2260,1.0,2212.5,-95
10242,2176,1821,1.0,1998.5,355
10243,1935,2273,0.5,2104.0,-338
10244,1925,2015,0.0,1970.0,-90
10245,1992,1948,0.5,1970.0,44
10246,1866,1981,0.5,1923.5,-115
10247,1958,1877,0.5,1917.5,81
10248,1717,1650,0.0,1683.5,67
10249,2073,2159,1.0,2116.0,-86
10250,1914,1982,1.0,1948.0,-68
10251,1871,1884,1.0,1877.5,-13
10252,1910,1717,1.0,1813.5,193
10253,1803,1976,1.0,1889.5,-173
10254,1511,1633,0.0,1572.0,-122
10255,1910,1589,0.5,1749.5,321
10256,1811,1647,1.0,1729.0,164
10257,1547,1871,0.0,1709.0,-324
10258,1807,1826,1.0,1816.5,-19
10259,2373,1518,1.0,1945.5,855
10260,2333,2390,1.0,2361.5,-57
10261,1928,2231,0.0,2079.5,-303
10262,2280,2337,1.0,2308.5,-57
10263,2265,1884,1.0,2074.5,381
10264,1972,2132,0.5,2052.0,-160
10265,2110,2015,0.5,2062.5,95
10266,1919,2060,0.5,1989.5,-141
10267,2238,2228,1.0,2233.0,10
10268,2256,2166,0.5,2211.0,90
10269,2132,2260,0.0,2196.0,-128
10270,2165,2170,0.0,2167.5,-5
10271,2302,2155,0.5,2228.5,147
10272,2055,2117,0.0,2086.0,-62
10273,2128,2217,1.0,2172.5,-89
10274,2127,2137,0.0,2132.0,-10
10275,2383,1914,1.0,2148.5,469
10276,1884,2038,0.0,1961.0,-154
10277,1717,1871,1.0,1794.0,-154
10278,2124,2176,0.0,2150.0,-52
10279,2015,2018,0.5,2016.5,-3
10280,1986,1925,1.0,1955.5,61
10281,1948,1784,0.5,1866.0,164
10282,2159,1992,0.5,2075.5,167
10283,1877,2073,0.0,1975.0,-196
10284,1958,1756,0.5,1857.0,202
10285,2273,1795,1.0,2034.0,478
10286,2038,1935,0.5,1986.5,103
10287,1933,2109,0.5,2021.0,-176
10288,1647,1910,0.0,1778.5,-263
10289,1905,1811,0.5,1858.0,94
10290,1826,1803,0.5,1814.5,23
10291,1589,1807,0.0,1698.0,-218
10292,2232,1910,1.0,2071.0,322
10293,1871,1547,1.0,1709.0,324
10294,1518,1821,0.5,1669.5,-303
10295,1667,1698,1.0,1682.5,-31
10296,1633,1511,1.0,1572.0,122
10297,1855,1982,1.0,1918.5,-127
10298,1786,1803,0.5,1794.5,-17
10299,2265,2266,1.0,2265.5,-1
10300,2337,2419,0.5,2378.0,-82
10301,2448,2305,0.5,2376.5,143
10302,2379,2387,0.0,2383.0,-8
10303,2151,2337,0.0,2244.0,-186
10304,2201,2303,0.5,2252.0,-102
10305,2313,2209,1.0,2261.0,104
10306,2129,2107,0.0,2118.0,22
10307,2242,2198,0.0,2220.0,44
10308,2147,2216,1.0,2181.5,-69
10309,2479,2481,0.5,2480.0,-2
10310,2537,2397,1.0,2467.0,140
10311,2440,2330,0.0,2385.0,110
10312,2360,2414,0.0,2387.0,-54
10313,2371,2420,0.0,2395.5,-49
10314,2395,2455,0.5,2425.0,-60
10315,2347,2234,1.0,2290.5,113
10316,2210,2370,0.5,2290.0,-160
10317,2262,2163,0.5,2212.5,99
10318,2315,2365,0.5,2340.0,-50
10319,2630,2457,0.5,2543.5,173
10320,2461,2619,0.0,2540.0,-158
10321,2590,2363,1.0,2476.5,227
10322,2214,2576,0.0,2395.0,-362
10323,2382,2244,1.0,2313.0,138
10324,2204,2424,1.0,2314.0,-220
10325,2286,2223,1.0,2254.5,63
10326,2170,2352,0.5,2261.0,-182
10327,2392,2257,0.0,2324.5,135
10328,2162,2311,0.0,2236.5,-149
10329,2637,2435,0.5,2536.0,202
10330,2523,2432,1.0,2477.5,91
10331,2423,2345,1.0,2384.0,78
10332,2340,2416,0.5,2378.0,-76
10333,2311,2220,1.0,2265.5,91
10334,2492,2368,1.0,2430.0,124
10335,2295,2266,1.0,2280.5,29
10336,2217,2330,0.0,2273.5,-113
10337,2139,2185,0.5,2162.0,-46
10338,2253,2216,0.5,2234.5,37
10339,2650,2590,0.5,2620.0,60
10340,2523,2546,0.0,2534.5,-23
10341,2556,2497,0.5,2526.5,59
10342,2493,2536,1.0,2514.5,-43
10343,2455,2379,1.0,2417.0,76
10344,2425,2340,0.5,2382.5,85
10345,2329,2349,1.0,2339.0,-20
10346,2378,2187,1.0,2282.5,191
10347,2266,2324,1.0,2295.0,-58
10348,2380,2256,0.0,2318.0,124
10349,2445,2214,1.0,2329.5,231
10350,2484,2628,0.5,2556.0,-144
10351,2524,2496,0.5,2510.0,28
10352,2618,2351,1.0,2484.5,267
10353,2398,2381,0.0,2389.5,17
10354,2485,2406,0.5,2445.5,79
10355,2577,2388,0.0,2482.5,189
10356,2315,2465,0.5,2390.0,-150
10357,2371,2319,1.0,2345.0,52
10358,2374,2363,0.0,2368.5,11
10359,2401,2391,1.0,2396.0,10
10360,2352,2195,1.0,2273.5,157
10361,2393,2622,0.0,2507.5,-229
10362,2297,2362,1.0,2329.5,-65
10363,2368,2346,0.5,2357.0,22
10364,2447,2374,1.0,2410.5,73
10365,2213,2386,0.0,2299.5,-173
10366,2480,1986,1.0,2233.0,494
10367,2259,2405,1.0,2332.0,-146
10368,2454,1984,1.0,2219.0,470
10369,1873,2409,0.0,2141.0,-536
10370,2628,2674,0.5,2651.0,-46
10371,2467,2398,0.5,2432.5,69
10372,2363,2578,0.5,2470.5,-215
10373,2511,2252,1.0,2381.5,259
10374,2351,2444,0.5,2397.5,-93
10375,2577,2435,0.5,2506.0,142
10376,2266,2136,1.0,2201.0,130
10377,2205,2202,0.0,2203.5,3
10378,2347,2102,1.0,2224.5,245
10379,2592,2485,0.5,2538.5,107
10380,2381,2534,0.0,2457.5,-153
10381,2359,2391,0.0,2375.0,-32
10382,2484,2551,1.0,2517.5,-67
10383,2331,2374,1.0,2352.5,-43
10384,2388,2234,1.0,2311.0,154
10385,2287,2311,0.0,2299.0,-24
10386,2315,2506,0.5,2410.5,-191
10387,2120,2182,0.5,2151.0,-62
10388,2319,2230,0.5,2274.5,89
10389,1984,1875,1.0,1929.5,109
10390,2766,2709,0.5,2737.5,57
10391,2770,2757,0.5,2763.5,13
10392,2830,2785,0.5,2807.5,45
10393,2787,2758,0.0,2772.5,29
10394,2758,2830,0.5,2794.0,-72
10395,2785,2766,0.5,2775.5,19
10396,2787,2770,0.5,2778.5,17
10397,2709,2757,0.5,2733.0,-48
10398,2785,2758,1.0,2771.5,27
10399,2757,2766,0.5,2761.5,-9
10400,2830,2787,0.5,2808.5,43
10401,2770,2709,0.5,2739.5,61
10402,2709,2830,1.0,2769.5,-121
10403,2766,2770,0.5,2768.0,-4
10404,2758,2757,0.5,2757.5,1
10405,2787,2785,1.0,2786.0,2
10406,2757,2787,0.5,2772.0,-30
10407,2785,2709,0.5,2747.0,76
10408,2830,2766,0.0,2798.0,64
10409,2770,2758,0.5,2764.0,12
10410,2340,2056,1.0,2198.0,284
10411,2764,2726,0.5,2745.0,38
10412,2767,2844,0.0,2805.5,-77
10413,2701,2797,0.5,2749.0,-96
10414,2748,2722,1.0,2735.0,26
10415,2764,2732,0.5,2748.0,32
10416,2751,2706,0.5,2728.5,45
10417,2722,2764,0.0,2743.0,-42
10418,2844,2748,0.5,2796.0,96
10419,2797,2767,0.5,2782.0,30
10420,2751,2701,0.5,2726.0,50
10421,2706,2726,0.5,2716.0,-20
10422,2732,2764,1.0,2748.0,-32
10423,2748,2797,1.0,2772.5,-49
10424,2726,2732,0.5,2729.0,-6
10425,2764,2844,0.5,2804.0,-80
10426,2701,2706,0.5,2703.5,-5
10427,2764,2722,0.5,2743.0,42
10428,2767,2751,1.0,2759.0,16
10429,2844,2764,1.0,2804.0,80
10430,2797,2764,0.5,2780.5,33
10431,2751,2748,0.5,2749.5,3
10432,2706,2732,0.5,2719.0,-26
10433,2701,2767,0.5,2734.0,-66
10434,2722,2726,0.5,2724.0,-4
10435,2766,2733,0.5,2749.5,33
10436,2648,2255,1.0,2451.5,393
10437,2249,2644,0.0,2446.5,-395
10438,2639,2243,1.0,2441.0,396
10439,2232,2632,0.0,2432.0,-400
10440,2626,2229,1.0,2427.5,397
10441,2226,2619,0.0,2422.5,-393
10442,2617,2192,1.0,2404.5,425
10443,2169,2610,0.0,2389.5,-441
10444,2595,2165,0.5,2380.0,430
10445,2136,2586,0.0,2361.0,-450
10446,2572,2126,1.0,2349.0,446
10447,2119,2564,0.0,2341.5,-445
10448,2561,2117,1.0,2339.0,444
10449,2114,2539,0.0,2326.5,-425
10450,2535,2108,1.0,2321.5,427
10451,2102,2516,0.0,2309.0,-414
10452,2504,2097,1.0,2300.5,407
10453,2085,2502,0.0,2293.5,-417
10454,2499,2081,1.0,2290.0,418
10455,2078,2487,1.0,2282.5,-409
10456,2443,2648,0.5,2545.5,-205
10457,2644,2484,0.5,2564.0,160
10458,2434,2639,0.5,2536.5,-205
10459,2632,2444,1.0,2538.0,188
10460,2431,2626,0.0,2528.5,-195
10461,2619,2432,0.5,2525.5,187
10462,2421,2617,1.0,2519.0,-196
10463,2610,2375,1.0,2492.5,235
10464,2586,2332,1.0,2459.0,254
10465,2360,2572,0.0,2466.0,-212
10466,2564,2322,0.5,2443.0,242
10467,2308,2561,0.0,2434.5,-253
10468,2539,2306,1.0,2422.5,233
10469,2277,2535,0.5,2406.0,-258
10470,2516,2258,1.0,2387.0,258
10471,2074,2504,0.0,2289.0,-430
10472,2502,2078,1.0,2290.0,424
10473,1874,2499,0.0,2186.5,-625
10474,1944,2595,0.0,2269.5,-651
10475,2165,2434,0.0,2299.5,-269
10476,2539,2632,0.5,2585.5,-93
10477,2626,2516,0.5,2571.0,110
10478,2504,2610,0.5,2557.0,-106
10479,2499,2586,0.5,2542.5,-87
10480,2572,2502,1.0,2537.0,70
10481,2561,2421,1.0,2491.0,140
10482,2648,2434,0.5,2541.0,214
10483,2432,2644,0.5,2538.0,-212
10484,2639,2443,1.0,2541.0,196
10485,2322,2619,0.0,2470.5,-297
10486,2595,2434,1.0,2514.5,161
10487,2426,2564,0.5,2495.0,-138
10488,2535,2040,1.0,2287.5,495
10489,2484,2277,0.0,2380.5,207
10490,2617,2229,1.0,2423.0,388
10491,2444,2192,1.0,2318.0,252
10492,2102,2431,0.0,2266.5,-329
10493,2375,2097,1.0,2236.0,278
10494,2078,2360,0.5,2219.0,-282
10495,2332,2074,0.0,2203.0,258
10496,2561,2572,0.5,2566.5,-11
10497,2586,2639,0.5,2612.5,-53
10498,2632,2535,0.5,2583.5,97
10499,2277,2626,0.0,2451.5,-349
10500,2619,2539,0.0,2579.0,80
10501,2610,2499,1.0,2554.5,111
10502,2516,2595,1.0,2555.5,-79
10503,2644,2504,0.5,2574.0,140
10504,2421,2648,0.5,2534.5,-227
10505,2328,2617,0.5,2472.5,-289
10506,2564,2375,0.0,2469.5,189
10507,2502,2426,1.0,2464.0,76
10508,2288,2444,1.0,2366.0,-156
10509,2434,2306,1.0,2370.0,128
10510,2074,2432,0.0,2253.0,-358
10511,2431,2258,1.0,2344.5,173
10512,2443,2232,0.0,2337.5,211
10513,2040,2484,0.0,2262.0,-444
10514,2434,2061,1.0,2247.5,373
10515,2360,2051,1.0,2205.5,309
10516,2626,2561,1.0,2593.5,65
10517,2539,2610,0.0,2574.5,-71
10518,2572,2516,0.5,2544.0,56
10519,2639,2434,0.5,2536.5,205
10520,2432,2632,1.0,2532.0,-200
10521,2375,2586,0.5,2480.5,-211
10522,2535,2431,1.0,2483.0,104
10523,2504,2288,0.5,2396.0,216
10524,2232,2502,0.0,2367.0,-270
10525,2648,2360,0.5,2504.0,288
10526,2421,2644,0.5,2532.5,-223
10527,2328,2619,0.5,2473.5,-291
10528,2617,2308,1.0,2462.5,309
10529,2595,2277,1.0,2436.0,318
10530,2499,2255,1.0,2377.0,244
10531,2484,2243,0.5,2363.5,241
10532,2322,2434,0.5,2378.0,-112
10533,2226,2564,0.0,2395.0,-338
10534,2444,2229,1.0,2336.5,215
10535,2426,2192,1.0,2309.0,234
10536,2610,2626,1.0,2618.0,-16
10537,2502,2535,0.5,2518.5,-33
10538,2516,2432,1.0,2474.0,84
10539,2639,2572,0.5,2605.5,67
10540,2499,2617,0.5,2558.0,-118
10541,2434,2595,0.5,2514.5,-161
10542,2586,2504,0.0,2545.0,82
10543,2561,2375,1.0,2468.0,186
10544,2288,2539,0.0,2413.5,-251
10545,2332,2648,0.0,2490.0,-316
10546,2644,2328,1.0,2486.0,316
10547,2632,2421,1.0,2526.5,211
10548,2619,2306,0.5,2462.5,313
10549,2564,2258,1.0,2411.0,306
10550,2360,2484,0.0,2422.0,-124
10551,2322,2444,0.0,2383.0,-122
10552,2434,2249,1.0,2341.5,185
10553,2431,2232,0.5,2331.5,199
10554,2243,2426,0.5,2334.5,-183
10555,2443,2255,1.0,2349.0,188
10556,2516,2610,0.5,2563.0,-94
10557,2626,2502,0.5,2564.0,124
10558,2572,2539,0.5,2555.5,33
10559,2535,2561,0.5,2548.0,-26
10560,2504,2632,0.5,2568.0,-128
10561,2648,2434,0.5,2541.0,214
10562,2444,2644,0.0,2544.0,-200
10563,2484,2639,0.0,2561.5,-155
10564,2617,2434,0.5,2525.5,183
10565,2595,2499,0.5,2547.0,96
10566,2432,2564,0.5,2498.0,-132
10567,2308,2619,0.5,2463.5,-311
10568,2232,2586,0.0,2409.0,-354
10569,2306,2443,0.5,2374.5,-137
10570,2288,2431,0.0,2359.5,-143
10571,2426,2277,1.0,2351.5,149
10572,2375,2243,1.0,2309.0,132
10573,2421,2229,1.0,2325.0,192
10574,2226,2360,0.5,2293.0,-134
10575,2192,2332,0.0,2262.0,-140
10576,2610,2572,0.5,2591.0,38
10577,2644,2516,1.0,2580.0,128
10578,2539,2639,1.0,2589.0,-100
10579,2504,2626,0.5,2565.0,-122
10580,2502,2561,0.5,2531.5,-59
10581,2648,2535,0.5,2591.5,113
10582,2632,2426,1.0,2529.0,206
10583,2434,2617,0.0,2525.5,-183
10584,2431,2595,0.0,2513.0,-164
10585,2586,2432,1.0,2509.0,154
10586,2564,2499,0.5,2531.5,65
10587,2434,2375,0.0,2404.5,59
10588,2619,2332,1.0,2475.5,287
10589,2484,2328,0.5,2406.0,156
10590,2444,2308,1.0,2376.0,136
10591,2443,2322,0.5,2382.5,121
10592,2306,2421,0.0,2363.5,-115
10593,2360,2169,1.0,2264.5,191
10594,2165,2288,0.0,2226.5,-123
10595,2277,2232,1.0,2254.5,45
10596,2644,2610,0.5,2627.0,34
10597,2626,2539,0.5,2582.5,87
10598,2561,2632,0.5,2596.5,-71
10599,2617,2535,1.0,2576.0,82
10600,2595,2502,0.0,2548.5,93
10601,2516,2586,0.5,2551.0,-70
10602,2572,2504,0.5,2538.0,68
10603,2375,2619,0.0,2497.0,-244
10604,2499,2648,0.5,2573.5,-149
10605,2639,2444,1.0,2541.5,195
10606,2421,2564,0.5,2492.5,-143
10607,2322,2484,0.5,2403.0,-162
10608,2328,2443,1.0,2385.5,-115
10609,2288,2434,0.0,2361.0,-146
10610,2277,2434,1.0,2355.5,-157
10611,2432,2243,0.5,2337.5,189
10612,2249,2431,0.0,2340.0,-182
10613,2426,2360,1.0,2393.0,66
10614,2332,2081,1.0,2206.5,251
10615,2308,2000,0.5,2154.0,308
10616,2610,2617,0.5,2613.5,-7
10617,2539,2644,0.5,2591.5,-105
10618,2502,2639,0.0,2570.5,-137
10619,2632,2516,1.0,2574.0,116
10620,2572,2626,0.5,2599.0,-54
10621,2619,2504,0.5,2561.5,115
10622,2586,2561,0.5,2573.5,25
10623,2431,2648,0.0,2539.5,-217
10624,2426,2595,0.0,2510.5,-169
10625,2564,2328,0.0,2446.0,236
10626,2535,2421,1.0,2478.0,114
10627,2499,2375,1.0,2437.0,124
10628,2434,2277,1.0,2355.5,157
10629,2279,2484,0.5,2381.5,-205
10630,2444,2258,0.5,2351.0,186
10631,2255,2432,0.0,2343.5,-177
10632,2243,2332,0.5,2287.5,-89
10633,2229,2322,1.0,2275.5,-93
10634,2443,2249,1.0,2346.0,194
10635,2434,2232,0.0,2333.0,202
10636,2094,2152,0.5,2123.0,-58
10637,2734,2667,0.5,2700.5,67
10638,2715,2727,1.0,2721.0,-12
10639,2757,2673,1.0,2715.0,84
10640,2784,2862,0.5,2823.0,-78
10641,2732,2820,0.0,2776.0,-88
10642,2666,2797,0.5,2731.5,-131
10643,2762,2744,0.5,2753.0,18
10644,2667,2744,0.5,2705.5,-77
10645,2797,2784,0.5,2790.5,13
10646,2820,2666,1.0,2743.0,154
10647,2862,2762,0.5,2812.0,100
10648,2727,2757,0.5,2742.0,-30
10649,2734,2715,0.5,2724.5,19
10650,2673,2732,0.0,2702.5,-59
10651,2732,2727,1.0,2729.5,5
10652,2715,2667,1.0,2691.0,48
10653,2784,2820,0.5,2802.0,-36
10654,2744,2862,1.0,2803.0,-118
10655,2757,2734,0.5,2745.5,23
10656,2762,2797,1.0,2779.5,-35
10657,2666,2673,0.5,2669.5,-7
10658,2652,2675,0.5,2663.5,-23
10659,2291,2352,0.5,2321.5,-61
10660,2729,2613,0.5,2671.0,116
10661,2593,2517,0.5,2555.0,76
10662,2615,2511,1.0,2563.0,104
10663,2563,2538,0.5,2550.5,25
10664,2603,2608,0.5,2605.5,-5
10665,2352,2729,0.0,2540.5,-377
10666,2511,2563,0.0,2537.0,-52
10667,2517,2615,0.5,2566.0,-98
10668,2538,2603,1.0,2570.5,-65
10669,2613,2593,0.5,2603.0,20
10670,2675,2608,1.0,2641.5,67
10671,2652,2291,0.5,2471.5,361
10672,2563,2517,0.0,2540.0,46
10673,2608,2538,1.0,2573.0,70
10674,2291,2675,0.5,2483.0,-384
10675,2615,2613,0.5,2614.0,2
10676,2729,2652,0.5,2690.5,77
10677,2603,2511,0.5,2557.0,92
10678,2593,2352,0.0,2472.5,241
10679,1928,1919,1.0,1923.5,9
10680,2290,2427,0.5,2358.5,-137
10681,2350,1885,1.0,2117.5,465
10682,1805,2332,0.0,2068.5,-527
10683,2313,1669,1.0,1991.0,644
10684,2289,1773,1.0,2031.0,516
10685,2057,2079,0.0,2068.0,-22
10686,2110,1921,1.0,2015.5,189
10687,1807,2194,0.0,2000.5,-387
10688,2158,2349,1.0,2253.5,-191
10689,2212,1860,1.0,2036.0,352
10690,1839,2147,0.0,1993.0,-308
10691,2516,2093,1.0,2304.5,423
10692,1852,2204,0.0,2028.0,-352
10693,2077,1792,1.0,1934.5,285
10694,1679,2022,1.0,1850.5,-343
10695,1890,2246,0.5,2068.0,-356
10696,2157,1857,0.5,2007.0,300
10697,1835,2140,0.0,1987.5,-305
10698,2112,1818,1.0,1965.0,294
10699,2261,1706,1.0,1983.5,555
10700,1741,2160,1.0,1950.5,-419
10701,2110,1964,0.0,2037.0,146
10702,1810,2041,0.5,1925.5,-231
10703,1897,2308,0.0,2102.5,-411
10704,1986,1863,0.5,1924.5,123
10705,1689,2122,0.5,1905.5,-433
10706,2122,1963,1.0,2042.5,159
10707,1793,2015,0.0,1904.0,-222
10708,2085,1547,1.0,1816.0,538
10709,1514,1902,0.0,1708.0,-388
10710,1554,2235,0.0,1894.5,-681
10711,1993,1882,0.5,1937.5,111
10712,1741,1922,0.0,1831.5,-181
10713,1897,1623,1.0,1760.0,274
10714,2126,1720,0.0,1923.0,406
10715,1694,1986,1.0,1840.0,-292
10716,1959,1898,1.0,1928.5,61
10717,2182,1964,0.5,2073.0,218
10718,1680,2008,0.0,1844.0,-328
10719,1622,2028,0.0,1825.0,-406
10720,1889,1783,1.0,1836.0,106
10721,1955,2158,1.0,2056.5,-203
10722,1786,1874,1.0,1830.0,-88
10723,2427,2246,1.0,2336.5,181
10724,2157,2350,0.5,2253.5,-193
10725,2332,2140,1.0,2236.0,192
10726,2112,2313,0.0,2212.5,-201
10727,1720,2407,0.0,2063.5,-687
10728,2289,1694,1.0,1991.5,595
10729,2194,2079,0.5,2136.5,115
10730,2349,2122,1.0,2235.5,227
10731,2015,2212,1.0,2113.5,-197
10732,2147,2085,0.5,2116.0,62
10733,1902,2208,1.0,2055.0,-306
10734,2158,2516,0.0,2337.0,-358
10735,2204,1955,1.0,2079.5,249
10736,1874,2077,0.0,1975.5,-203
10737,2095,1786,0.5,1940.5,309
10738,1964,2308,0.0,2136.0,-344
10739,1986,1795,0.0,1890.5,191
10740,1920,2122,0.5,2021.0,-202
10741,1838,2008,0.0,1923.0,-170
10742,2235,2098,1.0,2166.5,137
10743,2028,1993,1.0,2010.5,35
10744,1922,1864,0.5,1893.0,58
10745,1889,1897,1.0,1893.0,-8
10746,1741,1964,0.0,1852.5,-223
10747,1810,1703,0.0,1756.5,107
10748,2126,2261,0.5,2193.5,-135
10749,2110,1959,0.5,2034.5,151
10750,1898,2041,0.5,1969.5,-143
10751,2015,1773,1.0,1894.0,242
10752,1611,1689,0.5,1650.0,-78
10753,1773,1805,0.0,1789.0,-32
10754,1857,1890,0.5,1873.5,-33
10755,1921,2057,1.0,1989.0,-136
10756,1818,1835,0.5,1826.5,-17
10757,1502,2158,0.0,1830.0,-656
10758,1860,1882,0.0,1871.0,-22
10759,1741,1839,1.0,1790.0,-98
10760,1561,1623,0.0,1592.0,-62
10761,2093,2182,0.5,2137.5,-89
10762,1792,1852,0.5,1822.0,-60
10763,1793,1963,1.0,1878.0,-170
10764,1514,1547,0.5,1530.5,-33
10765,1706,2427,0.0,2066.5,-721
10766,2350,1741,1.0,2045.5,609
10767,1964,2332,0.0,2148.0,-368
10768,2313,1810,1.0,2061.5,503
10769,2407,2122,1.0,2264.5,285
10770,2015,2289,0.0,2152.0,-274
10771,2079,2085,1.0,2082.0,-6
10772,1902,2110,0.0,2006.0,-208
10773,2516,1795,1.0,2155.5,721
10774,1920,2204,0.0,2062.0,-284
10775,2077,2008,0.5,2042.5,69
10776,2000,2095,0.0,2047.5,-95
10777,2098,2349,0.0,2223.5,-251
10778,2212,2028,0.5,2120.0,184
10779,1864,2147,0.0,2005.5,-283
10780,2093,1783,1.0,1938.0,310
10781,2246,2158,0.0,2202.0,88
10782,1874,2157,0.0,2015.5,-283
10783,2140,1786,0.5,1963.0,354
10784,1643,2061,0.0,1852.0,-418
10785,2261,2093,1.0,2177.0,168
10786,1852,2160,0.0,2006.0,-308
10787,2041,1679,1.0,1860.0,362
10788,1527,2015,0.5,1771.0,-488
10789,2308,1502,1.0,1905.0,806
10790,1554,1986,0.0,1770.0,-432
10791,2122,1882,0.0,2002.0,240
10792,1741,1838,0.5,1789.5,-97
10793,1720,2235,1.0,1977.5,-515
10794,1993,1694,1.0,1843.5,299
10795,1885,2290,1.0,2087.5,-405
10796,1897,1773,0.0,1835.0,124
10797,2057,1863,0.5,1960.0,194
10798,1689,1921,0.0,1805.0,-232
10799,1807,1711,1.0,1759.0,96
10800,1963,1890,0.0,1926.5,73
10801,1857,1793,0.0,1825.0,64
10802,1547,1835,0.0,1691.0,-288
10803,1818,1514,1.0,1666.0,304
10804,2158,1622,1.0,1890.0,536
10805,1986,2126,0.5,2056.0,-140
10806,1839,1860,0.5,1849.5,-21
10807,1898,1959,0.5,1928.5,-61
10808,2427,1561,0.5,1994.0,866
10809,2289,2407,1.0,2348.0,-118
10810,2332,2350,0.5,2341.0,-18
10811,2194,2079,0.5,2136.5,115
10812,2349,2328,0.5,2338.5,21
10813,2204,2516,1.0,2360.0,-312
10814,2147,2212,0.5,2179.5,-65
10815,2095,2077,0.5,2086.0,18
10816,2246,2208,1.0,2227.0,38
10817,1694,1720,1.0,1707.0,-26
10818,2112,2157,1.0,2134.5,-45
10819,1964,2061,0.0,2012.5,-97
10820,2160,2261,1.0,2210.5,-101
10821,2008,1920,1.0,1964.0,88
10822,2015,2110,0.0,2062.5,-95
10823,2308,2000,1.0,2154.0,308
10824,1741,1706,1.0,1723.5,35
10825,2122,1986,0.0,2054.0,136
10826,1810,1964,0.5,1887.0,-154
10827,2122,1838,0.5,1980.0,284
10828,2028,2098,0.0,2063.0,-70
10829,2085,2015,0.5,2050.0,70
10830,1889,1864,0.5,1876.5,25
10831,1890,1902,0.5,1896.0,-12
10832,1885,2290,0.0,2087.5,-405
10833,1818,1835,0.5,1826.5,-17
10834,1669,1685,0.5,1677.0,-16
10835,1622,2057,0.0,1839.5,-435
10836,1921,1807,1.0,1864.0,114
10837,2235,2158,0.5,2196.5,77
10838,1860,1993,1.0,1926.5,-133
10839,1922,1839,1.0,1880.5,83
10840,2158,1897,1.0,2027.5,261
10841,1554,1502,0.0,1528.0,52
10842,1786,1955,0.0,1870.5,-169
10843,1741,1882,0.0,1811.5,-141
10844,2093,1643,0.0,1868.0,450
10845,1863,1897,0.5,1880.0,-34
10846,1679,1792,1.0,1735.5,-113
10847,1611,1711,1.0,1661.0,-100
10848,1963,1527,1.0,1745.0,436
10849,1547,1793,1.0,1670.0,-246
10850,2182,1514,1.0,1848.0,668
10851,2407,2516,0.5,2461.5,-109
10852,2204,2079,1.0,2141.5,125
10853,2110,2077,0.5,2093.5,33
10854,2095,2194,0.5,2144.5,-99
10855,2122,2427,0.0,2274.5,-305
10856,2332,2015,1.0,2173.5,317
10857,2085,2328,0.0,2206.5,-243
10858,2313,1902,1.0,2107.5,411
10859,1741,1720,0.0,1730.5,21
10860,1694,1964,0.0,1829.0,-270
10861,1810,1703,0.0,1756.5,107
10862,2261,1773,0.5,2017.0,488
10863,2057,2160,0.5,2108.5,-103
10864,2041,1921,1.0,1981.0,120
10865,1890,2015,1.0,1952.5,-125
10866,1795,1964,0.0,1879.5,-169
10867,1835,1857,0.5,1846.0,-22
10868,2000,2008,1.0,2004.0,-8
10869,2349,1818,1.0,2083.5,531
10870,2140,2246,0.0,2193.0,-106
10871,2147,2212,1.0,2179.5,-65
10872,2061,2112,0.5,2086.5,-51
10873,2235,2208,0.0,2221.5,27
10874,1986,2308,1.0,2147.0,-322
10875,1922,1993,0.5,1957.5,-71
10876,1838,2122,0.0,1980.0,-284
10877,2098,1897,0.5,1997.5,201
10878,1955,2158,1.0,2056.5,-203
10879,1864,2028,1.0,1946.0,-164
10880,1643,1874,0.5,1758.5,-231
10881,2290,1889,1.0,2089.5,401
10882,1793,1963,1.0,1878.0,-170
10883,1514,1547,1.0,1530.5,-33
10884,1897,1805,1.0,1851.0,92
10885,1622,1863,0.0,1742.5,-241
10886,1689,1611,0.5,1650.0,78
10887,2158,2182,1.0,2170.0,-24
10888,1839,1860,1.0,1849.5,-21
10889,1554,1680,0.0,1617.0,-126
10890,1986,2126,1.0,2056.0,-140
10891,1741,1882,0.0,1811.5,-141
10892,1773,1959,1.0,1866.0,-186
10893,2516,1623,1.0,2069.5,893
10894,2332,2427,1.0,2379.5,-95
10895,2077,2204,0.0,2140.5,-127
10896,2313,2328,0.5,2320.5,-15
10897,2407,2095,0.5,2251.0,312
10898,1964,1741,0.0,1852.5,223
10899,2079,2289,1.0,2184.0,-210
10900,1703,1810,0.0,1756.5,-107
10901,2261,2194,1.0,2227.5,67
10902,1857,1890,0.0,1873.5,-33
10903,2110,2160,0.5,2135.0,-50
10904,1818,1835,0.0,1826.5,-17
10905,1986,2015,0.0,2000.5,-29
10906,2212,2349,1.0,2280.5,-137
10907,1838,2122,0.0,1980.0,-284
10908,2208,2147,1.0,2177.5,61
10909,2158,1875,0.0,2016.5,283
10910,2015,2122,1.0,2068.5,-107
10911,1786,1955,0.0,1870.5,-169
10912,1902,2085,1.0,1993.5,-183
10913,2246,1643,1.0,1944.5,603
10914,2028,2098,0.0,2063.0,-70
10915,2140,2157,1.0,2148.5,-17
10916,1889,1864,0.5,1876.5,25
10917,1795,2112,0.5,1953.5,-317
10918,2057,1773,0.0,1915.0,284
10919,2008,1920,0.5,1964.0,88
10920,1807,1921,1.0,1864.0,-114
10921,1720,2000,1.0,1860.0,-280
10922,1863,1897,0.0,1880.0,-34
10923,1711,1689,0.0,1700.0,22
10924,2290,2235,1.0,2262.5,55
10925,1993,1885,0.0,1939.0,108
10926,1897,1922,1.0,1909.5,-25
10927,1963,1805,0.0,1884.0,158
10928,1860,2158,1.0,2009.0,-298
10929,1547,1793,0.0,1670.0,-246
10930,1561,1839,1.0,1700.0,-278
10931,1852,2093,1.0,1972.5,-241
10932,1679,1792,0.0,1735.5,-113
10933,1986,1680,1.0,1833.0,306
10934,1898,1959,1.0,1928.5,-61
10935,2427,2261,1.0,2344.0,166
10936,2160,2350,0.0,2255.0,-190
10937,2332,2110,1.0,2221.0,222
10938,2041,2313,0.5,2177.0,-272
10939,2349,2407,0.5,2378.0,-58
10940,2289,2212,0.0,2250.5,77
10941,2147,2110,1.0,2128.5,37
10942,2194,2208,1.0,2201.0,-14
10943,2122,2516,0.0,2319.0,-394
10944,2204,2015,0.5,2109.5,189
10945,2085,2077,0.0,2081.0,8
10946,2095,1902,0.5,1998.5,193
10947,1741,2246,1.0,1993.5,-505
10948,2157,1964,0.0,2060.5,193
10949,1810,2140,0.0,1975.0,-330
10950,2061,1703,0.5,1882.0,358
10951,1890,1720,1.0,1805.0,170
10952,1694,1857,0.0,1775.5,-163
10953,1835,1685,1.0,1760.0,150
10954,1773,2308,0.0,2040.5,-535
10955,1986,2057,0.0,2021.5,-71
10956,1921,2122,1.0,2021.5,-201
10957,1838,1807,0.5,1822.5,31
10958,2158,1964,1.0,2061.0,194
10959,1795,1860,0.0,1827.5,-65
10960,1839,1920,0.0,1879.5,-81
10961,2235,2126,0.5,2180.5,109
10962,1986,1993,0.5,1989.5,-7
10963,1922,1959,1.0,1940.5,-37
10964,1898,1897,0.0,1897.5,1
10965,2098,2290,0.0,2194.0,-192
10966,1885,2028,0.0,1956.5,-143
10967,1669,1889,0.0,1779.0,-220
10968,1897,2158,0.0,2027.5,-261
10969,1955,1863,0.5,1909.0,92
10970,1711,1874,0.0,1792.5,-163
10971,1643,1611,0.5,1627.0,32
10972,2093,1963,1.0,2028.0,130
10973,1793,1852,0.0,1822.5,-59
10974,1792,1547,1.0,1669.5,245
10975,1514,1527,0.5,1520.5,-13
10976,1680,1502,0.0,1591.0,178
10977,1554,1882,0.0,1718.0,-328
10978,2427,2349,1.0,2388.0,78
10979,2212,2350,0.5,2281.0,-138
10980,2332,2147,0.5,2239.5,185
10981,2093,2328,0.5,2210.5,-235
10982,2516,1706,1.0,2111.0,810
10983,1741,2204,0.5,1972.5,-463
10984,2077,1964,0.0,2020.5,113
10985,1703,2095,0.5,1899.0,-392
10986,2261,2407,1.0,2334.0,-146
10987,2289,2160,0.5,2224.5,129
10988,2041,2079,0.5,2060.0,-38
10989,2194,2015,1.0,2104.5,179
10990,2158,1890,0.5,2024.0,268
10991,1857,1860,0.0,1858.5,-3
10992,1839,1835,0.0,1837.0,4
10993,1818,1561,0.5,1689.5,257
10994,1773,2122,0.5,1947.5,-349
10995,2015,2057,0.0,2036.0,-42
10996,1921,2085,0.0,2003.0,-164
10997,1902,1807,1.0,1854.5,95
10998,2246,2235,1.0,2240.5,11
10999,1993,2157,0.5,2075.0,-164
11000,2140,1922,1.0,2031.0,218
11001,1897,2112,0.0,2004.5,-215
11002,2158,2093,0.5,2125.5,65
11003,1852,1955,0.5,1903.5,-103
11004,1874,1792,1.0,1833.0,82
11005,1679,1786,0.0,1732.5,-107
11006,1720,2182,0.5,1951.0,-462
11007,1964,1680,0.0,1822.0,284
11008,1885,2290,0.5,2087.5,-405
11009,2008,1920,1.0,1964.0,88
11010,1669,2000,0.0,1834.5,-331
11011,1986,2126,0.0,2056.0,-140
11012,1986,2122,1.0,2054.0,-136
11013,1838,1898,0.5,1868.0,-60
11014,1773,1875,0.0,1824.0,-102
11015,1554,2098,0.0,1826.0,-544
11016,2028,1882,1.0,1955.0,146
11017,1741,1864,0.5,1802.5,-123
11018,1889,1623,1.0,1756.0,266
11019,1689,1863,1.0,1776.0,-174
11020,1611,1711,1.0,1661.0,-100
11021,1890,2350,0.5,2120.0,-460
11022,2332,1857,1.0,2094.5,475
11023,1835,2328,0.0,2081.5,-493
11024,2313,1685,1.0,1999.0,628
11025,2516,2261,0.5,2388.5,255
11026,2160,2204,0.0,2182.0,-44
11027,2077,2110,0.0,2093.5,-33
11028,2041,2095,1.0,2068.0,-54
11029,1706,2349,0.0,2027.5,-643
11030,2212,1741,0.5,1976.5,471
11031,1964,2147,0.5,2055.5,-183
11032,2208,1703,0.5,1955.5,505
11033,2407,2158,0.5,2282.5,249
11034,1860,2289,0.0,2074.5,-429
11035,2079,1839,1.0,1959.0,240
11036,1561,2194,0.0,1877.5,-633
11037,2122,2246,0.5,2184.0,-124
11038,2157,2015,1.0,2086.0,142
11039,2085,2112,0.0,2098.5,-27
11040,2061,1902,0.0,1981.5,159
11041,1720,2158,0.0,1939.0,-438
11042,1955,1694,0.5,1824.5,261
11043,1786,1874,0.5,1830.0,-88
11044,2098,1964,1.0,2031.0,134
11045,1920,2028,0.0,1974.0,-108
11046,1864,2008,0.5,1936.0,-144
11047,2000,1889,0.0,1944.5,111
11048,2235,1773,1.0,2004.0,462
11049,2057,1993,0.0,2025.0,64
11050,1922,1921,1.0,1921.5,1
11051,1807,1897,0.0,1852.0,-90
11052,2126,2093,0.5,2109.5,33
11053,1852,1986,0.5,1919.0,-134
11054,1959,1792,1.0,1875.5,167
11055,1679,1898,0.5,1788.5,-219
11056,2182,1897,1.0,2039.5,285
11057,1680,1689,1.0,1684.5,-9
11058,1622,1885,0.0,1753.5,-263
11059,1882,1502,1.0,1692.0,380
11060,1623,1741,1.0,1682.0,-118
11061,1963,1793,0.0,1878.0,170
11062,1547,1514,0.5,1530.5,33
11063,2019,2114,0.0,2066.5,-95
11064,2759,2798,0.0,2778.5,-39
11065,2798,2759,0.0,2778.5,39
11066,2759,2798,0.0,2778.5,-39
11067,2798,2759,0.5,2778.5,39
11068,2613,2470,0.5,2541.5,143
11069,2544,2462,1.0,2503.0,82
11070,2470,2613,0.5,2541.5,-143
11071,2462,2544,1.0,2503.0,-82
11072,2613,2470,1.0,2541.5,143
11073,2544,2462,0.5,2503.0,82
11074,2470,2613,0.5,2541.5,-143
11075,2462,2544,0.5,2503.0,-82
11076,2759,2798,0.5,2778.5,-39
11077,2544,2462,1.0,2503.0,82
11078,2613,2470,1.0,2541.5,143
11079,1266,1643,0.0,1454.5,-377
11080,2501,2216,1.0,2358.5,285
11081,2155,2481,0.0,2318.0,-326
11082,2454,2109,1.0,2281.5,345
11083,1877,2406,0.0,2141.5,-529
11084,2187,2497,0.0,2342.0,-310
11085,2433,2107,1.0,2270.0,326
11086,2093,2422,0.5,2257.5,-329
11087,2336,1953,1.0,2144.5,383
11088,2450,2135,1.0,2292.5,315
11089,2044,2382,0.0,2213.0,-338
11090,2297,2048,1.0,2172.5,249
11091,2025,1894,0.0,1959.5,131
11092,2206,2414,1.0,2310.0,-208
11093,2353,2102,1.0,2227.5,251
11094,2059,2411,0.0,2235.0,-352
11095,2325,1808,1.0,2066.5,517
11096,2425,2171,1.0,2298.0,254
11097,2048,2329,0.5,2188.5,-281
11098,2332,1977,1.0,2154.5,355
11099,1974,2177,0.5,2075.5,-203
11100,2250,2372,0.0,2311.0,-122
11101,2364,2008,1.0,2186.0,356
11102,1880,2366,0.0,2123.0,-486
11103,2316,1856,0.0,2086.0,460
11104,2403,2099,1.0,2251.0,304
11105,1994,2346,0.0,2170.0,-352
11106,2275,1970,0.0,2122.5,305
11107,1929,2227,0.5,2078.0,-298
11108,1948,2266,0.0,2107.0,-318
11109,2310,2051,1.0,2180.5,259
11110,2081,2259,0.0,2170.0,-178
11111,2031,1874,1.0,1952.5,157
11112,2364,2274,0.5,2319.0,90
11113,2032,2214,0.0,2123.0,-182
11114,2282,1864,0.5,2073.0,418
11115,1745,2270,0.0,2007.5,-525
11116,2077,2415,0.0,2246.0,-338
11117,2315,1860,1.0,2087.5,455
11118,1889,2215,0.0,2052.0,-326
11119,2152,1888,0.0,2020.0,264
11120,2420,2101,1.0,2260.5,319
11121,1943,2274,0.0,2108.5,-331
11122,2263,1841,0.5,2052.0,422
11123,1636,1915,0.5,1775.5,-279
11124,2163,2364,0.5,2263.5,-201
11125,2289,1850,1.0,2069.5,439
11126,1727,2168,0.0,1947.5,-441
11127,2175,1648,1.0,1911.5,527
11128,2463,2154,1.0,2308.5,309
11129,1618,2289,0.0,1953.5,-671
11130,2191,1604,1.0,1897.5,587
11131,1593,2044,0.0,1818.5,-451
11132,1889,2324,0.0,2106.5,-435
11133,2216,1677,1.0,1946.5,539
11134,2005,2284,1.0,2144.5,-279
11135,2314,1618,1.0,1966.0,696
11136,1766,1923,0.0,1844.5,-157
11137,2013,2210,1.0,2111.5,-197
11138,1453,1716,0.5,1584.5,-263
11139,1944,1727,0.0,1835.5,217
11140,2142,2263,1.0,2202.5,-121
11141,1632,1626,0.0,1629.0,6
11142,1881,2124,1.0,2002.5,-243
11143,2447,1638,0.5,2042.5,809
11144,1763,1962,0.5,1862.5,-199
11145,2121,2257,1.0,2189.0,-136
11146,1548,1561,0.0,1554.5,-13
11147,1827,2083,0.0,1955.0,-256
11148,2162,2146,1.0,2154.0,16
11149,1632,1795,0.0,1713.5,-163
11150,1612,2127,0.5,1869.5,-515
11151,2263,1516,1.0,1889.5,747
11152,1682,1911,0.0,1796.5,-229
11153,2162,2200,1.0,2181.0,-38
11154,1370,1609,0.0,1489.5,-239
11155,1720,2114,0.0,1917.0,-394
11156,2176,2139,1.0,2157.5,37
11157,1685,1712,0.0,1698.5,-27
11158,1880,2102,0.0,1991.0,-222
11159,2396,1619,1.0,2007.5,777
11160,1682,1648,0.0,1665.0,34
11161,2051,2148,1.0,2099.5,-97
11162,1653,1687,0.0,1670.0,-34
11163,1766,2097,0.5,1931.5,-331
11164,2139,2117,1.0,2128.0,22
11165,1771,1772,0.0,1771.5,-1
11166,1890,2136,0.5,2013.0,-246
11167,2271,1352,1.0,1811.5,919
11168,1944,1628,0.5,1786.0,316
11169,2074,2167,0.5,2120.5,-93
11170,1594,1442,0.0,1518.0,152
11171,1783,2138,0.0,1960.5,-355
11172,2246,2186,1.0,2216.0,60
11173,1626,1631,0.0,1628.5,-5
11174,2104,2103,1.0,2103.5,1
11175,2208,1272,1.0,1740.0,936
11176,1398,1726,0.0,1562.0,-328
11177,2051,2034,0.0,2042.5,17
11178,1490,1564,0.0,1527.0,-74
11179,1318,2103,0.0,1710.5,-785
11180,2100,2259,0.0,2179.5,-159
11181,1703,1744,0.0,1723.5,-41
11182,1947,2049,0.5,1998.0,-102
11183,2108,1406,1.0,1757.0,702
11184,1335,1429,0.0,1382.0,-94
11185,2050,2103,1.0,2076.5,-53
11186,1259,1248,0.0,1253.5,11
11187,2324,1791,0.0,2057.5,533
11188,2481,2501,1.0,2491.0,-20
11189,2284,2216,1.0,2250.0,68
11190,2396,2454,0.5,2425.0,-58
11191,2382,2450,1.0,2416.0,-68
11192,2142,2263,0.0,2202.5,-121
11193,1894,2431,0.5,2162.5,-537
11194,2351,2124,1.0,2237.5,227
11195,2148,2396,0.0,2272.0,-248
11196,2310,2266,1.0,2288.0,44
11197,2097,2051,1.0,2074.0,46
11198,2259,2031,0.0,2145.0,228
11199,2289,2463,1.0,2376.0,-174
11200,2049,2100,1.0,2074.5,-51
11201,2044,2191,0.0,2117.5,-147
11202,2372,2051,0.5,2211.5,321
11203,2200,2263,0.0,2231.5,-63
11204,2366,2364,1.0,2365.0,2
11205,2107,2162,0.0,2134.5,-55
11206,2186,2275,0.0,2230.5,-89
11207,2274,2420,0.5,2347.0,-146
11208,2103,2246,0.0,2174.5,-143
11209,1915,2263,0.0,2089.0,-348
11210,2497,2081,0.5,2289.0,416
11211,2314,2402,0.0,2358.0,-88
11212,2422,2477,1.0,2449.5,-55
11213,2013,2210,0.0,2111.5,-197
11214,2364,2336,1.0,2350.0,28
11215,2276,2208,1.0,2242.0,68
11216,2168,2289,1.0,2228.5,-121
11217,2051,2034,0.0,2042.5,17
11218,2331,2175,1.0,2253.0,156
11219,2329,2425,1.0,2377.0,-96
11220,2162,2146,0.5,2154.0,16
11221,2177,2350,1.0,2263.5,-173
11222,2414,2127,0.0,2270.5,287
11223,2257,2447,0.5,2352.0,-190
11224,2411,2353,1.0,2382.0,58
11225,2030,2121,0.5,2075.5,-91
11226,2292,2316,0.0,2304.0,-24
11227,2254,2364,0.5,2309.0,-110
11228,2139,2117,0.5,2128.0,22
11229,2270,2282,0.5,2276.0,-12
11230,2415,2136,1.0,2275.5,279
11231,2167,2271,1.0,2219.0,-104
11232,2215,2315,0.5,2265.0,-100
11233,2138,2074,0.5,2106.0,64
11234,2321,2201,0.0,2261.0,120
11235,2346,2403,1.0,2374.5,-57
11236,2176,2139,0.0,2157.5,37
11237,2227,2288,1.0,2257.5,-61
11238,2216,2102,0.0,2159.0,114
11239,2108,2131,1.0,2119.5,-23
11240,2109,2155,0.0,2132.0,-46
11241,2050,2103,1.0,2076.5,-53
11242,2099,1877,1.0,1988.0,222
11243,1685,1712,0.5,1698.5,-27
11244,1970,1994,1.0,1982.0,-24
11245,1619,1631,0.0,1625.0,-12
11246,2154,1897,1.0,2025.5,257
11247,1744,1318,1.0,1531.0,426
11248,1604,1618,0.0,1611.0,-14
11249,1406,1703,0.5,1554.5,-297
11250,1962,1593,0.0,1777.5,369
11251,2102,2206,1.0,2154.0,-104
11252,1561,1763,0.0,1662.0,-202
11253,1808,2059,1.0,1933.5,-251
11254,2171,1548,1.0,1859.5,623
11255,1795,1827,0.0,1811.0,-32
11256,1977,2048,1.0,2012.5,-71
11257,1516,1632,0.0,1574.0,-116
11258,1911,1313,0.0,1612.0,598
11259,1880,2008,0.5,1944.0,-128
11260,1609,1682,0.0,1645.5,-73
11261,1287,1856,1.0,1571.5,-569
11262,2274,1370,1.0,1822.0,904
11263,1772,1766,0.5,1769.0,6
11264,1864,2032,1.0,1948.0,-168
11265,1352,1771,0.0,1561.5,-419
11266,1628,1513,0.0,1570.5,115
11267,1889,1860,0.5,1874.5,29
11268,1442,1944,0.0,1693.0,-502
11269,1818,1888,1.0,1853.0,-70
11270,2101,1594,1.0,1847.5,507
11271,1631,1783,0.0,1707.0,-152
11272,1841,1943,1.0,1892.0,-102
11273,1272,1422,1.0,1347.0,-150
11274,1726,1605,0.0,1665.5,121
11275,1850,2163,1.0,2006.5,-313
11276,1564,1398,0.0,1481.0,166
11277,1648,1727,1.0,1687.5,-79
11278,1923,1490,1.0,1706.5,433
11279,2107,2187,0.0,2147.0,-80
11280,1716,1766,0.5,1741.0,-50
11281,1677,2093,1.0,1885.0,-416
11282,2135,1453,0.5,1794.0,682
11283,1626,1944,0.0,1785.0,-318
11284,2048,2044,1.0,2046.0,4
11285,1638,1632,0.0,1635.0,6
11286,1648,2025,0.0,1836.5,-377
11287,2081,1948,1.0,2014.5,133
11288,1687,1682,1.0,1684.5,5
11289,1651,1874,0.5,1762.5,-223
11290,1429,1644,0.0,1536.5,-215
11291,1763,1677,1.0,1720.0,86
11292,1248,1335,0.0,1291.5,-87
11293,1618,1259,1.0,1438.5,359
11294,2131,2372,0.0,2251.5,-241
11295,2364,2108,1.0,2236.0,256
11296,2103,2366,0.5,2234.5,-263
11297,2275,2050,0.0,2162.5,225
11298,2450,2351,1.0,2400.5,99
11299,2266,2382,0.0,2324.0,-116
11300,2431,2310,0.5,2370.5,121
11301,2259,2297,0.0,2278.0,-38
11302,2364,2497,0.0,2430.5,-133
11303,2477,2214,0.5,2345.5,263
11304,2254,2433,0.5,2343.5,-179
11305,2422,2282,1.0,2352.0,140
11306,2403,2364,0.0,2383.5,39
11307,2289,2346,1.0,2317.5,-57
11308,2288,2168,1.0,2228.0,120
11309,2003,2227,0.0,2115.0,-224
11310,2425,2420,0.5,2422.5,5
11311,2274,2329,0.5,2301.5,-55
11312,2350,2263,1.0,2306.5,87
11313,2117,2332,1.0,2224.5,-215
11314,2463,2324,1.0,2393.5,139
11315,2216,2289,1.0,2252.5,-73
11316,2191,2284,0.0,2237.5,-93
11317,2143,2044,0.5,2093.5,99
11318,2501,2259,1.0,2380.0,242
11319,2049,2481,0.0,2265.0,-432
11320,2454,2051,1.0,2252.5,403
11321,1947,2406,0.0,2176.5,-459
11322,2271,2353,0.0,2312.0,-82
11323,2411,2167,0.0,2289.0,244
11324,2074,2316,0.5,2195.0,-242
11325,2325,2138,1.0,2231.5,187
11326,2447,2415,0.5,2431.0,32
11327,2215,2257,1.0,2236.0,-42
11328,2030,2152,0.5,2091.0,-122
11329,2201,2083,1.0,2142.0,118
11330,1889,2186,1.0,2037.5,-297
11331,2246,1677,1.0,1961.5,569
11332,1763,2104,0.0,1933.5,-341
11333,2396,2274,0.5,2335.0,122
11334,1864,2148,0.5,2006.0,-284
11335,2097,1745,1.0,1921.0,352
11336,1513,1884,0.0,1698.5,-371
11337,2263,2099,0.5,2181.0,164
11338,1994,2200,0.0,2097.0,-206
11339,2107,1970,0.0,2038.5,137
11340,1929,2114,0.0,2021.5,-185
11341,2250,2396,1.0,2323.0,-146
11342,2263,2008,1.0,2135.5,255
11343,1880,2142,1.0,2011.0,-262
11344,1881,1856,0.0,1868.5,25
11345,1948,2331,0.0,2139.5,-383
11346,2162,2051,0.0,2106.5,111
11347,2081,2127,0.0,2104.0,-46
11348,1612,1651,1.0,1631.5,-39
11349,2206,1923,1.0,2064.5,283
11350,1766,2102,0.5,1934.0,-336
11351,2059,1716,1.0,1887.5,343
11352,1453,1808,0.5,1630.5,-355
11353,2402,2171,1.0,2286.5,231
11354,2048,2314,0.0,2181.0,-266
11355,2210,1977,1.0,2093.5,233
11356,1974,1727,0.5,1850.5,247
11357,2163,2292,1.0,2227.5,-129
11358,2117,1850,0.5,1983.5,267
11359,1727,2139,0.5,1933.0,-412
11360,1890,1648,0.5,1769.0,242
11361,2077,2321,1.0,2199.0,-244
11362,2139,1889,0.0,2014.0,250
11363,1888,2176,0.0,2032.0,-288
11364,2102,1818,1.0,1960.0,284
11365,2208,2101,0.5,2154.5,107
11366,1943,2276,0.0,2109.5,-333
11367,2034,1636,1.0,1835.0,398
11368,1605,2103,1.0,1854.0,-498
11369,1318,2135,0.0,1726.5,-817
11370,2044,1744,1.0,1894.0,300
11371,1703,2048,0.0,1875.5,-345
11372,2025,1406,1.0,1715.5,619
11373,2187,1648,1.0,1917.5,539
11374,1682,2093,0.0,1887.5,-411
11375,1953,1653,0.5,1803.0,300
11376,1644,1677,0.5,1660.5,-33
11377,1766,2154,0.5,1960.0,-388
11378,1618,1772,0.0,1695.0,-154
11379,1771,1604,1.0,1687.5,167
11380,1289,1352,0.0,1320.5,-63
11381,1944,1628,0.5,1786.0,316
11382,1944,1626,1.0,1785.0,318
11383,1632,1442,1.0,1537.0,190
11384,1594,1638,0.0,1616.0,-44
11385,1720,2216,0.0,1968.0,-496
11386,2155,1685,1.0,1920.0,470
11387,1631,2109,0.0,1870.0,-478
11388,1877,1619,0.5,1748.0,258
11389,1783,1962,0.5,1872.5,-179
11390,1763,1631,1.0,1697.0,132
11391,1422,1561,0.5,1491.5,-139
11392,1548,1272,0.0,1410.0,276
11393,1827,1726,1.0,1776.5,101
11394,1564,1795,1.0,1679.5,-231
11395,1632,1490,0.0,1561.0,142
11396,1220,1516,0.0,1368.0,-296
11397,1429,1911,0.0,1670.0,-482
11398,1682,1335,1.0,1508.5,347
11399,1248,1609,1.0,1428.5,-361
11400,1370,1259,0.0,1314.5,111
11401,2497,2450,0.5,2473.5,47
11402,2382,2477,0.5,2429.5,-95
11403,2433,2431,0.5,2432.0,2
11404,2297,2422,0.5,2359.5,-125
11405,2372,2501,0.0,2436.5,-129
11406,2481,2364,0.5,2422.5,117
11407,2366,2454,0.5,2410.0,-88
11408,2406,2316,1.0,2361.0,90
11409,2364,2425,1.0,2394.5,-61
11410,2350,2289,1.0,2319.5,61
11411,2168,2332,0.5,2250.0,-164
11412,2177,2175,0.5,2176.0,2
11413,2420,2403,0.0,2411.5,17
11414,2346,2274,1.0,2310.0,72
11415,2263,2288,1.0,2275.5,-25
11416,2227,2117,1.0,2172.0,110
11417,2414,2415,0.0,2414.5,-1
11418,2315,2353,0.5,2334.0,-38
11419,2316,2215,0.5,2265.5,101
11420,2152,2325,0.0,2238.5,-173
11421,2324,2364,0.0,2344.0,-40
11422,2214,2216,0.0,2215.0,-2
11423,2284,2254,0.5,2269.0,30
11424,2270,2143,1.0,2206.5,127
11425,2131,2402,0.0,2266.5,-271
11426,2314,2103,0.5,2208.5,211
11427,2050,2210,0.5,2130.0,-160
11428,2013,1791,1.0,1902.0,222
11429,2246,2163,0.5,2204.5,83
11430,1850,2103,0.5,1976.5,-253
11431,2104,1727,1.0,1915.5,377
11432,1648,2081,1.0,1864.5,-433
11433,2250,2396,0.0,2323.0,-146
11434,2051,2008,0.5,2029.5,43
11435,1880,2097,0.0,1988.5,-217
11436,1884,1287,1.0,1585.5,597
11437,2331,2206,1.0,2268.5,125
11438,2102,2146,0.5,2124.0,-44
11439,2127,2059,0.5,2093.0,68
11440,1808,1612,1.0,1710.0,196
11441,2351,2208,1.0,2279.5,143
11442,2276,2266,1.0,2271.0,10
11443,2310,2051,1.0,2180.5,259
11444,2103,2031,1.0,2067.0,72
11445,2135,2263,0.5,2199.0,-128
11446,2200,2044,1.0,2122.0,156
11447,2048,2162,0.5,2105.0,-114
11448,2114,2025,1.0,2069.5,89
11449,2077,2463,0.0,2270.0,-386
11450,2289,1860,0.5,2074.5,429
11451,1888,2191,1.0,2039.5,-303
11452,2044,1818,1.0,1931.0,226
11453,2321,2271,1.0,2296.0,50
11454,2167,2176,0.0,2171.5,-9
11455,2102,2074,0.5,2088.0,28
11456,2138,1880,0.0,2009.0,258
11457,2259,2447,0.5,2353.0,-188
11458,2257,2100,0.5,2178.5,157
11459,2051,2030,1.0,2040.5,21
11460,2083,1947,1.0,2015.0,136
11461,2099,1318,1.0,1708.5,781
11462,1744,1970,0.0,1857.0,-226
11463,1929,1703,0.5,1816.0,226
11464,1406,1897,0.0,1651.5,-491
11465,2396,2274,0.5,2335.0,122
11466,2032,2142,0.5,2087.0,-110
11467,2124,1864,0.0,1994.0,260
11468,1745,1881,0.0,1813.0,-136
11469,2292,1889,1.0,2090.5,403
11470,1677,2139,0.0,1908.0,-462
11471,2136,1763,1.0,1949.5,373
11472,1618,1890,0.0,1754.0,-272
11473,2171,1766,0.5,1968.5,405
11474,1772,1977,1.0,1874.5,-205
11475,1974,1771,1.0,1872.5,203
11476,1352,1313,1.0,1332.5,39
11477,2101,2107,1.0,2104.0,-6
11478,2093,1841,1.0,1967.0,252
11479,1636,1953,0.0,1794.5,-317
11480,1677,1605,1.0,1641.0,72
11481,1923,1948,0.0,1935.5,-25
11482,2051,1766,1.0,1908.5,285
11483,1716,2081,1.0,1898.5,-365
11484,1874,1453,1.0,1663.5,421
11485,2216,1944,1.0,2080.0,272
11486,1626,2155,0.0,1890.5,-529
11487,2109,1632,1.0,1870.5,477
11488,1638,1877,0.5,1757.5,-239
11489,1962,1429,1.0,1695.5,533
11490,1335,1763,0.5,1549.0,-428
11491,1561,1248,0.0,1404.5,313
11492,1259,1548,1.0,1403.5,-289
11493,1726,1783,1.0,1754.5,-57
11494,1631,1398,1.0,1514.5,233
11495,1564,1626,0.5,1595.0,-62
11496,1272,1490,0.0,1381.0,-218
11497,1911,1827,1.0,1869.0,84
11498,1795,1682,1.0,1738.5,113
11499,1609,1632,0.0,1620.5,-23
11500,1516,1370,1.0,1443.0,146
11501,1628,1720,1.0,1674.0,-92
11502,1712,1944,0.0,1828.0,-232
11503,1442,1685,0.5,1563.5,-243
11504,1631,1594,0.0,1612.5,37
11505,2154,1648,1.0,1901.0,506
11506,1687,1604,1.0,1645.5,83
11507,1593,1653,0.0,1623.0,-60
11508,1644,1289,1.0,1466.5,355
11509,2501,2450,0.5,2475.5,51
11510,2382,2481,0.0,2431.5,-99
11511,2454,2431,0.5,2442.5,23
11512,2297,2406,0.0,2351.5,-109
11513,2403,2497,0.0,2450.0,-94
11514,2477,2346,1.0,2411.5,131
11515,2288,2433,0.0,2360.5,-145
11516,2422,2227,0.5,2324.5,195
11517,2396,2372,1.0,2384.0,24
11518,2364,2148,1.0,2256.0,216
11519,2051,2366,0.0,2208.5,-315
11520,2316,2097,1.0,2206.5,219
11521,2364,2364,0.0,2364.0,0
11522,2289,2254,1.0,2271.5,35
11523,2282,2168,1.0,2225.0,114
11524,2175,2270,0.5,2222.5,-95
11525,2402,2414,1.0,2408.0,-12
11526,2353,2314,1.0,2333.5,39
11527,2210,2411,0.5,2310.5,-201
11528,2325,2013,0.0,2169.0,312
11529,2415,2425,0.5,2420.0,-10
11530,2329,2315,0.5,2322.0,14
11531,2215,2350,1.0,2282.5,-135
11532,2332,2201,0.0,2266.5,131
11533,2263,2351,0.5,2307.0,-88
11534,2266,2200,0.0,2233.0,66
11535,2162,2310,0.0,2236.0,-148
11536,2259,2114,0.5,2186.5,145
11537,2206,2324,0.5,2265.0,-118
11538,2216,2102,1.0,2159.0,114
11539,2059,2284,0.5,2171.5,-225
11540,2005,1808,1.0,1906.5,197
11541,2163,2331,0.0,2247.0,-168
11542,2146,1850,1.0,1998.0,296
11543,1727,2162,0.0,1944.5,-435
11544,2127,1648,1.0,1887.5,479
11545,2463,2321,0.0,2392.0,142
11546,2139,2289,0.5,2214.0,-150
11547,2191,2102,1.0,2146.5,89
11548,1880,2044,0.5,1962.0,-164
11549,2208,2420,0.5,2314.0,-212
11550,2274,2276,0.5,2275.0,-2
11551,2034,2263,0.0,2148.5,-229
11552,1915,2103,0.0,2009.0,-188
11553,2447,2186,1.0,2316.5,261
11554,2246,2257,1.0,2251.5,-11
11555,2121,2103,0.5,2112.0,18
11556,2104,2083,0.5,2093.5,21
11557,1948,2108,0.0,2028.0,-160
11558,2103,2051,0.0,2077.0,52
11559,2081,2050,0.0,2065.5,31
11560,1791,1874,0.5,1832.5,-83
11561,2135,2292,0.0,2213.5,-157
11562,2117,2044,0.0,2080.5,73
11563,2048,2139,0.5,2093.5,-91
11564,2136,2025,1.0,2080.5,111
11565,2187,2099,0.5,2143.0,88
11566,1994,2107,1.0,2050.5,-113
11567,2093,1970,1.0,2031.5,123
11568,1929,1953,0.0,1941.0,-24
11569,2259,2250,0.5,2254.5,9
11570,2008,2100,0.0,2054.0,-92
11571,2049,1880,0.5,1964.5,169
11572,1856,2051,1.0,1953.5,-195
11573,1766,2216,0.0,1991.0,-450
11574,2155,1772,1.0,1963.5,383
11575,1771,2109,0.5,1940.0,-338
11576,1877,1352,0.5,1614.5,525
11577,2271,2077,1.0,2174.0,194
11578,1860,2167,0.0,2013.5,-307
11579,2074,1889,1.0,1981.5,185
11580,1818,2138,0.0,1978.0,-320
11581,1827,2396,0.0,2111.5,-569
11582,2263,1795,1.0,2029.0,468
11583,1632,2124,0.0,1878.0,-492
11584,1881,1516,1.0,1698.5,365
11585,2032,1726,0.5,1879.0,306
11586,1564,1864,0.5,1714.0,-300
11587,1745,1490,1.0,1617.5,255
11588,1220,1513,0.5,1366.5,-293
11589,1429,2171,0.0,1800.0,-742
11590,2048,1335,1.0,1691.5,713
11591,1248,1977,0.0,1612.5,-729
11592,1974,1259,1.0,1616.5,715
11593,1944,1943,1.0,1943.5,1
11594,1841,1626,1.0,1733.5,215
11595,1632,1636,0.5,1634.0,-4
11596,1605,1638,0.0,1621.5,-33
11597,1889,1628,0.5,1758.5,261
11598,1944,1763,1.0,1853.5,181
11599,1594,1442,1.0,1518.0,152
11600,1682,1618,1.0,1650.0,64
11601,1766,1923,0.5,1844.5,-157
11602,1653,1687,0.5,1670.0,-34
11603,1453,1716,1.0,1584.5,-263
11604,1318,1644,0.0,1481.0,-326
11605,1763,1962,0.0,1862.5,-199
11606,1703,1744,1.0,1723.5,-41
11607,1548,1561,0.0,1554.5,-13
11608,1783,1406,0.5,1594.5,377
11609,1682,1911,1.0,1796.5,-229
11610,1626,1631,1.0,1628.5,-5
11611,1370,1609,0.0,1489.5,-239
11612,1720,1272,0.5,1496.0,448
11613,1618,2154,0.5,1886.0,-536
11614,1685,1712,1.0,1698.5,-27
11615,1593,1604,0.0,1598.5,-11
11616,2336,2376,0.5,2356.0,-40
11617,2614,2248,0.5,2431.0,366
11618,2580,2726,0.0,2653.0,-146
11619,2605,2541,0.0,2573.0,64
11620,2650,2566,0.0,2608.0,84
11621,2617,2314,0.5,2465.5,303
11622,2491,2503,0.5,2497.0,-12
11623,2365,2432,1.0,2398.5,-67
11624,2506,2376,0.0,2441.0,130
11625,2352,2464,0.0,2408.0,-112
11626,2407,2261,0.5,2334.0,146
11627,2509,2615,0.5,2562.0,-106
11628,2441,2583,0.5,2512.0,-142
11629,2474,2400,0.5,2437.0,74
11630,2436,2421,0.5,2428.5,15
11631,2230,2315,1.0,2272.5,-85
11632,2317,2419,0.0,2368.0,-102
11633,2276,2302,1.0,2289.0,-26
11634,2204,2256,1.0,2230.0,-52
11635,2179,2370,0.0,2274.5,-191
11636,2425,2202,1.0,2313.5,223
11637,2586,2363,1.0,2474.5,223
11638,2336,2356,0.5,2346.0,-20
11639,2490,2323,1.0,2406.5,167
11640,2102,2378,0.5,2240.0,-276
11641,2264,2292,0.0,2278.0,-28
11642,2377,2109,1.0,2243.0,268
11643,2189,2289,1.0,2239.0,-100
11644,2415,2235,1.0,2325.0,180
11645,1825,2319,0.0,2072.0,-494
11646,2429,2565,0.5,2497.0,-136
11647,2502,2606,0.0,2554.0,-104
11648,2357,2453,0.5,2405.0,-96
11649,2398,1847,1.0,2122.5,551
11650,2533,2444,0.5,2488.5,89
11651,2415,2118,1.0,2266.5,297
11652,2318,2343,0.5,2330.5,-25
11653,2317,2054,1.0,2185.5,263
11654,2234,2297,1.0,2265.5,-63
11655,2268,2438,0.5,2353.0,-170
11656,2797,2816,1.0,2806.5,-19
11657,2698,2763,1.0,2730.5,-65
11658,2785,2687,0.5,2736.0,98
11659,2693,2722,0.5,2707.5,-29
11660,2788,2638,1.0,2713.0,150
11661,2599,2620,0.5,2609.5,-21
11662,2729,2587,1.0,2658.0,142
11663,2616,2634,0.5,2625.0,-18
11664,2712,2778,0.5,2745.0,-66
11665,2746,2656,0.5,2701.0,90
11666,2648,2666,0.5,2657.0,-18
11667,2617,2653,0.5,2635.0,-36
11668,2683,2697,0.0,2690.0,-14
11669,2638,2691,0.0,2664.5,-53
11670,2595,2601,0.5,2598.0,-6
11671,2575,2569,1.0,2572.0,6
11672,2652,2752,0.5,2702.0,-100
11673,2682,2554,0.0,2618.0,128
11674,2469,2681,0.5,2575.0,-212
11675,2596,2508,0.5,2552.0,88
11676,2551,2726,0.5,2638.5,-175
11677,2685,2499,1.0,2592.0,186
11678,2495,2695,0.0,2595.0,-200
11679,2665,2418,1.0,2541.5,247
11680,2737,2717,0.5,2727.0,20
11681,2654,2713,0.0,2683.5,-59
11682,2698,2594,1.0,2646.0,104
11683,2594,2685,0.5,2639.5,-91
11684,2722,2773,0.5,2747.5,-51
11685,2516,2653,1.0,2584.5,-137
11686,2698,2586,1.0,2642.0,112
11687,2520,2635,0.5,2577.5,-115
11688,2523,2769,0.5,2646.0,-246
11689,2734,2514,0.5,2624.0,220
11690,2526,2693,0.0,2609.5,-167
11691,2706,2438,1.0,2572.0,268
11692,2707,2738,0.5,2722.5,-31
11693,2687,2685,0.5,2686.0,2
11694,2664,2642,1.0,2653.0,22
11695,2605,2637,1.0,2621.0,-32
11696,2734,2609,0.5,2671.5,125
11697,2552,2645,0.0,2598.5,-93
11698,2569,2554,1.0,2561.5,15
11699,2552,2468,0.0,2510.0,84
11700,2693,2643,0.5,2668.0,50
11701,2602,2639,0.5,2620.5,-37
11702,2505,2429,0.5,2467.0,76
11703,2448,2518,0.5,2483.0,-70
11704,2521,2578,0.5,2549.5,-57
11705,2585,2481,1.0,2533.0,104
11706,2493,2575,0.0,2534.0,-82
11707,2569,2500,1.0,2534.5,69
11708,2714,2448,1.0,2581.0,266
11709,2429,2652,1.0,2540.5,-223
11710,2644,2431,1.0,2537.5,213
11711,2350,2682,0.5,2516.0,-332
11712,2599,2610,0.5,2604.5,-11
11713,2378,2577,0.5,2477.5,-199
11714,2587,2354,0.5,2470.5,233
11715,2357,2435,0.0,2396.0,-78
11716,2684,2623,0.5,2653.5,61
11717,2617,2617,0.0,2617.0,0
11718,2499,2593,1.0,2546.0,-94
11719,2511,2492,0.0,2501.5,19
11720,2579,2523,1.0,2551.0,56
11721,2448,2553,0.5,2500.5,-105
11722,2532,2472,1.0,2502.0,60
11723,2472,2481,1.0,2476.5,-9
11724,2606,2532,1.0,2569.0,74
11725,2529,2589,0.0,2559.0,-60
11726,2570,2508,1.0,2539.0,62
11727,2486,2482,1.0,2484.0,4
11728,2566,2507,0.5,2536.5,59
11729,2397,2448,1.0,2422.5,-51
11730,2461,2411,1.0,2436.0,50
11731,2378,2418,0.0,2398.0,-40
11732,2725,2542,0.5,2633.5,183
11733,2517,2711,0.0,2614.0,-194
11734,2583,2393,1.0,2488.0,190
11735,2178,2569,0.0,2373.5,-391
11736,2606,2392,1.0,2499.0,214
11737,2373,2618,0.0,2495.5,-245
11738,2623,2244,1.0,2433.5,379
11739,2160,2574,0.0,2367.0,-414
11740,2711,2556,1.0,2633.5,155
11741,2543,2691,0.5,2617.0,-148
11742,2696,2509,0.5,2602.5,187
11743,2448,2608,0.0,2528.0,-160
11744,2670,2515,1.0,2592.5,155
11745,2511,2545,0.5,2528.0,-34
11746,2400,2506,0.0,2453.0,-106
11747,2426,2442,0.5,2434.0,-16
11748,2423,2595,0.0,2509.0,-172
11749,2419,2362,0.0,2390.5,57
11750,2387,2406,1.0,2396.5,-19
11751,2370,2317,0.0,2343.5,53
11752,2645,2267,1.0,2456.0,378
11753,2037,2599,0.0,2318.0,-562
11754,2614,2133,1.0,2373.5,481
11755,2151,2579,0.0,2365.0,-428
11756,2487,2614,0.0,2550.5,-127
11757,2618,2359,1.0,2488.5,259
11758,2283,2548,0.0,2415.5,-265
11759,2612,2383,1.0,2497.5,229
11760,2533,2706,0.0,2619.5,-173
11761,2580,2303,1.0,2441.5,277
11762,2323,2537,1.0,2430.0,-214
11763,2494,2174,1.0,2334.0,320
11764,2414,2595,0.0,2504.5,-181
11765,2469,2363,0.5,2416.0,106
11766,2397,2459,1.0,2428.0,-62
11767,2469,2284,0.5,2376.5,185
11768,2579,2575,0.5,2577.0,4
11769,2533,2458,0.5,2495.5,75
11770,2477,2417,0.5,2447.0,60
11771,2402,2472,0.5,2437.0,-70
11772,2516,2516,0.0,2516.0,0
11773,2437,2514,1.0,2475.5,-77
11774,2480,2402,0.0,2441.0,78
11775,2411,2448,0.5,2429.5,-37
11776,2360,2495,0.5,2427.5,-135
11777,2417,2283,0.5,2350.0,134
11778,2365,2338,0.5,2351.5,27
11779,2354,2195,1.0,2274.5,159
11780,2577,2429,0.5,2503.0,148
11781,2242,2516,1.0,2379.0,-274
11782,2517,2030,1.0,2273.5,487
11783,2081,2498,0.0,2289.5,-417
11784,2446,2562,0.0,2504.0,-116
11785,2570,2421,1.0,2495.5,149
11786,2424,2576,0.5,2500.0,-152
11787,2503,2332,1.0,2417.5,171
11788,2667,2546,0.5,2606.5,121
11789,2285,2582,0.0,2433.5,-297
11790,2528,2245,1.0,2386.5,283
11791,2228,2485,0.5,2356.5,-257
11792,2382,2529,0.0,2455.5,-147
11793,2361,2347,1.0,2354.0,14
11794,2256,2180,1.0,2218.0,76
11795,2451,2326,1.0,2388.5,125
11796,2366,2346,1.0,2356.0,20
11797,2443,2413,0.5,2428.0,30
11798,2278,2344,1.0,2311.0,-66
11799,2536,2454,0.5,2495.0,82
11800,2390,2344,1.0,2367.0,46
11801,2420,2254,1.0,2337.0,166
11802,2210,2181,1.0,2195.5,29
11803,2250,2471,0.0,2360.5,-221
11804,2282,2221,0.5,2251.5,61
11805,2251,2180,1.0,2215.5,71
11806,2171,2081,1.0,2126.0,90
11807,2434,2538,1.0,2486.0,-104
11808,2437,2405,0.5,2421.0,32
11809,2342,2400,0.0,2371.0,-58
11810,2292,2234,0.5,2263.0,58
11811,2357,2354,1.0,2355.5,3
11812,2287,2305,0.0,2296.0,-18
11813,2214,2258,0.0,2236.0,-44
11814,2120,2191,1.0,2155.5,-71
11815,2498,2358,1.0,2428.0,140
11816,2190,2469,0.5,2329.5,-279
11817,2473,2296,1.0,2384.5,177
11818,2178,2348,1.0,2263.0,-170
11819,2120,2257,0.5,2188.5,-137
11820,2159,2209,1.0,2184.0,-50
11821,1915,2213,0.0,2064.0,-298
11822,1882,1986,0.5,1934.0,-104
11823,2493,2446,1.0,2469.5,47
11824,2358,2394,1.0,2376.0,-36
11825,2475,2323,0.5,2399.0,152
11826,2251,2280,1.0,2265.5,-29
11827,2261,2247,1.0,2254.0,14
11828,2144,2158,0.5,2151.0,-14
11829,2282,2393,0.5,2337.5,-111
11830,2237,2316,0.0,2276.5,-79
11831,2278,2259,0.5,2268.5,19
11832,2104,2211,0.0,2157.5,-107
11833,2334,2469,0.5,2401.5,-135
11834,2372,2255,0.0,2313.5,117
11835,2276,2260,0.0,2268.0,16
11836,2203,2227,0.0,2215.0,-24
11837,2398,2249,1.0,2323.5,149
11838,2205,2174,0.5,2189.5,31
11839,2312,2171,1.0,2241.5,141
11840,2207,2149,0.5,2178.0,58
11841,2377,2108,0.0,2242.5,269
11842,1938,2308,0.5,2123.0,-370
11843,2166,2064,1.0,2115.0,102
11844,2205,2209,0.5,2207.0,-4
11845,2115,1790,1.0,1952.5,325
11846,1830,2149,1.0,1989.5,-319
11847,1784,1851,1.0,1817.5,-67
11848,2293,2360,1.0,2326.5,-67
11849,2329,2349,0.0,2339.0,-20
11850,2160,2282,1.0,2221.0,-122
11851,2189,2025,0.5,2107.0,164
11852,2291,2280,0.0,2285.5,11
11853,2275,2211,0.5,2243.0,64
11854,2155,2208,1.0,2181.5,-53
11855,2272,2171,0.0,2221.5,101
11856,2139,2068,1.0,2103.5,71
11857,2081,2205,0.0,2143.0,-124
11858,2273,2270,1.0,2271.5,3
11859,2136,2153,0.0,2144.5,-17
11860,2100,2116,0.0,2108.0,-16
11861,2089,2068,0.0,2078.5,21
11862,2046,2026,1.0,2036.0,20
11863,2137,2110,1.0,2123.5,27
11864,2363,2027,0.0,2195.0,336
11865,2374,2627,0.0,2500.5,-253
11866,2263,2243,0.0,2253.0,20
11867,2198,2345,1.0,2271.5,-147
11868,2424,2019,1.0,2221.5,405
11869,2075,2365,0.0,2220.0,-290
11870,2084,2262,0.0,2173.0,-178
11871,2264,2271,1.0,2267.5,-7
11872,2187,2155,0.5,2171.0,32
11873,2088,2196,0.5,2142.0,-108
11874,2166,2034,0.5,2100.0,132
11875,1964,1973,0.5,1968.5,-9
11876,2126,1812,0.5,1969.0,314
11877,2092,2352,0.0,2222.0,-260
11878,1730,1861,0.0,1795.5,-131
11879,2113,2139,0.0,2126.0,-26
11880,2428,1790,1.0,2109.0,638
11881,2206,2222,0.0,2214.0,-16
11882,2312,2322,1.0,2317.0,-10
11883,2067,2103,1.0,2085.0,-36
11884,2002,2297,0.5,2149.5,-295
11885,2291,2540,1.0,2415.5,-249
11886,1929,1861,0.0,1895.0,68
11887,2133,2193,1.0,2163.0,-60
11888,2260,2156,0.5,2208.0,104
11889,2129,2304,1.0,2216.5,-175
11890,2204,2173,0.0,2188.5,31
11891,2185,2111,0.5,2148.0,74
11892,2030,2206,0.5,2118.0,-176
11893,2088,2185,1.0,2136.5,-97
11894,1975,2066,0.0,2020.5,-91
11895,2030,2089,0.0,2059.5,-59
11896,2099,2144,0.5,2121.5,-45
11897,1967,2066,0.5,2016.5,-99
11898,1893,1995,0.5,1944.0,-102
11899,2091,2118,1.0,2104.5,-27
11900,1958,2127,0.0,2042.5,-169
11901,1992,1831,1.0,1911.5,161
11902,1719,1952,1.0,1835.5,-233
11903,2084,2187,1.0,2135.5,-103
11904,2094,2016,0.5,2055.0,78
11905,1983,1874,0.0,1928.5,109
11906,2014,2104,1.0,2059.0,-90
11907,2041,1910,0.5,1975.5,131
11908,2065,2151,1.0,2108.0,-86
11909,2049,2082,0.0,2065.5,-33
11910,2068,1966,0.0,2017.0,102
11911,1947,2032,0.0,1989.5,-85
11912,1987,2120,1.0,2053.5,-133
11913,2024,1965,1.0,1994.5,59
11914,1801,1823,0.0,1812.0,-22
11915,2072,1895,1.0,1983.5,177
11916,1740,2259,0.0,1999.5,-519
11917,1977,1659,1.0,1818.0,318
11918,2179,2211,1.0,2195.0,-32
11919,1944,1875,1.0,1909.5,69
11920,1893,1923,0.0,1908.0,-30
11921,1922,1663,0.5,1792.5,259
11922,2086,1529,0.0,1807.5,557
11923,1596,1907,1.0,1751.5,-311
11924,2390,1712,0.5,2051.0,678
11925,2362,2398,0.0,2380.0,-36
11926,2265,2228,1.0,2246.5,37
11927,2153,2338,0.0,2245.5,-185
11928,2594,2231,1.0,2412.5,363
11929,2333,2399,0.0,2366.0,-66
11930,2494,2525,1.0,2509.5,-31
11931,2244,2162,0.5,2203.0,82
11932,2788,2484,0.5,2636.0,304
11933,2763,2797,1.0,2780.0,-34
11934,2729,2620,0.5,2674.5,109
11935,2722,2785,0.5,2753.5,-63
11936,2726,2634,0.5,2680.0,92
11937,2698,2816,0.0,2757.0,-118
11938,2695,2685,0.5,2690.0,10
11939,2693,2687,0.5,2690.0,6
11940,2652,2670,0.5,2661.0,-18
11941,2713,2737,1.0,2725.0,-24
11942,2469,2554,1.0,2511.5,-85
11943,2668,2685,0.5,2676.5,-17
11944,2769,2508,1.0,2638.5,261
11945,2601,2697,0.5,2649.0,-96
11946,2709,2734,0.5,2721.5,-25
11947,2575,2581,0.5,2578.0,-6
11948,2734,2693,0.5,2713.5,41
11949,2656,2712,1.0,2684.0,-56
11950,2569,2645,1.0,2607.0,-76
11951,2610,2648,1.0,2629.0,-38
11952,2606,2468,0.5,2537.0,138
11953,2685,2707,0.5,2696.0,-22
11954,2570,2589,1.0,2579.5,-19
11955,2637,2664,1.0,2650.5,-27
11956,2778,2589,1.0,2683.5,189
11957,2577,2599,0.0,2588.0,-22
11958,2666,2746,1.0,2706.0,-80
11959,2543,2587,0.5,2565.0,-44
11960,2738,2598,0.5,2668.0,140
11961,2714,2686,0.0,2700.0,28
11962,2638,2687,0.5,2662.5,-49
11963,2644,2652,1.0,2648.0,-8
11964,2659,2605,0.5,2632.0,54
11965,2653,2722,0.5,2687.5,-69
11966,2575,2578,0.0,2576.5,-3
11967,2635,2698,0.5,2666.5,-63
11968,2579,2569,0.5,2574.0,10
11969,2617,2684,1.0,2650.5,-67
11970,2532,2553,0.0,2542.5,-21
11971,2492,2499,0.5,2495.5,-7
11972,2773,2481,1.0,2627.0,292
11973,2494,2566,1.0,2530.0,-72
11974,2542,2516,0.5,2529.0,26
11975,2418,2461,1.0,2439.5,-43
11976,2638,2520,0.5,2579.0,118
11977,2618,2606,0.5,2612.0,12
11978,2599,2614,0.5,2606.5,-15
11979,2574,2589,0.5,2581.5,-15
11980,2551,2616,0.5,2583.5,-65
11981,2691,2683,1.0,2687.0,8
11982,2423,2499,0.5,2461.0,-76
11983,2569,2619,0.0,2594.0,-50
11984,2516,2418,0.0,2467.0,98
11985,2537,2706,1.0,2621.5,-169
11986,2402,2437,0.5,2419.5,-35
11987,2494,2404,0.0,2449.0,90
11988,2643,2411,0.0,2527.0,232
11989,2599,2645,0.0,2622.0,-46
11990,2453,2602,0.0,2527.5,-149
11991,2579,2614,1.0,2596.5,-35
11992,2752,2429,1.0,2590.5,323
11993,2691,2711,0.5,2701.0,-20
11994,2596,2681,0.0,2638.5,-85
11995,2630,2608,1.0,2619.0,22
11996,2717,2563,1.0,2640.0,154
11997,2514,2523,1.0,2518.5,-9
11998,2635,2654,1.0,2644.5,-19
11999,2526,2479,0.0,2502.5,47
12000,2639,2594,0.5,2616.5,45
12001,2362,2423,0.0,2392.5,-61
12002,2505,2506,0.5,2505.5,-1
12003,2317,2387,1.0,2352.0,-70
12004,2495,2518,0.0,2506.5,-23
12005,2618,2614,0.5,2616.0,4
12006,2338,2417,0.5,2377.5,-79
12007,2612,2548,1.0,2580.0,64
12008,2609,2354,0.5,2481.5,255
12009,2576,2562,0.0,2569.0,14
12010,2554,2552,1.0,2553.0,2
12011,2503,2511,0.0,2507.0,-8
12012,2532,2552,0.5,2542.0,-20
12013,2384,2529,0.0,2456.5,-145
12014,2508,2529,1.0,2518.5,-21
12015,2523,2486,0.0,2504.5,37
12016,2582,2667,0.5,2624.5,-85
12017,2472,2448,0.5,2460.0,24
12018,2523,2528,1.0,2525.5,-5
12019,2623,2418,0.5,2520.5,205
12020,2513,2595,0.5,2554.0,-82
12021,2593,2582,1.0,2587.5,11
12022,2469,2469,0.5,2469.0,0
12023,2575,2511,0.0,2543.0,64
12024,2363,2414,0.0,2388.5,-51
12025,2498,2533,1.0,2515.5,-35
12026,2284,2306,1.0,2295.0,-22
12027,2471,2417,0.5,2444.0,54
12028,2516,2577,0.5,2546.5,-61
12029,2282,2345,0.0,2313.5,-63
12030,2498,2496,1.0,2497.0,2
12031,2507,2171,0.5,2339.0,336
12032,2448,2638,0.0,2543.0,-190
12033,2411,2397,0.0,2404.0,14
12034,2350,2429,0.5,2389.5,-79
12035,2521,2360,0.5,2440.5,161
12036,2525,2594,1.0,2559.5,-69
12037,2493,2481,0.5,2487.0,12
12038,2494,2471,0.0,2482.5,23
12039,2515,2398,1.0,2456.5,117
12040,2458,2579,0.5,2518.5,-121
12041,2506,2511,0.0,2508.5,-5
12042,2472,2503,1.0,2487.5,-31
12043,2227,2426,0.0,2326.5,-199
12044,2498,2670,1.0,2584.0,-172
12045,2442,2545,1.0,2493.5,-103
12046,2454,2519,0.0,2486.5,-65
12047,2446,2390,1.0,2418.0,56
12048,2254,2493,0.5,2373.5,-239
12049,2394,2210,0.5,2302.0,184
12050,2326,2498,0.5,2412.0,-172
12051,2469,2366,0.5,2417.5,103
12052,2413,2473,0.0,2443.0,-60
12053,2420,2278,1.0,2349.0,142
12054,2610,2178,1.0,2394.0,432
12055,2209,2354,0.0,2281.5,-145
12056,2357,2159,1.0,2258.0,198
12057,2213,2190,0.5,2201.5,23
12058,2459,2267,1.0,2363.0,192
12059,2037,2362,0.0,2199.5,-325
12060,2338,2133,0.5,2235.5,205
12061,2226,2153,0.5,2189.5,73
12062,2116,2507,0.0,2311.5,-391
12063,2303,2045,1.0,2174.0,258
12064,2174,2323,1.0,2248.5,-149
12065,2538,2543,1.0,2540.5,-5
12066,2509,2437,0.5,2473.0,72
12067,2061,2448,0.0,2254.5,-387
12068,2375,2400,1.0,2387.5,-25
12069,2627,2357,1.0,2492.0,270
12070,2305,2415,1.0,2360.0,-110
12071,2345,2191,0.5,2268.0,154
12072,2354,2198,0.5,2276.0,156
12073,2405,2434,1.0,2419.5,-29
12074,2297,2258,0.0,2277.5,39
12075,2234,2342,0.0,2288.0,-108
12076,2542,2120,1.0,2331.0,422
12077,2283,2360,0.5,2321.5,-77
12078,2393,2517,1.0,2455.0,-124
12079,2195,2365,0.0,2280.0,-170
12080,2595,2178,0.5,2386.5,417
12081,2180,2349,0.0,2264.5,-169
12082,2406,2419,1.0,2412.5,-13
12083,2025,2160,0.0,2092.5,-135
12084,2429,2370,0.5,2399.5,59
12085,2316,2282,0.5,2299.0,34
12086,2155,2242,0.5,2198.5,-87
12087,2137,2278,1.0,2207.5,-141
12088,2516,2081,0.0,2298.5,435
12089,2359,2487,0.5,2423.0,-128
12090,2462,2480,0.5,2471.0,-18
12091,2057,2283,0.0,2170.0,-226
12092,2068,2448,0.0,2258.0,-380
12093,2365,2424,1.0,2394.5,-59
12094,2270,2139,0.5,2204.5,131
12095,2262,2370,1.0,2316.0,-108
12096,2392,2273,0.5,2332.5,119
12097,2255,2334,0.5,2294.5,-79
12098,2244,2244,1.0,2244.0,0
12099,2227,2237,1.0,2232.0,-10
12100,2398,2160,0.5,2279.0,238
12101,2110,2046,1.0,2078.0,64
12102,2312,2174,0.0,2243.0,138
12103,2060,2137,0.5,2098.5,-77
12104,2280,2149,0.0,2214.5,131
12105,2344,2536,1.0,2440.0,-192
12106,2208,2275,0.5,2241.5,-67
12107,2218,2420,0.0,2319.0,-202
12108,2322,2044,1.0,2183.0,278
12109,1986,1915,0.5,1950.5,71
12110,2245,2285,1.0,2265.0,-40
12111,2540,2228,0.5,2384.0,312
12112,2346,2451,1.0,2398.5,-105
12113,2193,2291,0.5,2242.0,-98
12114,2378,2344,1.0,2361.0,34
12115,2358,2133,0.5,2245.5,225
12116,2251,2221,1.0,2236.0,30
12117,2062,2190,1.0,2126.0,-128
12118,2081,2101,0.0,2091.0,-20
12119,2323,2296,0.0,2309.5,27
12120,2308,2377,0.0,2342.5,-69
12121,2247,2251,1.0,2249.0,-4
12122,2209,2166,0.5,2187.5,43
12123,2126,2144,0.5,2135.0,-18
12124,2256,2347,0.5,2301.5,-91
12125,1730,1861,0.0,1795.5,-131
12126,2252,2180,1.0,2216.0,72
12127,2291,1790,1.0,2040.5,501
12128,2424,2421,1.0,2422.5,3
12129,2155,2211,0.0,2183.0,-56
12130,2360,2332,0.5,2346.0,28
12131,2271,2129,1.0,2200.0,142
12132,2120,2257,0.0,2188.5,-137
12133,2155,2264,0.5,2209.5,-109
12134,2322,2428,0.5,2375.0,-106
12135,2297,2312,1.0,2304.5,-15
12136,2108,2115,0.5,2111.5,-7
12137,1938,1827,1.0,1882.5,111
12138,2206,2205,1.0,2205.5,1
12139,1973,2088,0.5,2030.5,-115
12140,2066,2088,1.0,2077.0,-22
12141,1812,1964,1.0,1888.0,-152
12142,1790,2030,0.5,1910.0,-240
12143,2099,2144,0.5,2121.5,-45
12144,1912,1830,0.5,1871.0,82
12145,1893,2066,0.0,1979.5,-173
12146,2118,1784,0.0,1951.0,334
12147,2129,2156,0.5,2142.5,-27
12148,1956,2173,0.5,2064.5,-217
12149,2153,1897,1.0,2025.0,256
12150,2469,2104,1.0,2286.5,365
12151,2014,2354,0.0,2184.0,-340
12152,2260,1941,1.0,2100.5,319
12153,2416,2203,0.5,2309.5,213
12154,2243,2363,1.0,2303.0,-120
12155,2171,2249,0.0,2210.0,-78
12156,2004,2263,0.0,2133.5,-259
12157,2205,2272,1.0,2238.5,-67
12158,1952,1992,0.0,1972.0,-40
12159,2153,2081,1.0,2117.0,72
12160,2393,2136,0.5,2264.5,257
12161,2133,2259,1.0,2196.0,-126
12162,2243,2068,1.0,2155.5,175
12163,2026,2104,0.0,2065.0,-78
12164,1883,2072,1.0,1977.5,-189
12165,2032,1788,1.0,1910.0,244
12166,2314,2072,1.0,2193.0,242
12167,2282,2329,1.0,2305.5,-47
12168,2187,2189,0.0,2188.0,-2
12169,1977,2259,0.5,2118.0,-282
12170,1874,2094,1.0,1984.0,-220
12171,2179,2211,1.0,2195.0,-32
12172,2196,2075,0.5,2135.5,121
12173,2304,2260,0.5,2282.0,44
12174,1967,2255,0.5,2111.0,-288
12175,2034,2185,1.0,2109.5,-151
12176,1975,2166,0.5,2070.5,-191
12177,2021,2089,0.0,2055.0,-68
12178,2352,2120,0.5,2236.0,232
12179,2007,2092,0.0,2049.5,-85
12180,2139,1987,1.0,2063.0,152
12181,1823,2113,0.0,1968.0,-290
12182,1903,2002,0.0,1952.5,-99
12183,1861,1947,0.0,1904.0,-86
12184,2024,1929,1.0,1976.5,95
12185,2222,1895,1.0,2058.5,327
12186,1923,1944,0.0,1933.5,-21
12187,2103,2206,1.0,2154.5,-103
12188,1529,1893,0.0,1711.0,-364
12189,1983,2084,1.0,2033.5,-101
12190,1712,1725,0.0,1718.5,-13
12191,1875,2091,0.0,1983.0,-216
12192,1663,1810,1.0,1736.5,-147
12193,2049,2151,1.0,2100.0,-102
12194,1765,1966,0.0,1865.5,-201
12195,1938,1596,1.0,1767.0,342
12196,1659,1719,0.0,1689.0,-60
12197,1910,2025,1.0,1967.5,-115
12198,2086,2088,1.0,2087.0,-2
12199,2711,1907,1.0,2309.0,804
12200,2298,2390,0.5,2344.0,-92
12201,2583,2626,1.0,2604.5,-43
12202,2231,2265,0.0,2248.0,-34
12203,2399,2569,0.5,2484.0,-170
12204,2280,2475,0.0,2377.5,-195
12205,2244,2333,1.0,2288.5,-89
12206,2212,2261,1.0,2236.5,-49
12207,2797,2121,0.5,2459.0,676
12208,2734,2769,0.5,2751.5,-35
12209,2785,2763,1.0,2774.0,22
12210,2706,2709,0.5,2707.5,-3
12211,2726,2730,0.5,2728.0,-4
12212,2729,2788,1.0,2758.5,-59
12213,2695,2685,1.0,2690.0,10
12214,2613,2634,0.5,2623.5,-21
12215,2816,2670,0.5,2743.0,146
12216,2617,2684,0.5,2650.5,-67
12217,2687,2698,1.0,2692.5,-11
12218,2492,2499,0.0,2495.5,-7
12219,2566,2693,0.0,2629.5,-127
12220,2666,2746,1.0,2706.0,-80
12221,2448,2494,0.5,2471.0,-46
12222,2598,2617,0.5,2607.5,-19
12223,2712,2418,1.0,2565.0,294
12224,2713,2737,0.5,2725.0,-24
12225,2653,2656,0.5,2654.5,-3
12226,2668,2698,0.5,2683.0,-30
12227,2722,2610,0.5,2666.0,112
12228,2554,2652,1.0,2603.0,-98
12229,2698,2653,0.0,2675.5,45
12230,2508,2469,0.5,2488.5,39
12231,2686,2555,0.5,2620.5,131
12232,2711,2725,0.5,2718.0,-14
12233,2644,2714,0.5,2679.0,-70
12234,2569,2626,0.0,2597.5,-57
12235,2707,2682,0.0,2694.5,25
12236,2614,2645,0.5,2629.5,-31
12237,2664,2685,0.5,2674.5,-21
12238,2579,2549,0.0,2564.0,30
12239,2697,2550,0.5,2623.5,147
12240,2687,2738,1.0,2712.5,-51
12241,2601,2638,0.0,2619.5,-37
12242,2638,2642,1.0,2640.0,-4
12243,2706,2575,0.5,2640.5,131
12244,2691,2711,0.5,2701.0,-20
12245,2537,2580,0.0,2558.5,-43
12246,2608,2696,1.0,2652.0,-88
12247,2614,2404,0.0,2509.0,210
12248,2589,2606,0.5,2597.5,-17
12249,2548,2618,0.0,2583.0,-70
12250,2482,2570,0.5,2526.0,-88
12251,2638,2612,0.5,2625.0,26
12252,2635,2717,0.5,2676.0,-82
12253,2587,2614,0.0,2600.5,-27
12254,2594,2594,0.5,2594.0,0
12255,2606,2616,0.5,2611.0,-10
12256,2552,2609,0.5,2580.5,-57
12257,2623,2618,0.5,2620.5,5
12258,2552,2554,0.5,2553.0,-2
12259,2683,2574,0.5,2628.5,109
12260,2645,2734,0.0,2689.5,-89
12261,2619,2691,0.5,2655.0,-72
12262,2396,2569,0.5,2482.5,-173
12263,2423,2595,0.0,2509.0,-172
12264,2578,2659,1.0,2618.5,-81
12265,2317,2387,0.0,2352.0,-70
12266,2569,2585,0.5,2577.0,-16
12267,2670,2299,0.5,2484.5,371
12268,2553,2579,0.5,2566.0,-26
12269,2545,2498,1.0,2521.5,47
12270,2481,2532,0.5,2506.5,-51
12271,2532,2442,0.5,2487.0,90
12272,2617,2623,1.0,2620.0,-6
12273,2508,2529,0.0,2518.5,-21
12274,2593,2582,0.5,2587.5,11
12275,2519,2486,0.5,2502.5,33
12276,2586,2516,1.0,2551.0,70
12277,2493,2446,0.5,2469.5,47
12278,2520,2542,1.0,2531.0,-22
12279,2667,2394,1.0,2530.5,273
12280,2499,2551,0.0,2525.0,-52
12281,2528,2582,1.0,2555.0,-54
12282,2418,2423,1.0,2420.5,-5
12283,2599,2485,0.0,2542.0,114
12284,2639,2693,1.0,2666.0,-54
12285,2543,2587,0.5,2565.0,-44
12286,2505,2506,0.5,2505.5,-1
12287,2579,2435,0.0,2507.0,144
12288,2378,2610,1.0,2494.0,-232
12289,2477,2503,1.0,2490.0,-26
12290,2357,2354,0.0,2355.5,3
12291,2498,2472,0.5,2485.0,26
12292,2517,2516,1.0,2516.5,1
12293,2473,2469,0.5,2471.0,4
12294,2498,2496,1.0,2497.0,2
12295,2516,2420,0.0,2468.0,96
12296,2682,2752,0.5,2717.0,-70
12297,2411,2402,0.0,2406.5,9
12298,2596,2681,1.0,2638.5,-85
12299,2523,2397,0.5,2460.0,126
12300,2517,2542,1.0,2529.5,-25
12301,2479,2514,0.0,2496.5,-35
12302,2178,2393,0.0,2285.5,-215
12303,2638,2526,0.5,2582.0,112
12304,2525,2594,1.0,2559.5,-69
12305,2431,2429,1.0,2430.0,2
12306,2484,2471,0.5,2477.5,13
12307,2507,2350,0.5,2428.5,157
12308,2398,2459,1.0,2428.5,-61
12309,2378,2397,1.0,2387.5,-19
12310,2338,2362,0.0,2350.0,-24
12311,2414,2360,1.0,2387.0,54
12312,2493,2521,0.0,2507.0,-28
12313,2306,2397,0.0,2351.5,-91
12314,2398,2500,0.5,2449.0,-102
12315,2533,2284,0.5,2408.5,249
12316,2405,2434,0.0,2419.5,-29
12317,2303,2507,0.5,2405.0,-204
12318,2197,2342,1.0,2269.5,-145
12319,2548,2323,0.0,2435.5,225
12320,2533,2575,1.0,2554.0,-42
12321,2365,2424,1.0,2394.5,-59
12322,2402,2498,0.0,2450.0,-96
12323,2316,2370,0.0,2343.0,-54
12324,2602,2643,1.0,2622.5,-41
12325,2211,2278,0.0,2244.5,-67
12326,2448,2453,1.0,2450.5,-5
12327,2627,2137,1.0,2382.0,490
12328,2417,2395,1.0,2406.0,22
12329,2374,2415,1.0,2394.5,-41
12330,2354,2338,0.0,2346.0,16
12331,2556,2198,0.5,2377.0,358
12332,2419,2595,0.0,2507.0,-176
12333,2448,2509,1.0,2478.5,-61
12334,2370,2406,1.0,2388.0,-36
12335,2562,2375,1.0,2468.5,187
12336,2046,2227,0.0,2136.5,-181
12337,2576,2570,1.0,2573.0,6
12338,2595,2511,0.0,2553.0,84
12339,2421,2446,0.0,2433.5,-25
12340,2469,2513,1.0,2491.0,-44
12341,2360,2332,0.0,2346.0,28
12342,2487,2459,1.0,2473.0,28
12343,2511,2515,0.0,2513.0,-4
12344,2283,2359,0.5,2321.0,-76
12345,2375,2506,0.0,2440.5,-131
12346,1790,2383,0.0,2086.5,-593
12347,2448,2523,1.0,2485.5,-75
12348,1912,1830,0.0,1871.0,82
12349,2418,2472,1.0,2445.0,-54
12350,2536,1784,1.0,2160.0,752
12351,2366,2326,0.0,2346.0,40
12352,2420,2344,1.0,2382.0,76
12353,2239,2413,1.0,2326.0,-174
12354,2178,2218,0.0,2198.0,-40
12355,2345,2471,0.0,2408.0,-126
12356,2147,2159,0.5,2153.0,-12
12357,2180,2282,0.5,2231.0,-102
12358,2334,2213,0.0,2273.5,121
12359,2322,2546,0.0,2434.0,-224
12360,2237,2255,0.5,2246.0,-18
12361,2228,2245,1.0,2236.5,-17
12362,2529,2227,1.0,2378.0,302
12363,2346,2451,0.0,2398.5,-105
12364,2361,2384,1.0,2372.5,-23
12365,2378,2443,0.5,2410.5,-65
12366,2390,2516,1.0,2453.0,-126
12367,2514,2254,1.0,2384.0,260
12368,2210,2462,0.0,2336.0,-252
12369,2448,2153,1.0,2300.5,295
12370,2382,2428,0.5,2405.0,-46
12371,2322,2256,1.0,2289.0,66
12372,2180,2312,1.0,2246.0,-132
12373,2297,2252,1.0,2274.5,45
12374,2358,2392,1.0,2375.0,-34
12375,2373,2190,0.0,2281.5,183
12376,2296,2244,0.0,2270.0,52
12377,2156,2323,1.0,2239.5,-167
12378,2251,2173,0.5,2212.0,78
12379,2185,2221,1.0,2203.0,-36
12380,2144,2153,0.0,2148.5,-9
12381,2469,2206,1.0,2337.5,263
12382,2066,2354,0.0,2210.0,-288
12383,2260,2030,0.5,2145.0,230
12384,1824,2203,0.0,2013.5,-379
12385,2357,2360,0.0,2358.5,-3
12386,2283,2305,0.5,2294.0,-22
12387,2214,2365,0.5,2289.5,-151
12388,2245,2191,0.0,2218.0,54
12389,2259,2354,0.0,2306.5,-95
12390,2287,1977,1.0,2132.0,310
12391,2211,2297,0.5,2254.0,-86
12392,2120,2179,1.0,2149.5,-59
12393,2429,2538,0.5,2483.5,-109
12394,2437,2242,0.0,2339.5,195
12395,2030,2400,0.0,2215.0,-370
12396,2292,2155,0.5,2223.5,137
12397,2267,2314,1.0,2290.5,-47
12398,2360,2133,1.0,2246.5,227
12399,2226,2282,1.0,2254.0,-56
12400,2189,2151,1.0,2170.0,38
12401,2115,2398,0.0,2256.5,-283
12402,2174,2149,1.0,2161.5,25
12403,2149,2312,1.0,2230.5,-163
12404,2293,2116,1.0,2204.5,177
12405,2100,2349,0.0,2224.5,-249
12406,2180,2025,0.5,2102.5,155
12407,2108,2068,0.5,2088.0,40
12408,2139,1827,1.0,1983.0,312
12409,2064,2270,0.0,2167.0,-206
12410,2072,2205,0.0,2138.5,-133
12411,2243,2363,0.0,2303.0,-120
12412,2019,2263,0.0,2141.0,-244
12413,2272,2032,0.0,2152.0,240
12414,2237,2393,1.0,2315.0,-156
12415,2081,2205,0.0,2143.0,-124
12416,2243,2259,1.0,2251.0,-16
12417,2250,2153,1.0,2201.5,97
12418,1730,1861,0.5,1795.5,-131
12419,2101,2251,1.0,2176.0,-150
12420,1790,1719,0.0,1754.5,71
12421,2377,2081,1.0,2229.0,296
12422,2209,2166,1.0,2187.5,43
12423,2475,2171,1.0,2323.0,304
12424,2211,2291,0.0,2251.0,-80
12425,2212,2261,1.0,2236.5,-49
12426,2129,2171,0.0,2150.0,-42
12427,2206,2222,0.5,2214.0,-16
12428,2067,2067,0.5,2067.0,0
12429,2144,2196,1.0,2170.0,-52
12430,1973,2088,0.5,2030.5,-115
12431,2066,2099,1.0,2082.5,-33
12432,1812,1964,1.0,1888.0,-152
12433,2257,1893,0.5,2075.0,364
12434,1986,1915,0.0,1950.5,71
12435,2041,2120,1.0,2080.5,-79
12436,2030,2540,0.0,2285.0,-510
12437,2291,1975,0.0,2133.0,316
12438,2089,2193,0.0,2141.0,-104
12439,2133,1981,0.5,2057.0,152
12440,2280,1947,1.0,2113.5,333
12441,1965,2275,0.0,2120.0,-310
12442,2208,2024,0.5,2116.0,184
12443,1895,2044,0.0,1969.5,-149
12444,2352,2092,0.5,2222.0,260
12445,2139,2113,0.0,2126.0,26
12446,1883,2025,0.0,1954.0,-142
12447,2136,2118,0.5,2127.0,18
12448,2089,2133,1.0,2111.0,-44
12449,1956,2127,0.5,2041.5,-171
12450,2104,2026,0.0,2065.0,78
12451,2249,2416,1.0,2332.5,-167
12452,1941,2014,0.0,1977.5,-73
12453,2207,2205,1.0,2206.0,2
12454,1992,2016,0.5,2004.0,-24
12455,1983,1952,1.0,1967.5,31
12456,1834,1725,1.0,1779.5,109
12457,2094,2187,0.5,2140.5,-93
12458,1719,1874,0.0,1796.5,-155
12459,2151,2072,1.0,2111.5,79
12460,2068,2049,0.5,2058.5,19
12461,2091,1938,0.0,2014.5,153
12462,1958,2084,0.5,2021.0,-126
12463,2143,1810,0.0,1976.5,333
12464,2002,2034,0.5,2018.0,-32
12465,2166,1929,1.0,2047.5,237
12466,1678,2021,1.0,1849.5,-343
12467,2120,2304,0.0,2212.0,-184
12468,2255,2007,1.0,2131.0,248
12469,1987,2204,0.5,2095.5,-217
12470,2111,1823,1.0,1967.0,288
12471,1944,2086,0.0,2015.0,-142
12472,1907,1923,1.0,1915.0,-16
12473,1893,1848,0.0,1870.5,45
12474,1659,1740,1.0,1699.5,-81
12475,1765,1542,0.0,1653.5,223
12476,1875,1596,1.0,1735.5,279
12477,1663,1712,0.0,1687.5,-49
12478,2046,1922,0.0,1984.0,124
12479,2228,2390,1.0,2309.0,-162
12480,2137,2110,0.5,2123.5,27
12481,2231,2298,1.0,2264.5,-67
12482,2172,2060,0.5,2116.0,112
12483,2333,2399,0.0,2366.0,-66
12484,2264,2271,1.0,2267.5,-7
12485,2244,2162,1.0,2203.0,82
12486,2778,2187,1.0,2482.5,591
12487,2763,2797,0.0,2780.0,-34
12488,2666,2746,0.5,2706.0,-80
12489,2722,2785,1.0,2753.5,-63
12490,2652,2598,0.5,2625.0,54
12491,2695,2726,1.0,2710.5,-31
12492,2469,2554,0.0,2511.5,-85
12493,2665,2670,1.0,2667.5,-5
12494,2816,2508,1.0,2662.0,308
12495,2656,2712,0.5,2684.0,-56
12496,2687,2698,1.0,2692.5,-11
12497,2653,2648,1.0,2650.5,5
12498,2717,2693,1.0,2705.0,24
12499,2729,2788,1.0,2758.5,-59
12500,2594,2635,0.5,2614.5,-41
12501,2613,2634,0.5,2623.5,-21
12502,2769,2594,1.0,2681.5,175
12503,2714,2686,0.5,2700.0,28
12504,2693,2734,0.5,2713.5,-41
12505,2682,2652,0.0,2667.0,30
12506,2711,2706,0.5,2708.5,5
12507,2687,2738,0.0,2712.5,-51
12508,2696,2691,0.5,2693.5,5
12509,2605,2642,0.0,2623.5,-37
12510,2645,2608,0.0,2626.5,37
12511,2589,2606,0.5,2597.5,-17
12512,2614,2599,0.5,2606.5,15
12513,2589,2570,0.5,2579.5,19
12514,2737,2549,0.5,2643.0,188
12515,2586,2773,0.5,2679.5,-187
12516,2698,2713,1.0,2705.5,-15
12517,2520,2542,0.0,2531.0,-22
12518,2659,2685,0.5,2672.0,-26
12519,2685,2707,0.5,2696.0,-22
12520,2585,2578,0.0,2581.5,7
12521,2550,2637,0.0,2593.5,-87
12522,2693,2575,1.0,2634.0,118
12523,2698,2722,0.5,2710.0,-24
12524,2506,2639,1.0,2572.5,-133
12525,2555,2635,0.5,2595.0,-80
12526,2684,2505,0.5,2594.5,179
12527,2552,2609,0.0,2580.5,-57
12528,2499,2617,0.5,2558.0,-118
12529,2552,2554,1.0,2553.0,-2
12530,2670,2454,0.0,2562.0,216
12531,2691,2683,1.0,2687.0,8
12532,2545,2498,0.0,2521.5,47
12533,2595,2619,1.0,2607.0,-24
12534,2623,2442,0.5,2532.5,181
12535,2582,2667,0.5,2624.5,-85
12536,2582,2617,0.0,2599.5,-35
12537,2523,2528,0.5,2525.5,-5
12538,2577,2593,0.5,2585.0,-16
12539,2494,2566,1.0,2530.0,-72
12540,2496,2517,1.0,2506.5,-21
12541,2418,2461,0.0,2439.5,-43
12542,2725,2498,1.0,2611.5,227
12543,2580,2706,0.5,2643.0,-126
12544,2626,2711,1.0,2668.5,-85
12545,2404,2537,0.0,2470.5,-133
12546,2752,2583,1.0,2667.5,169
12547,2363,2414,1.0,2388.5,-51
12548,2681,2682,1.0,2681.5,-1
12549,2306,2397,0.0,2351.5,-91
12550,2542,2596,0.0,2569.0,-54
12551,2623,2618,0.5,2620.5,5
12552,2393,2517,0.0,2455.0,-124
12553,2574,2589,1.0,2581.5,-15
12554,2697,2178,1.0,2437.5,519
12555,2503,2458,1.0,2480.5,45
12556,2581,2638,0.5,2609.5,-57
12557,2472,2477,0.0,2474.5,-5
12558,2556,2575,0.5,2565.5,-19
12559,2618,2614,1.0,2616.0,4
12560,2509,2543,0.0,2526.0,-34
12561,2554,2612,0.5,2583.0,-58
12562,2643,2448,0.5,2545.5,195
12563,2614,2638,0.5,2626.0,-24
12564,2429,2602,0.0,2515.5,-173
12565,2616,2599,1.0,2607.5,17
12566,2610,2448,1.0,2529.0,162
12567,2397,2507,1.0,2452.0,-110
12568,2354,2378,0.5,2366.0,-24
12569,2360,2378,0.5,2369.0,-18
12570,2734,2357,1.0,2545.5,377
12571,2577,2599,0.0,2588.0,-22
12572,2569,2645,1.0,2607.0,-76
12573,2435,2543,0.5,2489.0,-108
12574,2519,2468,0.5,2493.5,51
12575,2570,2562,1.0,2566.0,8
12576,2493,2446,0.5,2469.5,47
12577,2503,2576,1.0,2539.5,-73
12578,2434,2358,0.5,2396.0,76
12579,2529,2532,1.0,2530.5,-3
12580,2342,2405,0.0,2373.5,-63
12581,2486,2508,1.0,2497.0,-22
12582,2579,2197,1.0,2388.0,382
12583,2384,2529,0.0,2456.5,-145
12584,2532,2553,0.5,2542.5,-21
12585,2575,2481,0.5,2528.0,94
12586,2362,2423,0.5,2392.5,-61
12587,2498,2533,0.5,2515.5,-35
12588,2299,2387,0.5,2343.0,-88
12589,2551,2417,0.0,2484.0,134
12590,2448,2638,0.5,2543.0,-190
12591,2423,2495,1.0,2459.0,-72
12592,2431,2429,0.0,2430.0,2
12593,2595,2418,1.0,2506.5,177
12594,2365,2548,1.0,2456.5,-183
12595,2459,2513,0.5,2486.0,-54
12596,2262,2370,0.0,2316.0,-108
12597,2594,2469,1.0,2531.5,125
12598,2448,2523,1.0,2485.5,-75
12599,2494,2525,0.0,2509.5,-31
12600,2472,2472,1.0,2472.0,0
12601,2546,2484,0.0,2515.0,62
12602,2344,2536,1.0,2440.0,-192
12603,2245,2285,0.0,2265.0,-40
12604,2181,2420,0.5,2300.5,-239
12605,2156,2228,1.0,2192.0,-72
12606,2473,2469,1.0,2471.0,4
12607,2185,2129,0.0,2157.0,56
12608,2348,2420,1.0,2384.0,-72
12609,2487,2153,1.0,2320.0,334
12610,2507,2533,1.0,2520.0,-26
12611,2283,2359,1.0,2321.0,-76
12612,2174,2303,0.0,2238.5,-129
12613,2428,2383,0.0,2405.5,45
12614,2480,2514,0.5,2497.0,-34
12615,2312,2322,0.5,2317.0,-10
12616,2448,2462,0.0,2455.0,-14
12617,2595,2297,1.0,2446.0,298
12618,2271,2172,1.0,2221.5,99
12619,2406,2419,1.0,2412.5,-13
12620,2155,2264,0.0,2209.5,-109
12621,2523,2370,1.0,2446.5,153
12622,2190,2358,0.0,2274.0,-168
12623,2526,2479,1.0,2502.5,47
12624,2471,2438,1.0,2454.5,33
12625,2316,2282,0.5,2299.0,34
12626,2282,2345,1.0,2313.5,-63
12627,2137,2278,0.0,2207.5,-141
12628,2398,2171,0.0,2284.5,227
12629,2437,2516,1.0,2476.5,-79
12630,2338,2362,0.0,2350.0,-24
12631,2411,2402,0.5,2406.5,9
12632,2495,2153,0.5,2324.0,342
12633,2237,2393,0.0,2315.0,-156
12634,2338,2417,1.0,2377.5,-79
12635,2104,2243,0.0,2173.5,-139
12636,2354,2354,0.0,2354.0,0
12637,2481,2521,0.5,2501.0,-40
12638,2258,2287,0.0,2272.5,-29
12639,2398,2500,0.0,2449.0,-102
12640,2398,2120,0.0,2259.0,278
12641,2159,2209,1.0,2184.0,-50
12642,2312,2174,0.0,2243.0,138
12643,2213,2147,1.0,2180.0,66
12644,2293,2149,0.0,2221.0,144
12645,2372,2469,0.5,2420.5,-97
12646,2180,2349,1.0,2264.5,-169
12647,2203,2260,0.5,2231.5,-57
12648,2068,2160,0.5,2114.0,-92
12649,2244,2373,0.5,2308.5,-129
12650,2273,2139,1.0,2206.0,134
12651,2160,2244,0.0,2202.0,-84
12652,2382,2046,1.0,2214.0,336
12653,2110,2347,1.0,2228.5,-237
12654,2256,2137,1.0,2196.5,119
12655,2027,2180,1.0,2103.5,-153
12656,2515,2072,1.0,2293.5,443
12657,2065,2506,0.0,2285.5,-441
12658,2426,2082,1.0,2254.0,344
12659,2446,2375,1.0,2410.5,71
12660,2366,2326,0.0,2346.0,40
12661,2332,2424,1.0,2378.0,-92
12662,2239,2278,0.5,2258.5,-39
12663,2377,2360,0.5,2368.5,17
12664,2030,2429,1.0,2229.5,-399
12665,2209,2166,1.0,2187.5,43
12666,2081,2155,1.0,2118.0,-74
12667,2451,2171,0.0,2311.0,280
12668,2305,2357,0.5,2331.0,-52
12669,2344,2443,0.5,2393.5,-99
12670,2191,2214,0.5,2202.5,-23
12671,2250,2378,0.0,2314.0,-128
12672,2390,2454,1.0,2422.0,-64
12673,2251,2221,0.0,2236.0,30
12674,2210,2254,1.0,2232.0,-44
12675,2538,2101,1.0,2319.5,437
12676,2099,2144,0.0,2121.5,-45
12677,2061,2437,0.5,2249.0,-376
12678,1893,2066,0.0,1979.5,-173
12679,2334,2400,1.0,2367.0,-66
12680,2275,2280,0.0,2277.5,-5
12681,2276,2255,0.0,2265.5,21
12682,2044,2227,0.0,2135.5,-183
12683,2267,1790,1.0,2028.5,477
12684,1830,2037,0.5,1933.5,-207
12685,2226,1912,1.0,2069.0,314
12686,1784,2151,1.0,1967.5,-367
12687,2363,2227,1.0,2295.0,136
12688,2046,2243,1.0,2144.5,-197
12689,2263,2004,0.0,2133.5,259
12690,2206,2323,0.0,2264.5,-117
12691,2251,2088,1.0,2169.5,163
12692,2066,2247,0.0,2156.5,-181
12693,2144,2030,1.0,2087.0,114
12694,2540,2475,0.5,2507.5,65
12695,2280,2291,0.5,2285.5,-11
12696,2193,2261,0.5,2227.0,-68
12697,2212,2090,1.0,2151.0,122
12698,2360,2257,0.5,2308.5,103
12699,2120,2329,0.0,2224.5,-209
12700,2282,2041,1.0,2161.5,241
12701,2196,2189,1.0,2192.5,7
12702,2187,2108,0.0,2147.5,79
12703,1938,2094,0.0,2016.0,-156
12704,1874,2064,1.0,1969.0,-190
12705,2416,2259,0.0,2337.5,157
12706,1977,2249,0.5,2113.0,-272
12707,2205,2211,0.5,2208.0,-6
12708,2179,2171,1.0,2175.0,8
12709,2222,1883,1.0,2052.5,339
12710,2103,2206,0.5,2154.5,-103
12711,2092,2352,0.5,2222.0,-260
12712,1810,1958,0.0,1884.0,-148
12713,2113,2139,1.0,2126.0,-26
12714,2084,2272,1.0,2178.0,-188
12715,2205,2016,1.0,2110.5,189
12716,1983,2081,1.0,2032.0,-98
12717,2153,1818,0.5,1985.5,335
12718,2116,2118,0.0,2117.0,-2
12719,1956,2127,1.0,2041.5,-171
12720,2088,1903,0.0,1995.5,185
12721,1947,1973,0.5,1960.0,-26
12722,1964,1965,0.0,1964.5,-1
12723,1895,1812,0.5,1853.5,83
12724,2260,2002,0.5,2131.0,258
12725,1861,2304,0.0,2082.5,-443
12726,2204,1678,1.0,1941.0,526
12727,1975,2030,0.0,2002.5,-55
12728,1995,1967,0.0,1981.0,28
12729,1981,2089,0.5,2035.0,-108
12730,2291,2133,0.5,2212.0,158
12731,2068,2155,1.0,2111.5,-87
12732,2171,2089,1.0,2130.0,82
12733,2026,2129,0.0,2077.5,-103
12734,1915,2126,0.0,2020.5,-211
12735,1730,1882,0.0,1806.0,-152
12736,1790,1719,1.0,1754.5,71
12737,1907,2086,0.5,1996.5,-179
12738,1719,2104,0.0,1911.5,-385
12739,2014,1992,0.0,2003.0,22
12740,1952,1941,0.5,1946.5,11
12741,2041,1834,0.5,1937.5,207
12742,2025,2084,0.0,2054.5,-59
12743,2143,1910,0.5,2026.5,233
12744,1740,2151,0.5,1945.5,-411
12745,2049,1659,0.5,1854.0,390
12746,1542,1966,1.0,1754.0,-424
12747,2034,2166,0.0,2100.0,-132
12748,2120,1875,1.0,1997.5,245
12749,1823,2007,1.0,1915.0,-184
12750,1922,1663,1.0,1792.5,259
12751,1923,1944,1.0,1933.5,-21
12752,1712,1893,1.0,1802.5,-181
12753,2088,2186,0.0,2137.0,-98
12754,2390,2627,0.0,2508.5,-237
12755,2374,2228,1.0,2301.0,146
12756,2298,2345,0.5,2321.5,-47
12757,2198,2265,0.0,2231.5,-67
12758,2360,2399,0.5,2379.5,-39
12759,2333,2283,0.5,2308.0,50
12760,2365,2162,1.0,2263.5,203
12761,2121,2195,0.0,2158.0,-74
12762,2726,2778,0.5,2752.0,-52
12763,2746,2685,0.5,2715.5,61
12764,2695,2666,1.0,2680.5,29
12765,2617,2670,0.5,2643.5,-53
12766,2606,2763,0.5,2684.5,-157
12767,2785,2589,1.0,2687.0,196
12768,2570,2730,0.5,2650.0,-160
12769,2722,2589,0.5,2655.5,133
12770,2711,2816,0.0,2763.5,-105
12771,2698,2691,0.5,2694.5,7
12772,2696,2687,0.0,2691.5,9
12773,2693,2608,0.5,2650.5,85
12774,2788,2769,0.5,2778.5,19
12775,2734,2620,1.0,2677.0,114
12776,2729,2709,0.5,2719.0,20
12777,2706,2634,0.5,2670.0,72
12778,2683,2717,0.0,2700.0,-34
12779,2635,2691,0.0,2663.0,-56
12780,2619,2594,0.0,2606.5,25
12781,2594,2595,1.0,2594.5,-1
12782,2577,2737,0.0,2657.0,-160
12783,2713,2517,1.0,2615.0,196
12784,2496,2698,0.0,2597.0,-202
12785,2685,2498,1.0,2591.5,187
12786,2667,2712,0.5,2689.5,-45
12787,2648,2582,0.5,2615.0,66
12788,2528,2653,0.5,2590.5,-125
12789,2610,2523,1.0,2566.5,87
12790,2652,2693,0.5,2672.5,-41
12791,2639,2554,0.5,2596.5,85
12792,2469,2506,0.5,2487.5,-37
12793,2505,2508,0.5,2506.5,-3
12794,2707,2725,0.0,2716.0,-18
12795,2711,2685,1.0,2698.0,26
12796,2664,2626,1.0,2645.0,38
12797,2583,2637,0.0,2610.0,-54
12798,2738,2659,0.5,2698.5,79
12799,2578,2642,0.5,2610.0,-64
12800,2638,2575,1.0,2606.5,63
12801,2569,2605,1.0,2587.0,-36
12802,2684,2752,1.0,2718.0,-68
12803,2681,2499,0.5,2590.0,182
12804,2492,2596,0.5,2544.0,-104
12805,2563,2454,0.0,2508.5,109
12806,2614,2686,0.5,2650.0,-72
12807,2714,2618,0.0,2666.0,96
12808,2612,2652,1.0,2632.0,-40
12809,2644,2554,1.0,2599.0,90
12810,2606,2697,0.5,2651.5,-91
12811,2601,2623,0.5,2612.0,-22
12812,2589,2581,0.5,2585.0,8
12813,2575,2574,0.5,2574.5,1
12814,2640,2638,0.5,2639.0,2
12815,2599,2609,0.5,2604.0,-10
12816,2554,2587,1.0,2570.5,-33
12817,2616,2552,0.5,2584.0,64
12818,2627,2734,1.0,2680.5,-107
12819,2645,2415,0.0,2530.0,230
12820,2374,2569,0.0,2471.5,-195
12821,2468,2345,1.0,2406.5,123
12822,2645,2595,0.5,2620.0,50
12823,2513,2599,0.5,2556.0,-86
12824,2549,2469,1.0,2509.0,80
12825,2469,2579,0.5,2524.0,-110
12826,2722,2536,1.0,2629.0,186
12827,2344,2653,0.0,2498.5,-309
12828,2635,2420,1.0,2527.5,215
12829,2181,2555,0.0,2368.0,-374
12830,2623,2579,1.0,2601.0,44
12831,2553,2617,1.0,2585.0,-64
12832,2593,2532,1.0,2562.5,61
12833,2481,2511,0.0,2496.0,-30
12834,2566,2532,0.5,2549.0,34
12835,2529,2494,1.0,2511.5,35
12836,2448,2508,0.5,2478.0,-60
12837,2486,2418,0.5,2452.0,68
12838,2773,2498,1.0,2635.5,275
12839,2473,2516,0.0,2494.5,-43
12840,2586,2420,0.5,2503.0,166
12841,2348,2542,1.0,2445.0,-194
12842,2448,2562,0.0,2505.0,-114
12843,2570,2472,0.5,2521.0,98
12844,2472,2576,0.5,2524.0,-104
12845,2503,2418,0.5,2460.5,85
12846,2551,2670,0.5,2610.5,-119
12847,2498,2495,0.5,2496.5,3
12848,2423,2545,0.5,2484.0,-122
12849,2400,2418,0.5,2409.0,-18
12850,2610,2487,1.0,2548.5,123
12851,2359,2378,1.0,2368.5,-19
12852,2354,2283,0.0,2318.5,71
12853,2383,2190,0.0,2286.5,193
12854,2507,2595,0.0,2551.0,-88
12855,2419,2397,0.0,2408.0,22
12856,2378,2406,1.0,2392.0,-28
12857,2370,2360,0.0,2365.0,10
12858,2579,2523,0.5,2551.0,56
12859,2514,2503,0.0,2508.5,11
12860,2477,2526,1.0,2501.5,-49
12861,2438,2472,1.0,2455.0,-34
12862,2414,2471,0.5,2442.5,-57
12863,2345,2363,0.5,2354.0,-18
12864,2397,2282,1.0,2339.5,115
12865,2171,2306,0.5,2238.5,-135
12866,2706,2428,1.0,2567.0,278
12867,2322,2580,0.0,2451.0,-258
12868,2537,2312,1.0,2424.5,225
12869,2297,2494,0.0,2395.5,-197
12870,2516,2643,0.5,2579.5,-127
12871,2453,2437,0.0,2445.0,16
12872,2402,2429,1.0,2415.5,-27
12873,2448,2411,1.0,2429.5,37
12874,2178,2575,0.0,2376.5,-397
12875,2533,2209,1.0,2371.0,324
12876,2159,2417,1.0,2288.0,-258
12877,2402,2147,0.5,2274.5,255
12878,2495,2556,1.0,2525.5,-61
12879,2543,2395,1.0,2469.0,148
12880,2417,2448,0.5,2432.5,-31
12881,2375,2338,0.0,2356.5,37
12882,2521,2423,0.5,2472.0,98
12883,2362,2481,0.5,2421.5,-119
12884,2493,2387,0.5,2440.0,106
12885,2317,2500,1.0,2408.5,-183
12886,2516,2068,0.5,2292.0,448
12887,2139,2514,0.0,2326.5,-375
12888,2480,2273,1.0,2376.5,207
12889,2599,2462,0.5,2530.5,137
12890,2173,2156,1.0,2164.5,17
12891,2543,2577,1.0,2560.0,-34
12892,2153,2185,0.0,2169.0,-32
12893,2172,2435,0.0,2303.5,-263
12894,2471,2525,0.5,2498.0,-54
12895,2155,2271,0.0,2213.0,-116
12896,2484,2494,1.0,2489.0,-10
12897,2475,2187,1.0,2331.0,288
12898,2511,2515,1.0,2513.0,-4
12899,2261,2280,0.0,2270.5,-19
12900,2426,2506,1.0,2466.0,-80
12901,2529,2212,0.5,2370.5,317
12902,2448,2638,1.0,2543.0,-190
12903,2350,2429,0.0,2389.5,-79
12904,2360,2519,0.0,2439.5,-159
12905,2446,2329,1.0,2387.5,117
12906,2282,2493,0.0,2387.5,-211
12907,2394,2189,1.0,2291.5,205
12908,2533,2293,1.0,2413.0,240
12909,2349,2507,0.0,2428.0,-158
12910,2303,2180,0.5,2241.5,123
12911,2025,2323,0.5,2174.0,-298
12912,2429,2454,1.0,2441.5,-25
12913,2390,2242,1.0,2316.0,148
12914,2030,2254,0.5,2142.0,-224
12915,2210,2081,0.0,2145.5,129
12916,2548,2546,0.5,2547.0,2
12917,2322,2424,1.0,2373.0,-102
12918,2365,2245,0.5,2305.0,120
12919,2228,2262,0.5,2245.0,-34
12920,2323,2360,1.0,2341.5,-37
12921,2283,2251,0.5,2267.0,32
12922,2247,2365,0.5,2306.0,-118
12923,2195,2221,1.0,2208.0,-26
12924,2434,2469,0.5,2451.5,-35
12925,2372,2405,0.5,2388.5,-33
12926,2342,2354,0.0,2348.0,-12
12927,2203,2234,0.0,2218.5,-31
12928,2046,2446,0.0,2246.0,-400
12929,2421,2110,0.5,2265.5,311
12930,2060,2424,0.0,2242.0,-364
12931,2360,2027,0.5,2193.5,333
12932,2357,2267,1.0,2312.0,90
12933,2037,2305,0.0,2171.0,-268
12934,2214,2133,0.0,2173.5,81
12935,2226,2191,0.5,2208.5,35
12936,2538,2334,1.0,2436.0,204
12937,2255,2437,0.0,2346.0,-182
12938,2061,2237,0.0,2149.0,-176
12939,2227,2400,0.0,2313.5,-173
12940,2393,2459,0.5,2426.0,-66
12941,2398,2237,1.0,2317.5,161
12942,2259,2362,0.5,2310.5,-103
12943,2153,2104,0.5,2128.5,49
12944,2282,2354,0.0,2318.0,-72
12945,2287,2316,0.5,2301.5,-29
12946,2278,2258,0.5,2268.0,20
12947,2297,2211,1.0,2254.0,86
12948,2222,2382,0.0,2302.0,-160
12949,2347,2206,1.0,2276.5,141
12950,2067,2256,0.0,2161.5,-189
12951,2180,2067,0.5,2123.5,113
12952,2174,2398,0.5,2286.0,-224
12953,2149,2312,1.0,2230.5,-163
12954,2227,2046,1.0,2136.5,181
12955,2392,2259,0.0,2325.5,133
12956,1977,2373,0.0,2175.0,-396
12957,2244,2211,1.0,2227.5,33
12958,2179,2244,0.0,2211.5,-65
12959,2358,2084,0.5,2221.0,274
12960,2016,2190,1.0,2103.0,-174
12961,2062,1983,1.0,2022.5,79
12962,2352,2363,0.0,2357.5,-11
12963,2243,2092,0.5,2167.5,151
12964,2139,2263,1.0,2201.0,-124
12965,2004,2113,0.0,2058.5,-109
12966,2326,2108,1.0,2217.0,218
12967,1827,2413,0.0,2120.0,-586
12968,2278,1938,1.0,2108.0,340
12969,2064,2239,0.5,2151.5,-175
12970,2118,2346,0.0,2232.0,-228
12971,2127,2344,1.0,2235.5,-217
12972,2378,1956,0.5,2167.0,422
12973,1790,2377,0.0,2083.5,-587
12974,2308,1830,0.0,2069.0,478
12975,1912,2209,1.0,2060.5,-297
12976,2171,1784,1.0,1977.5,387
12977,2144,2250,0.0,2197.0,-106
12978,2221,2099,1.0,2160.0,122
12979,2066,2101,1.0,2083.5,-35
12980,2081,1893,1.0,1987.0,188
12981,2275,2187,1.0,2231.0,88
12982,2094,2208,0.5,2151.0,-114
12983,1903,2044,0.0,1973.5,-141
12984,2304,2260,1.0,2282.0,44
12985,2024,1947,0.0,1985.5,77
12986,2204,2255,1.0,2229.5,-51
12987,2540,1895,0.0,2217.5,645
12988,2088,2206,0.5,2147.0,-118
12989,2133,2193,1.0,2163.0,-60
12990,1824,2066,0.0,1945.0,-242
12991,2257,2090,1.0,2173.5,167
12992,2211,2291,0.5,2251.0,-80
12993,2041,2120,0.0,2080.5,-79
12994,2171,2155,1.0,2163.0,16
12995,2030,2416,0.0,2223.0,-386
12996,2249,2185,0.5,2217.0,64
12997,1975,2205,0.5,2090.0,-230
12998,2171,1981,1.0,2076.0,190
12999,2126,2091,1.0,2108.5,35
13000,1719,1861,0.5,1790.0,-142
13001,1810,1958,1.0,1884.0,-148
13002,2115,1790,1.0,1952.5,325
13003,1986,1719,0.5,1852.5,267
13004,2205,2272,1.0,2238.5,-67
13005,2153,2081,1.0,2117.0,72
13006,1883,2116,1.0,1999.5,-233
13007,2072,1967,0.0,2019.5,105
13008,2166,2034,1.0,2100.0,132
13009,2104,2084,1.0,2094.0,20
13010,1973,2088,0.0,2030.5,-115
13011,1941,2014,0.0,1977.5,-73
13012,1812,1964,1.0,1888.0,-152
13013,2136,1740,0.5,1938.0,396
13014,1659,2133,0.5,1896.0,-474
13015,2068,1542,1.0,1805.0,526
13016,2002,2089,0.5,2045.5,-87
13017,1992,1861,1.0,1926.5,131
13018,2086,2151,0.0,2118.5,-65
13019,1966,1907,1.0,1936.5,59
13020,1938,2068,1.0,2003.0,-130
13021,1944,2120,0.0,2032.0,-176
13022,2007,1923,0.5,1965.0,84
13023,1893,1987,0.0,1940.0,-94
13024,1823,1848,0.0,1835.5,-25
13025,2186,2025,0.0,2105.5,161
13026,1910,1765,1.0,1837.5,145
13027,1875,2088,1.0,1981.5,-213
13028,1663,1922,0.0,1792.5,-259
13029,2390,2542,1.0,2466.0,-152
13030,2517,2298,1.0,2407.5,219
13031,2265,2393,0.5,2329.0,-128
13032,2178,2231,0.5,2204.5,-53
13033,2399,2072,1.0,2235.5,327
13034,2065,2333,0.0,2199.0,-268
13035,2162,2082,1.0,2122.0,80
13036,2769,2244,1.0,2506.5,525
13037,2685,2726,0.5,2705.5,-41
13038,2709,2734,0.5,2721.5,-25
13039,2670,2695,0.0,2682.5,-25
13040,2737,2693,0.5,2715.0,44
13041,2698,2816,1.0,2757.0,-118
13042,2698,2713,0.5,2705.5,-15
13043,2693,2687,0.5,2690.0,6
13044,2797,2685,1.0,2741.0,112
13045,2656,2712,0.5,2684.0,-56
13046,2785,2763,1.0,2774.0,22
13047,2610,2653,0.5,2631.5,-43
13048,2717,2722,1.0,2719.5,-5
13049,2746,2778,1.0,2762.0,-32
13050,2594,2654,0.5,2624.0,-60
13051,2598,2666,1.0,2632.0,-68
13052,2606,2594,0.0,2600.0,12
13053,2691,2711,1.0,2701.0,-20
13054,2570,2589,0.5,2579.5,-19
13055,2608,2696,0.5,2652.0,-88
13056,2693,2589,0.5,2641.0,104
13057,2499,2684,0.5,2591.5,-185
13058,2505,2506,1.0,2505.5,-1
13059,2454,2492,0.0,2473.0,-38
13060,2614,2518,0.5,2566.0,96
13061,2554,2652,0.5,2603.0,-98
13062,2612,2618,1.0,2615.0,-6
13063,2508,2469,0.0,2488.5,39
13064,2725,2554,1.0,2639.5,171
13065,2609,2640,1.0,2624.5,-31
13066,2626,2711,0.5,2668.5,-85
13067,2552,2554,0.0,2553.0,-2
13068,2620,2569,0.5,2594.5,51
13069,2685,2707,0.0,2696.0,-22
13070,2634,2729,0.5,2681.5,-95
13071,2550,2664,0.5,2607.0,-114
13072,2722,2613,0.5,2667.5,109
13073,2691,2683,1.0,2687.0,8
13074,2698,2653,1.0,2675.5,45
13075,2569,2595,0.0,2582.0,-26
13076,2687,2635,1.0,2661.0,52
13077,2582,2667,1.0,2624.5,-85
13078,2638,2642,1.0,2640.0,-4
13079,2523,2528,1.0,2525.5,-5
13080,2659,2605,0.5,2632.0,54
13081,2516,2577,1.0,2546.5,-61
13082,2585,2578,0.0,2581.5,7
13083,2498,2496,0.5,2497.0,2
13084,2773,2569,1.0,2671.0,204
13085,2618,2606,0.0,2612.0,12
13086,2586,2516,0.5,2551.0,70
13087,2574,2623,0.0,2598.5,-49
13088,2697,2520,0.5,2608.5,177
13089,2599,2645,0.5,2622.0,-46
13090,2601,2638,0.0,2619.5,-37
13091,2549,2614,1.0,2581.5,-65
13092,2562,2581,1.0,2571.5,-19
13093,2617,2623,0.5,2620.0,-6
13094,2576,2570,0.5,2573.0,6
13095,2593,2582,0.0,2587.5,11
13096,2532,2511,1.0,2521.5,21
13097,2397,2507,0.5,2452.0,-110
13098,2508,2529,0.0,2518.5,-21
13099,2360,2378,0.5,2369.0,-18
13100,2752,2486,1.0,2619.0,266
13101,2415,2627,0.0,2521.0,-212
13102,2681,2682,1.0,2681.5,-1
13103,2198,2374,0.0,2286.0,-176
13104,2734,2596,0.5,2665.0,138
13105,2395,2495,0.0,2445.0,-100
13106,2569,2645,0.5,2607.0,-76
13107,2338,2417,0.5,2377.5,-79
13108,2686,2468,1.0,2577.0,218
13109,2363,2414,0.5,2388.5,-51
13110,2652,2714,1.0,2683.0,-62
13111,2306,2397,0.0,2351.5,-91
13112,2638,2682,0.5,2660.0,-44
13113,2378,2610,0.5,2494.0,-232
13114,2599,2614,1.0,2606.5,-15
13115,2190,2354,0.0,2272.0,-164
13116,2487,2587,0.5,2537.0,-100
13117,2580,2706,0.5,2643.0,-126
13118,2283,2359,0.5,2321.0,-76
13119,2494,2537,1.0,2515.5,-43
13120,2516,2383,1.0,2449.5,133
13121,2499,2551,0.5,2525.0,-52
13122,2480,2514,0.5,2497.0,-34
13123,2423,2495,0.5,2459.0,-72
13124,2575,2462,0.5,2518.5,113
13125,2437,2516,1.0,2476.5,-79
13126,2498,2533,0.0,2515.5,-35
13127,2411,2402,0.0,2406.5,9
13128,2423,2402,0.0,2412.5,21
13129,2498,2670,0.5,2584.0,-172
13130,2317,2362,1.0,2339.5,-45
13131,2400,2545,0.5,2472.5,-145
13132,2579,2299,1.0,2439.0,280
13133,2503,2579,0.5,2541.0,-76
13134,2532,2553,1.0,2542.5,-21
13135,2472,2477,1.0,2474.5,-5
13136,2446,2481,0.5,2463.5,-35
13137,2494,2566,0.5,2530.0,-72
13138,2424,2421,0.5,2422.5,3
13139,2461,2448,1.0,2454.5,13
13140,2594,2332,0.0,2463.0,262
13141,2513,2595,0.0,2554.0,-82
13142,2494,2525,1.0,2509.5,-31
13143,2459,2469,0.5,2464.0,-10
13144,2523,2484,0.0,2503.5,39
13145,2437,2538,0.0,2487.5,-101
13146,2472,2472,1.0,2472.0,0
13147,2292,2400,1.0,2346.0,-108
13148,2638,2418,0.0,2528.0,220
13149,2577,2599,1.0,2588.0,-22
13150,2431,2429,0.0,2430.0,2
13151,2435,2543,1.0,2489.0,-108
13152,2536,2350,1.0,2443.0,186
13153,2511,2515,1.0,2513.0,-4
13154,2420,2344,0.5,2382.0,76
13155,2426,2506,1.0,2466.0,-80
13156,2542,2218,0.5,2380.0,324
13157,2446,2519,1.0,2482.5,-73
13158,2393,2517,0.0,2455.0,-124
13159,2394,2493,0.5,2443.5,-99
13160,2498,2178,0.0,2338.0,320
13161,2322,2546,0.0,2434.0,-224
13162,2420,2473,1.0,2446.5,-53
13163,2228,2245,0.0,2236.5,-17
13164,2533,2348,1.0,2440.5,185
13165,2242,2429,0.5,2335.5,-187
13166,2303,2507,0.5,2405.0,-204
13167,2081,2030,0.5,2055.5,51
13168,2360,2174,1.0,2267.0,186
13169,2479,2523,0.5,2501.0,-44
13170,2365,2283,1.0,2324.0,82
13171,2438,2526,0.0,2482.0,-88
13172,2398,2195,0.5,2296.5,203
13173,2322,2428,1.0,2375.0,-106
13174,2338,2362,1.0,2350.0,-24
13175,2297,2312,1.0,2304.5,-15
13176,2643,2153,1.0,2398.0,490
13177,2543,2556,0.0,2549.5,-13
13178,2453,2602,1.0,2527.5,-149
13179,2448,2509,0.5,2478.5,-61
13180,2595,2448,1.0,2521.5,147
13181,2209,2178,0.5,2193.5,31
13182,2406,2419,0.0,2412.5,-13
13183,2147,2159,0.0,2153.0,-12
13184,2521,2370,0.5,2445.5,151
13185,2405,2434,1.0,2419.5,-29
13186,2493,2481,1.0,2487.0,12
13187,2234,2342,0.5,2288.0,-108
13188,2471,2500,1.0,2485.5,-29
13189,2092,2352,0.0,2222.0,-260
13190,2282,2345,1.0,2313.5,-63
13191,2113,2139,0.5,2126.0,-26
13192,2354,2180,1.0,2267.0,174
13193,2139,2068,0.0,2103.5,71
13194,2297,2287,0.0,2292.0,10
13195,2273,2270,0.0,2271.5,3
13196,2382,2120,1.0,2251.0,262
13197,2373,2392,0.5,2382.5,-19
13198,2256,2347,1.0,2301.5,-91
13199,2244,2244,0.0,2244.0,0
13200,2469,2180,1.0,2324.5,289
13201,2174,2398,0.0,2286.0,-224
13202,2354,2372,0.5,2363.0,-18
13203,2149,2312,1.0,2230.5,-163
13204,2323,2260,1.0,2291.5,63
13205,2190,2358,0.5,2274.0,-168
13206,2247,2251,1.0,2249.0,-4
13207,2296,2062,0.0,2179.0,234
13208,2384,2144,0.0,2264.0,240
13209,2360,2314,0.5,2337.0,46
13210,2189,2329,0.0,2259.0,-140
13211,2366,2548,0.5,2457.0,-182
13212,2424,2413,0.0,2418.5,11
13213,2278,2365,0.5,2321.5,-87
13214,2262,2239,0.0,2250.5,23
13215,2451,2475,0.0,2463.0,-24
13216,2280,2346,0.0,2313.0,-66
13217,2443,2261,1.0,2352.0,182
13218,2212,2378,0.0,2295.0,-166
13219,2390,2334,1.0,2362.0,56
13220,2255,2254,0.5,2254.5,1
13221,2210,2237,0.0,2223.5,-27
13222,2276,2153,0.5,2214.5,123
13223,2129,2280,0.5,2204.5,-151
13224,2208,2173,0.0,2190.5,35
13225,2044,2153,0.0,2098.5,-109
13226,2250,2046,0.5,2148.0,204
13227,2110,2221,0.5,2165.5,-111
13228,2251,2137,1.0,2194.0,114
13229,2027,2081,1.0,2054.0,-54
13230,2037,2267,0.5,2152.0,-230
13231,2226,2133,0.5,2179.5,93
13232,2260,2196,0.0,2228.0,64
13233,2291,2540,0.5,2415.5,-249
13234,2255,2304,0.5,2279.5,-49
13235,2133,2193,0.5,2163.0,-60
13236,2293,2204,1.0,2248.5,89
13237,2264,2271,0.5,2267.5,-7
13238,2180,2349,0.5,2264.5,-169
13239,2187,2155,0.0,2171.0,32
13240,2291,2025,0.5,2158.0,266
13241,2308,2377,1.0,2342.5,-69
13242,2155,2211,0.0,2183.0,-56
13243,2209,2166,1.0,2187.5,43
13244,2416,2171,1.0,2293.5,245
13245,2278,2316,0.5,2297.0,-38
13246,2171,2249,0.0,2210.0,-78
13247,2137,2211,0.0,2174.0,-74
13248,2363,2207,1.0,2285.0,156
13249,1830,1790,0.0,1810.0,40
13250,2263,2243,1.0,2253.0,20
13251,1784,1912,0.5,1848.0,-128
13252,2259,2019,0.0,2139.0,240
13253,2016,2084,0.0,2050.0,-68
13254,1977,1725,1.0,1851.0,252
13255,1818,2211,0.0,2014.5,-393
13256,2237,2393,0.0,2315.0,-156
13257,1967,2259,0.0,2113.0,-292
13258,2243,2115,0.0,2179.0,128
13259,2149,2075,1.0,2112.0,74
13260,2272,2084,0.0,2178.0,188
13261,2081,2205,0.5,2143.0,-124
13262,2116,2153,1.0,2134.5,-37
13263,2206,2222,1.0,2214.0,-16
13264,2067,2103,1.0,2085.0,-36
13265,2257,2144,1.0,2200.5,113
13266,2099,2041,0.5,2070.0,58
13267,1893,2066,1.0,1979.5,-173
13268,2072,2118,1.0,2095.0,-46
13269,1956,2127,1.0,2041.5,-171
13270,2206,2032,1.0,2119.0,174
13271,1861,2126,0.5,1993.5,-265
13272,2066,2088,0.0,2077.0,-22
13273,1719,1730,0.5,1724.5,-11
13274,2108,2030,1.0,2069.0,78
13275,1965,1947,0.5,1956.0,18
13276,2064,1938,0.5,2001.0,126
13277,1895,2024,0.5,1959.5,-129
13278,2187,2205,0.0,2196.0,-18
13279,1992,2094,0.0,2043.0,-102
13280,1874,1952,0.5,1913.0,-78
13281,2151,2091,0.5,2121.0,60
13282,2068,2049,0.0,2058.5,19
13283,2088,1938,0.5,2013.0,150
13284,1987,2007,0.5,1997.0,-20
13285,1964,1973,0.0,1968.5,-9
13286,1801,1823,0.0,1812.0,-22
13287,2185,2030,1.0,2107.5,155
13288,2089,1975,1.0,2032.0,114
13289,1883,2072,1.0,1977.5,-189
13290,2136,1788,0.5,1962.0,348
13291,1986,1915,0.0,1950.5,71
13292,2089,2068,0.0,2078.5,21
13293,2014,2104,1.0,2059.0,-90
13294,1719,1941,0.5,1830.0,-222
13295,2034,1740,1.0,1887.0,294
13296,1542,2166,0.0,1854.0,-624
13297,1944,2186,0.5,2065.0,-242
13298,1893,1923,1.0,1908.0,-30
13299,1765,1848,1.0,1806.5,-83
13300,2025,1875,1.0,1950.0,150
13301,1922,1663,0.0,1792.5,259
13302,1907,2086,1.0,1996.5,-179
13303,1712,2002,0.0,1857.0,-290
13304,1929,1678,0.0,1803.5,251
13305,2357,2390,0.0,2373.5,-33
13306,2228,2305,1.0,2266.5,-77
13307,2214,2265,0.0,2239.5,-51
13308,2231,2191,0.0,2211.0,40
13309,2227,2333,1.0,2280.0,-106
13310,2162,2046,1.0,2104.0,116
13311,2121,2244,0.0,2182.5,-123
13312,2599,2530,1.0,2564.5,69
13313,2524,2549,1.0,2536.5,-25
13314,2528,2489,0.5,2508.5,39
13315,2448,2449,0.5,2448.5,-1
13316,2467,2392,1.0,2429.5,75
13317,2304,2412,0.0,2358.0,-108
13318,2377,2277,0.5,2327.0,100
13319,2266,2375,0.0,2320.5,-109
13320,2280,2547,0.5,2413.5,-267
13321,2509,2353,1.0,2431.0,156
13322,2305,2444,0.0,2374.5,-139
13323,2432,2241,0.0,2336.5,191
13324,2464,2422,1.0,2443.0,42
13325,2417,2385,0.5,2401.0,32
13326,2306,2276,0.0,2291.0,30
13327,2252,2302,0.5,2277.0,-50
13328,2542,2285,1.0,2413.5,257
13329,2324,2466,0.5,2395.0,-142
13330,2442,2245,1.0,2343.5,197
13331,2205,2433,0.0,2319.0,-228
13332,2442,2091,0.0,2266.5,351
13333,1991,2411,0.0,2201.0,-420
13334,2261,2061,1.0,2161.0,200
13335,2022,2253,0.0,2137.5,-231
13336,2276,2393,0.5,2334.5,-117
13337,2212,2298,1.0,2255.0,-86
13338,2241,2226,0.0,2233.5,15
13339,2228,2267,0.5,2247.5,-39
13340,2337,2164,0.5,2250.5,173
13341,2189,2181,0.5,2185.0,8
13342,2004,2028,1.0,2016.0,-24
13343,2014,2097,1.0,2055.5,-83
13344,2457,2342,1.0,2399.5,115
13345,2261,2336,0.5,2298.5,-75
13346,2256,2130,0.0,2193.0,126
13347,2057,2215,0.0,2136.0,-158
13348,2413,2251,1.0,2332.0,162
13349,2315,2169,1.0,2242.0,146
13350,2160,2306,1.0,2233.0,-146
13351,2226,1858,0.0,2042.0,368
13352,2291,2351,1.0,2321.0,-60
13353,2305,2267,1.0,2286.0,38
13354,2216,2235,0.5,2225.5,-19
13355,2151,2165,0.5,2158.0,-14
13356,2503,2483,0.5,2493.0,20
13357,2356,2371,0.5,2363.5,-15
13358,2379,2337,1.0,2358.0,42
13359,2380,2271,0.0,2325.5,109
13360,2295,2329,0.0,2312.0,-34
13361,2178,2174,0.0,2176.0,4
13362,2317,2147,0.5,2232.0,170
13363,2185,2202,1.0,2193.5,-17
13364,2502,2606,0.5,2554.0,-104
13365,2260,2299,0.5,2279.5,-39
13366,2281,2240,0.5,2260.5,41
13367,2211,2313,0.5,2262.0,-102
13368,2158,2512,0.0,2335.0,-354
13369,2467,1947,1.0,2207.0,520
13370,2009,2356,0.0,2182.5,-347
13371,2341,1999,0.5,2170.0,342
13372,2066,2294,0.0,2180.0,-228
13373,2341,2103,1.0,2222.0,238
13374,2088,1974,1.0,2031.0,114
13375,1938,2165,1.0,2051.5,-227
13376,2476,2368,0.5,2422.0,108
13377,2164,2454,0.0,2309.0,-290
13378,2349,2160,1.0,2254.5,189
13379,2095,2338,0.0,2216.5,-243
13380,2402,2139,0.5,2270.5,263
13381,1992,2380,0.0,2186.0,-388
13382,2352,1939,1.0,2145.5,413
13383,1782,2372,0.0,2077.0,-590
13384,2159,2338,0.0,2248.5,-179
13385,2327,2132,1.0,2229.5,195
13386,2091,2239,0.0,2165.0,-148
13387,2087,2012,1.0,2049.5,75
13388,2313,2199,1.0,2256.0,114
13389,2186,2270,0.5,2228.0,-84
13390,2237,2102,1.0,2169.5,135
13391,1931,2218,0.0,2074.5,-287
13392,2346,2242,1.0,2294.0,104
13393,2163,2128,0.5,2145.5,35
13394,1998,2132,1.0,2065.0,-134
13395,2109,1952,1.0,2030.5,157
13396,2311,2055,1.0,2183.0,256
13397,1977,2232,0.0,2104.5,-255
13398,2167,2026,1.0,2096.5,141
13399,2520,2146,1.0,2333.0,374
13400,1995,2101,0.0,2048.0,-106
13401,2052,2216,1.0,2134.0,-164
13402,1634,2053,0.0,1843.5,-419
13403,2197,2211,1.0,2204.0,-14
13404,1547,1627,0.0,1587.0,-80
13405,2057,2101,1.0,2079.0,-44
13406,2091,2116,1.0,2103.5,-25
13407,2152,1927,1.0,2039.5,225
13408,1896,1927,0.5,1911.5,-31
13409,1841,1782,1.0,1811.5,59
13410,2218,1981,1.0,2099.5,237
13411,1890,2143,0.0,2016.5,-253
13412,1818,1843,0.5,1830.5,-25
13413,2075,2280,0.5,2177.5,-205
13414,2066,2014,0.5,2040.0,52
13415,2072,2036,0.5,2054.0,36
13416,1981,1937,1.0,1959.0,44
13417,1978,2214,0.5,2096.0,-236
13418,2179,1939,0.0,2059.0,240
13419,1828,2074,0.0,1951.0,-246
13420,2037,1655,1.0,1846.0,382
13421,1885,2345,0.5,2115.0,-460
13422,2355,2035,1.0,2195.0,320
13423,1721,2296,0.0,2008.5,-575
13424,2264,1709,1.0,1986.5,555
13425,2235,2235,0.5,2235.0,0
13426,1788,1861,0.5,1824.5,-73
13427,2220,2228,1.0,2224.0,-8
13428,2170,2023,0.5,2096.5,147
13429,1949,2212,0.0,2080.5,-263
13430,2181,2087,1.0,2134.0,94
13431,1892,2297,0.0,2094.5,-405
13432,2185,1794,1.0,1989.5,391
13433,1516,2160,0.0,1838.0,-644
13434,2173,1970,0.5,2071.5,203
13435,1881,2035,1.0,1958.0,-154
13436,1942,1788,1.0,1865.0,154
13437,2231,1924,1.0,2077.5,307
13438,1915,2187,0.0,2051.0,-272
13439,2033,1546,0.0,1789.5,487
13440,1521,1996,0.0,1758.5,-475
13441,2193,2281,1.0,2237.0,-88
13442,1957,2067,0.0,2012.0,-110
13443,2050,1832,1.0,1941.0,218
13444,1737,2036,0.5,1886.5,-299
13445,2070,2121,0.0,2095.5,-51
13446,1911,1933,0.0,1922.0,-22
13447,1844,1830,0.0,1837.0,14
13448,1732,1834,1.0,1783.0,-102
13449,1910,1882,1.0,1896.0,28
13450,1778,1885,1.0,1831.5,-107
13451,1909,1864,1.0,1886.5,45
13452,1845,2023,1.0,1934.0,-178
13453,1705,1806,0.5,1755.5,-101
13454,1801,1762,1.0,1781.5,39
13455,2015,1687,1.0,1851.0,328
13456,1997,1836,0.5,1916.5,161
13457,1894,1927,0.5,1910.5,-33
13458,1921,1593,1.0,1757.0,328
13459,2204,2050,0.5,2127.0,154
13460,1742,2004,0.0,1873.0,-262
13461,1990,1605,1.0,1797.5,385
13462,1760,2104,0.0,1932.0,-344
13463,1646,2058,0.0,1852.0,-412
13464,2120,1583,1.0,1851.5,537
13465,1575,2090,0.0,1832.5,-515
13466,2103,1498,1.0,1800.5,605
13467,2174,1946,1.0,2060.0,228
13468,1796,2011,0.0,1903.5,-215
13469,2076,1657,1.0,1866.5,419
13470,1952,1705,1.0,1828.5,247
13471,2008,1987,1.0,1997.5,21
13472,2024,2098,1.0,2061.0,-74
13473,1713,1682,0.0,1697.5,31
13474,2061,2040,1.0,2050.5,21
13475,2022,1631,0.0,1826.5,391
13476,1918,2095,0.0,2006.5,-177
13477,1914,1967,0.0,1940.5,-53
13478,1673,1841,0.0,1757.0,-168
13479,2057,1541,0.0,1799.0,516
13480,1779,2171,0.0,1975.0,-392
13481,1940,1697,1.0,1818.5,243
13482,1638,1597,0.0,1617.5,41
13483,2005,1818,1.0,1911.5,187
13484,1834,1747,0.5,1790.5,87
13485,1820,1916,1.0,1868.0,-96
13486,1654,1753,1.0,1703.5,-99
13487,1818,1638,0.0,1728.0,180
13488,1950,1923,1.0,1936.5,27
13489,1949,1565,1.0,1757.0,384
13490,1753,1786,0.0,1769.5,-33
13491,1675,2117,0.0,1896.0,-442
13492,1839,1816,0.0,1827.5,23
13493,1581,1782,0.0,1681.5,-201
13494,1789,1694,0.5,1741.5,95
13495,1927,2050,0.5,1988.5,-123
13496,1482,1536,1.0,1509.0,-54
13497,1566,1684,0.5,1625.0,-118
13498,1542,1522,1.0,1532.0,20
13499,1997,1533,1.0,1765.0,464
13500,1756,1707,1.0,1731.5,49
13501,1952,1728,0.0,1840.0,224
13502,1647,1774,0.0,1710.5,-127
13503,1720,1772,1.0,1746.0,-52
13504,1689,1594,0.5,1641.5,95
13505,1631,1550,0.0,1590.5,81
13506,1670,1528,1.0,1599.0,142
13507,1492,1466,1.0,1479.0,26
13508,2294,2026,0.0,2160.0,268
13509,1763,1994,0.5,1878.5,-231
13510,1837,1632,0.0,1734.5,205
13511,1840,1999,0.5,1919.5,-159
13512,2078,1889,1.0,1983.5,189
13513,1949,1797,1.0,1873.0,152
13514,1761,1898,1.0,1829.5,-137
13515,2507,2467,0.5,2487.0,40
13516,2412,2524,0.5,2468.0,-112
13517,2489,2377,0.0,2433.0,112
13518,2375,2448,0.0,2411.5,-73
13519,2547,2599,0.5,2573.0,-52
13520,2528,2509,0.0,2518.5,19
13521,2458,2449,0.0,2453.5,9
13522,2424,2444,1.0,2434.0,-20
13523,2542,2442,0.5,2492.0,100
13524,2411,2466,0.5,2438.5,-55
13525,2442,2284,0.5,2363.0,158
13526,2261,2433,0.5,2347.0,-172
13527,2392,2212,0.5,2302.0,180
13528,2226,2304,1.0,2265.0,-78
13529,2277,2228,1.0,2252.5,49
13530,2172,2300,0.5,2236.0,-128
13531,2464,2337,0.5,2400.5,127
13532,2181,2385,0.5,2283.0,-204
13533,2289,2004,0.5,2146.5,285
13534,1801,2302,0.0,2051.5,-501
13535,2422,2457,0.5,2439.5,-35
13536,2336,2355,1.0,2345.5,-19
13537,2276,2215,1.0,2245.5,61
13538,2237,2252,0.0,2244.5,-15
13539,2164,2503,0.0,2333.5,-339
13540,2379,2189,1.0,2284.0,190
13541,2028,2396,0.0,2212.0,-368
13542,2271,2042,0.0,2156.5,229
13543,2329,2413,1.0,2371.0,-84
13544,2169,2178,0.5,2173.5,-9
13545,2147,2160,0.0,2153.5,-13
13546,1858,2185,0.0,2021.5,-327
13547,2280,2313,0.0,2296.5,-33
13548,2270,2305,0.5,2287.5,-35
13549,2241,2237,0.0,2239.0,4
13550,2249,2222,1.0,2235.5,27
13551,2512,2128,1.0,2320.0,384
13552,1998,2467,0.0,2232.5,-469
13553,2356,1952,1.0,2154.0,404
13554,2291,2303,1.0,2297.0,-12
13555,2311,2434,1.0,2372.5,-123
13556,2267,2346,1.0,2306.5,-79
13557,2146,2232,0.0,2189.0,-86
13558,2280,2165,0.0,2222.5,115
13559,2317,2502,1.0,2409.5,-185
13560,2036,2066,0.5,2051.0,-30
13561,2281,2299,1.0,2290.0,-18
13562,2606,1981,0.5,2293.5,625
13563,2324,2285,1.0,2304.5,39
13564,2240,2260,1.0,2250.0,-20
13565,2205,2208,0.5,2206.5,-3
13566,2338,2211,0.5,2274.5,127
13567,2454,2476,0.5,2465.0,-22
13568,2239,2327,0.5,2283.0,-88
13569,2338,2349,1.0,2343.5,-11
13570,2211,2087,0.5,2149.0,124
13571,2341,2294,0.5,2317.5,47
13572,2197,2227,1.0,2212.0,-30
13573,1876,1938,0.0,1907.0,-62
13574,2411,2101,0.0,2256.0,310
13575,2216,2520,1.0,2368.0,-304
13576,2305,2351,1.0,2328.0,-46
13577,2053,2118,0.5,2085.5,-65
13578,2259,2151,0.5,2205.0,108
13579,2162,2218,0.0,2190.0,-56
13580,2298,2276,1.0,2287.0,22
13581,2214,2267,0.5,2240.5,-53
13582,2380,2402,1.0,2391.0,-22
13583,2037,2074,0.0,2055.5,-37
13584,2372,2352,1.0,2362.0,20
13585,2091,1968,0.5,2029.5,123
13586,2152,2178,0.0,2165.0,-26
13587,1991,2061,0.5,2026.0,-70
13588,1841,1927,0.0,1884.0,-86
13589,1970,2061,0.0,2015.5,-91
13590,2356,2483,1.0,2419.5,-127
13591,2301,2337,1.0,2319.0,-36
13592,2258,1942,0.0,2100.0,316
13593,2174,2295,0.5,2234.5,-121
13594,2185,2297,1.0,2241.0,-112
13595,2202,2266,1.0,2234.0,-64
13596,2228,2258,1.0,2243.0,-30
13597,2306,2315,0.0,2310.5,-9
13598,2253,2170,1.0,2211.5,83
13599,2203,2226,0.0,2214.5,-23
13600,2344,2181,0.5,2262.5,163
13601,2261,2342,0.5,2301.5,-81
13602,2355,2345,1.0,2350.0,10
13603,2058,2130,1.0,2094.0,-72
13604,1981,2296,0.0,2138.5,-315
13605,2235,2230,1.0,2232.5,5
13606,1738,1890,1.0,1814.0,-152
13607,1861,1954,0.0,1907.5,-93
13608,2351,1828,0.0,2089.5,523
13609,1952,2002,0.5,1977.0,-50
13610,2160,2164,1.0,2162.0,-4
13611,1827,2008,0.0,1917.5,-181
13612,2384,2095,0.5,2239.5,289
13613,2058,2254,0.0,2156.0,-196
13614,2163,2242,0.0,2202.5,-79
13615,2103,2120,0.0,2111.5,-17
13616,2231,2109,0.5,2170.0,122
13617,2156,2186,0.5,2171.0,-30
13618,1996,2187,0.5,2091.5,-191
13619,1931,2102,0.5,2016.5,-171
13620,2098,2006,0.0,2052.0,92
13621,2103,2066,1.0,2084.5,37
13622,2061,2024,0.0,2042.5,37
13623,2088,2234,0.0,2161.0,-146
13624,2101,2115,1.0,2108.0,-14
13625,2014,2075,1.0,2044.5,-61
13626,1693,1995,0.0,1844.0,-302
13627,1993,2072,1.0,2032.5,-79
13628,2094,1808,0.0,1951.0,286
13629,2067,2193,1.0,2130.0,-126
13630,1939,1978,0.0,1958.5,-39
13631,1990,2050,1.0,2020.0,-60
13632,1882,1828,0.5,1855.0,54
13633,2009,2158,1.0,2083.5,-149
13634,1834,1885,1.0,1859.5,-51
13635,1999,2009,0.0,2004.0,-10
13636,1627,1634,0.0,1630.5,-7
13637,1547,1586,0.5,1566.5,-39
13638,2121,1788,1.0,1954.5,333
13639,1990,2204,1.0,2097.0,-214
13640,1830,1911,0.0,1870.5,-81
13641,2104,2105,1.0,2104.5,-1
13642,1993,1732,1.0,1862.5,261
13643,1697,2057,0.5,1877.0,-360
13644,1845,1864,1.0,1854.5,-19
13645,2139,1801,1.0,1970.0,338
13646,2011,2174,0.0,2092.5,-163
13647,1939,1992,0.5,1965.5,-53
13648,2055,1782,0.5,1918.5,273
13649,2023,2220,0.0,2121.5,-197
13650,2026,1977,0.5,2001.5,49
13651,1891,2087,0.5,1989.0,-196
13652,1923,2095,0.0,2009.0,-172
13653,1918,1997,0.0,1957.5,-79
13654,1927,1841,1.0,1884.0,86
13655,1730,1921,0.5,1825.5,-191
13656,1923,2173,1.0,2048.0,-250
13657,2035,1950,1.0,1992.5,85
13658,1796,1755,1.0,1775.5,41
13659,1927,1987,0.5,1957.0,-60
13660,1949,2050,1.0,1999.5,-101
13661,1746,1788,0.0,1767.0,-42
13662,1836,2062,0.0,1949.0,-226
13663,1885,1894,1.0,1889.5,-9
13664,1863,1721,1.0,1792.0,142
13665,1709,1593,1.0,1651.0,116
13666,2026,2022,0.0,2024.0,4
13667,1967,1914,0.0,1940.5,53
13668,1916,1816,0.5,1866.0,100
13669,1820,1810,1.0,1815.0,10
13670,1949,1840,0.5,1894.5,109
13671,1794,1892,0.0,1843.0,-98
13672,1727,1898,1.0,1812.5,-171
13673,1818,1516,1.0,1667.0,302
13674,1646,1688,1.0,1667.0,-42
13675,1747,1583,0.0,1665.0,164
13676,1924,1915,0.5,1919.5,9
13677,1546,2005,1.0,1775.5,-459
13678,2050,1943,1.0,1996.5,107
13679,2023,1909,1.0,1966.0,114
13680,1605,1742,0.5,1673.5,-137
13681,1741,1705,1.0,1723.0,36
13682,2281,1760,1.0,2020.5,521
13683,1536,1988,1.0,1762.0,-452
13684,1832,1886,1.0,1859.0,-54
13685,1522,1566,0.0,1544.0,-44
13686,1762,1705,1.0,1733.5,57
13687,1782,1946,0.0,1864.0,-164
13688,1796,1581,0.0,1688.5,215
13689,1694,1657,0.0,1675.5,37
13690,1667,1789,1.0,1728.0,-122
13691,1756,2070,0.5,1913.0,-314
13692,1954,1716,0.5,1835.0,238
13693,1834,1844,1.0,1839.0,-10
13694,1682,1838,1.0,1760.0,-156
13695,1647,1713,0.5,1680.0,-66
13696,2171,1839,1.0,2005.0,332
13697,1798,1635,1.0,1716.5,163
13698,1640,1638,1.0,1639.0,2
13699,1818,1985,1.0,1901.5,-167
13700,1565,1806,0.5,1685.5,-241
13701,1550,1772,1.0,1661.0,-222
13702,1684,1482,1.0,1583.0,202
13703,1520,1533,1.0,1526.5,-13
13704,1528,1825,0.0,1676.5,-297
13705,1728,1997,0.0,1862.5,-269
13706,1808,1952,1.0,1880.0,-144
13707,1492,1797,1.0,1644.5,-305
13708,2294,2159,0.5,2226.5,135
13709,2132,1837,1.0,1984.5,295
13710,1632,2091,0.0,1861.5,-459
13711,2012,1643,1.0,1827.5,369
13712,1999,2091,0.0,2045.0,-92
13713,1927,1797,1.0,1862.0,130
13714,1761,1896,0.5,1828.5,-135
13715,1782,1501,1.0,1641.5,281
13716,2467,2599,0.0,2533.0,-132
13717,2549,2412,1.0,2480.5,137
13718,2377,2449,0.5,2413.0,-72
13719,2424,2375,0.5,2399.5,49
13720,2530,2542,0.5,2536.0,-12
13721,2466,2507,0.5,2486.5,-41
13722,2524,2442,1.0,2483.0,82
13723,2433,2448,1.0,2440.5,-15
13724,2442,2422,1.0,2432.0,20
13725,2417,2411,0.5,2414.0,6
13726,2284,2355,0.5,2319.5,-71
13727,2252,2261,0.0,2256.5,-9
13728,2329,2464,0.5,2396.5,-135
13729,2289,2178,0.0,2233.5,111
13730,2185,2306,0.5,2245.5,-121
13731,2302,2143,0.5,2222.5,159
13732,2393,2503,0.5,2448.0,-110
13733,2371,2212,0.0,2291.5,159
13734,2226,2379,0.0,2302.5,-153
13735,2396,2172,1.0,2284.0,224
13736,2392,2547,0.0,2469.5,-155
13737,2509,2277,0.5,2393.0,232
13738,2300,2458,1.0,2379.0,-158
13739,2432,2266,0.5,2349.0,166
13740,2091,2512,0.0,2301.5,-421
13741,2467,2061,1.0,2264.0,406
13742,1991,2341,0.5,2166.0,-350
13743,2303,2061,1.0,2182.0,242
13744,2476,2402,1.0,2439.0,74
13745,2380,2454,0.5,2417.0,-74
13746,2349,2352,0.5,2350.5,-3
13747,2372,2338,0.0,2355.0,34
13748,2502,2259,1.0,2380.5,243
13749,2276,2317,1.0,2296.5,-41
13750,2299,2298,0.5,2298.5,1
13751,2241,2281,0.0,2261.0,-40
13752,2520,2313,1.0,2416.5,207
13753,2270,2216,1.0,2243.0,54
13754,2052,2237,1.0,2144.5,-185
13755,2249,2053,1.0,2151.0,196
13756,2211,2291,0.0,2251.0,-80
13757,2346,2227,0.0,2286.5,119
13758,2101,2216,0.0,2158.5,-115
13759,2165,2057,1.0,2111.0,108
13760,2285,2457,0.5,2371.0,-172
13761,2336,2324,0.5,2330.0,12
13762,2245,2256,0.5,2250.5,-11
13763,2215,2205,0.0,2210.0,10
13764,2483,2337,0.5,2410.0,146
13765,2181,2337,1.0,2259.0,-156
13766,2380,2004,1.0,2192.0,376
13767,2097,2301,0.0,2199.0,-204
13768,2295,2189,1.0,2242.0,106
13769,2028,2174,0.5,2101.0,-146
13770,2317,2014,1.0,2165.5,303
13771,2042,2266,0.0,2154.0,-224
13772,2606,2228,1.0,2417.0,378
13773,2170,2260,0.5,2215.0,-90
13774,2240,2253,1.0,2246.5,-13
13775,2181,2211,0.5,2196.0,-30
13776,2413,2280,0.5,2346.5,133
13777,2353,2030,1.0,2191.5,323
13778,2160,2305,1.0,2232.5,-145
13779,2222,1858,0.5,2040.0,364
13780,2239,2327,1.0,2283.0,-88
13781,1731,2087,0.0,1909.0,-356
13782,2048,1788,0.0,1918.0,260
13783,2294,2344,0.5,2319.0,-50
13784,2345,2341,0.5,2343.0,4
13785,1974,2355,1.0,2164.5,-381
13786,2264,1938,1.0,2101.0,326
13787,2342,2214,1.0,2278.0,128
13788,2179,2261,0.5,2220.0,-82
13789,2058,2074,0.0,2066.0,-16
13790,1968,2057,0.5,2012.5,-89
13791,2346,2411,0.5,2378.5,-65
13792,2351,1998,1.0,2174.5,353
13793,1952,2305,0.0,2128.5,-353
13794,2159,2434,0.0,2296.5,-275
13795,2311,2132,0.5,2221.5,179
13796,2091,2232,0.0,2161.5,-141
13797,2167,1983,1.0,2075.0,184
13798,2075,2368,0.0,2221.5,-293
13799,2351,2072,0.5,2211.5,279
13800,1993,2160,0.5,2076.5,-167
13801,2095,1937,1.0,2016.0,158
13802,2218,2139,1.0,2178.5,79
13803,1992,2162,0.0,2077.0,-170
13804,1818,1939,1.0,1878.5,-121
13805,2091,2384,0.0,2237.5,-293
13806,2242,1927,0.0,2084.5,315
13807,1896,2132,0.0,2014.0,-236
13808,2109,1782,1.0,1945.5,327
13809,2193,2066,0.5,2129.5,127
13810,2103,2067,1.0,2085.0,36
13811,2050,2234,0.0,2142.0,-184
13812,2165,1990,0.5,2077.5,175
13813,1882,2319,1.0,2100.5,-437
13814,2280,1910,0.5,2095.0,370
13815,1834,2066,0.5,1950.0,-232
13816,1981,1778,0.0,1879.5,203
13817,1993,1977,1.0,1985.0,16
13818,2026,1845,1.0,1935.5,181
13819,1806,1801,1.0,1803.5,5
13820,2178,2004,1.0,2091.0,174
13821,1990,2116,0.0,2053.0,-126
13822,2152,2105,0.0,2128.5,47
13823,2104,1927,0.5,2015.5,177
13824,2251,1687,1.0,1969.0,564
13825,1923,2306,0.0,2114.5,-383
13826,2226,1927,1.0,2076.5,299
13827,1921,2203,0.0,2062.0,-282
13828,1981,2231,0.0,2106.0,-250
13829,2187,1843,1.0,2015.0,344
13830,1738,1996,0.0,1867.0,-258
13831,2006,1828,1.0,1917.0,178
13832,2199,2235,1.0,2217.0,-36
13833,2230,2186,0.5,2208.0,44
13834,2156,2235,0.5,2195.5,-79
13835,1954,1931,0.0,1942.5,23
13836,2062,2297,0.5,2179.5,-235
13837,2185,1885,1.0,2035.0,300
13838,2035,2258,0.5,2146.5,-223
13839,2160,1709,1.0,1934.5,451
13840,1987,1970,1.0,1978.5,17
13841,1881,1949,0.5,1915.0,-68
13842,1942,2117,0.5,2029.5,-175
13843,2022,1916,0.0,1969.0,106
13844,1810,1967,0.5,1888.5,-157
13845,1541,1753,0.0,1647.0,-212
13846,2254,1909,0.0,2081.5,345
13847,2023,2058,0.0,2040.5,-35
13848,2120,1705,1.0,1912.5,415
13849,1741,2090,0.0,1915.5,-349
13850,1840,2281,0.0,2060.5,-441
13851,1957,1889,1.0,1923.0,68
13852,1949,1832,0.0,1890.5,117
13853,1737,1727,1.0,1732.0,10
13854,2101,2174,0.0,2137.5,-73
13855,2011,1693,1.0,1852.0,318
13856,1808,2076,0.0,1942.0,-268
13857,2002,1952,1.0,1977.0,50
13858,1762,1827,1.0,1794.5,-65
13859,1838,2035,0.5,1936.5,-197
13860,1755,1682,1.0,1718.5,73
13861,1713,1788,0.5,1750.5,-75
13862,2024,2094,0.5,2059.0,-70
13863,1978,2040,0.5,2009.0,-62
13864,2061,1939,0.0,2000.0,122
13865,1655,2115,0.0,1885.0,-460
13866,1634,2121,0.0,1877.5,-487
13867,1819,1627,0.0,1723.0,192
13868,1586,1830,0.5,1708.0,-244
13869,2158,1923,1.0,2040.5,235
13870,1950,2009,0.0,1979.5,-59
13871,1947,1796,1.0,1871.5,151
13872,2057,1999,0.0,2028.0,58
13873,1915,1924,1.0,1919.5,-9
13874,1940,1697,1.0,1818.5,243
13875,1943,1546,1.0,1744.5,397
13876,1688,1810,0.0,1749.0,-122
13877,1949,2220,1.0,2084.5,-271
13878,1575,1583,0.0,1579.0,-8
13879,1891,2087,1.0,1989.0,-196
13880,1818,1498,1.0,1658.0,320
13881,2050,1927,0.5,1988.5,123
13882,1747,1746,1.0,1746.5,1
13883,1839,1638,0.0,1738.5,201
13884,1836,2015,1.0,1925.5,-179
13885,1794,1892,0.5,1843.0,-98
13886,1593,1863,0.5,1728.0,-270
13887,1816,1516,0.0,1666.0,300
13888,1894,1985,1.0,1939.5,-91
13889,1689,1841,0.0,1765.0,-152
13890,1673,1550,0.5,1611.5,123
13891,2026,1730,1.0,1878.0,296
13892,1581,1760,0.5,1670.5,-179
13893,1789,1694,1.0,1741.5,95
13894,1988,2050,0.0,2019.0,-62
13895,1605,1536,0.5,1570.5,69
13896,1522,1760,0.0,1641.0,-238
13897,1604,1542,0.0,1573.0,62
13898,1705,1756,0.0,1730.5,-51
13899,1716,1482,0.0,1599.0,234
13900,1684,1533,1.0,1608.5,151
13901,2171,1923,1.0,2047.0,248
13902,1597,1779,1.0,1688.0,-182
13903,1806,1638,0.5,1722.0,168
13904,1797,1720,1.0,1758.5,77
13905,1594,1492,0.5,1543.0,102
13906,1466,1631,0.0,1548.5,-165
13907,1825,1528,0.0,1676.5,297
13908,1946,2294,0.5,2120.0,-348
13909,1994,1796,1.0,1895.0,198
13910,1657,1837,0.0,1747.0,-180
13911,1632,1667,0.5,1649.5,-35
13912,2070,2078,0.5,2074.0,-8
13913,1797,1954,1.0,1875.5,-157
13914,1933,1761,0.5,1847.0,172
13915,1501,1844,0.0,1672.5,-343
13916,2599,2442,1.0,2520.5,157
13917,2411,2549,0.0,2480.0,-138
13918,2528,2284,0.5,2406.0,244
13919,2261,2449,0.5,2355.0,-188
13920,2503,2530,0.5,2516.5,-27
13921,2507,2371,1.0,2439.0,136
13922,2379,2524,0.5,2451.5,-145
13923,2489,2271,1.0,2380.0,218
13924,2291,2329,0.5,2310.0,-38
13925,2178,2267,0.0,2222.5,-89
13926,2216,2185,1.0,2200.5,31
13927,2143,2165,1.0,2154.0,-22
13928,2512,2542,0.0,2527.0,-30
13929,2466,2467,0.5,2466.5,-1
13930,2356,2433,0.5,2394.5,-77
13931,2404,2303,1.0,2353.5,101
13932,2502,2467,0.5,2484.5,35
13933,2412,2317,0.5,2364.5,95
13934,2299,2377,0.0,2338.0,-78
13935,2375,2281,0.5,2328.0,94
13936,2313,2476,0.0,2394.5,-163
13937,2454,2270,0.5,2362.0,184
13938,2249,2349,0.5,2299.0,-100
13939,2338,2218,1.0,2278.0,120
13940,2509,2285,0.0,2397.0,224
13941,2324,2458,0.5,2391.0,-134
13942,2444,2208,0.5,2326.0,236
13943,2205,2432,0.5,2318.5,-227
13944,2295,2304,0.0,2299.5,-9
13945,2277,2174,0.0,2225.5,103
13946,2317,2300,1.0,2308.5,17
13947,2266,2202,0.0,2234.0,64
13948,2464,2606,0.5,2535.0,-142
13949,2260,2385,0.5,2322.5,-125
13950,2306,2240,1.0,2273.0,66
13951,2211,2302,1.0,2256.5,-91
13952,2393,2483,0.5,2438.0,-90
13953,2356,2212,1.0,2284.0,144
13954,2226,2380,0.0,2303.0,-154
13955,2301,2228,0.0,2264.5,73
13956,2422,2520,0.5,2471.0,-98
13957,2216,2417,0.0,2316.5,-201
13958,2355,2118,1.0,2236.5,237
13959,2052,2276,0.0,2164.0,-224
13960,2280,2227,1.0,2253.5,53
13961,2197,2353,0.5,2275.0,-156
13962,2241,2101,0.0,2171.0,140
13963,2057,2222,0.5,2139.5,-165
13964,2066,2259,1.0,2162.5,-193
13965,2276,2103,0.5,2189.5,173
13966,2234,2298,0.0,2266.0,-64
13967,2267,2088,0.0,2177.5,179
13968,2380,2091,1.0,2235.5,289
13969,1991,2352,0.5,2171.5,-361
13970,2372,2061,1.0,2216.5,311
13971,2022,2246,1.0,2134.0,-224
13972,2351,1910,1.0,2130.5,441
13973,1885,2305,0.0,2095.0,-420
13974,2235,1834,1.0,2034.5,401
13975,1778,2151,0.0,1964.5,-373
13976,2434,2242,1.0,2338.0,192
13977,2163,2311,0.0,2237.0,-148
13978,2232,2132,1.0,2182.0,100
13979,2109,2146,0.5,2127.5,-37
13980,2338,2218,1.0,2278.0,120
13981,2162,2327,1.0,2244.5,-165
13982,2239,2143,1.0,2191.0,96
13983,1818,2087,0.5,1952.5,-269
13984,2368,2413,0.5,2390.5,-45
13985,2169,2351,0.5,2260.0,-182
13986,2160,2160,0.0,2160.0,0
13987,1858,2095,0.5,1976.5,-237
13988,2228,2178,1.0,2203.0,50
13989,2116,2170,0.5,2143.0,-54
13990,2212,1927,1.0,2069.5,285
13991,1841,2181,0.0,2011.0,-340
13992,2457,1916,1.0,2186.5,541
13993,1810,2256,0.0,2033.0,-446
13994,2215,1820,1.0,2017.5,395
13995,1753,2237,0.0,1995.0,-484
13996,2164,2294,0.0,2229.0,-130
13997,2341,2189,1.0,2265.0,152
13998,2014,1974,0.5,1994.0,40
13999,1876,2042,0.0,1959.0,-166
14000,2342,2199,0.5,2270.5,143
14001,2186,2261,0.0,2223.5,-75
14002,2130,2156,1.0,2143.0,-26
14003,2102,2057,0.0,2079.5,45
14004,2337,2344,0.5,2340.5,-7
14005,2355,2181,1.0,2268.0,174
14006,2004,2296,0.5,2150.0,-292
14007,2264,2097,1.0,2180.5,167
14008,2251,1987,1.0,2119.0,264
14009,1786,2315,0.0,2050.5,-529
14010,2306,1788,1.0,2047.0,518
14011,2117,2226,0.5,2171.5,-109
14012,2231,2214,1.0,2222.5,17
14013,2179,2187,0.0,2183.0,-8
14014,2033,2037,0.5,2035.0,-4
14015,1968,1996,1.0,1982.0,-28
14016,2258,1993,0.0,2125.5,265
14017,1864,2185,0.5,2024.5,-321
14018,2258,1845,0.5,2051.5,413
14019,1806,2160,0.0,1983.0,-354
14020,2055,2193,0.0,2124.0,-138
14021,2067,1977,0.5,2022.0,90
14022,2026,2036,1.0,2031.0,-10
14023,2254,2346,1.0,2300.0,-92
14024,2128,2058,1.0,2093.0,70
14025,2120,1998,0.5,2059.0,122
14026,2204,2103,0.0,2153.5,101
14027,1957,2281,0.0,2119.0,-324
14028,2105,2004,1.0,2054.5,101
14029,1737,1886,0.5,1811.5,-149
14030,2174,2104,1.0,2139.0,70
14031,2035,2173,0.5,2104.0,-138
14032,2076,2011,0.0,2043.5,65
14033,1788,1755,0.5,1771.5,33
14034,1924,2014,0.0,1969.0,-90
14035,2072,1915,0.5,1993.5,157
14036,1943,1993,0.5,1968.0,-50
14037,1937,1521,1.0,1729.0,416
14038,2159,2132,0.0,2145.5,27
14039,2091,1731,1.0,1911.0,360
14040,1788,2012,0.0,1900.0,-224
14041,2139,2091,0.5,2115.0,48
14042,1927,1992,0.0,1959.5,-65
14043,1939,1896,1.0,1917.5,43
14044,1782,1782,0.0,1782.0,0
14045,1911,2009,0.5,1960.0,-98
14046,1947,1819,1.0,1883.0,128
14047,1830,2009,0.5,1919.5,-179
14048,1999,1732,1.0,1865.5,267
14049,1923,2002,1.0,1962.5,-79
14050,1952,1997,1.0,1974.5,-45
14051,1927,1987,0.0,1957.0,-60
14052,2008,1921,1.0,1964.5,87
14053,2235,2095,1.0,2165.0,140
14054,1918,2230,1.0,2074.0,-312
14055,2235,1841,1.0,2038.0,394
14056,1730,1861,0.5,1795.5,-131
14057,2023,2098,1.0,2060.5,-75
14058,2040,1949,1.0,1994.5,91
14059,2087,2061,0.0,2074.0,26
14060,2115,1891,0.5,2003.0,224
14061,2094,1818,0.5,1956.0,276
14062,1828,1978,0.0,1903.0,-150
14063,1967,2022,1.0,1994.5,-55
14064,1541,1914,0.5,1727.5,-373
14065,1970,1762,0.5,1866.0,208
14066,1885,2062,0.5,1973.5,-177
14067,1881,2035,0.0,1958.0,-154
14068,1721,1942,0.0,1831.5,-221
14069,2070,1890,1.0,1980.0,180
14070,1843,1954,1.0,1898.5,-111
14071,1933,1738,0.5,1835.5,195
14072,1828,1834,0.5,1831.0,-6
14073,2015,1834,1.0,1924.5,181
14074,1894,1836,0.5,1865.0,58
14075,1840,1593,1.0,1716.5,247
14076,1763,2026,0.0,1894.5,-263
14077,1949,1889,1.0,1919.0,60
14078,1923,1898,0.0,1910.5,25
14079,1796,1946,1.0,1871.0,-150
14080,1667,1657,1.0,1662.0,10
14081,1627,2101,0.0,1864.0,-474
14082,1995,1586,1.0,1790.5,409
14083,1547,1808,1.0,1677.5,-261
14084,1482,1684,0.0,1583.0,-202
14085,2050,1533,0.0,1791.5,517
14086,1697,2057,1.0,1877.0,-360
14087,1605,1742,1.0,1673.5,-137
14088,1810,1940,0.0,1875.0,-130
14089,1909,1760,1.0,1834.5,149
14090,1682,1838,0.0,1760.0,-156
14091,1705,2023,0.0,1864.0,-318
14092,1631,1713,0.0,1672.0,-82
14093,1756,1707,1.0,1731.5,49
14094,1772,2171,1.0,1971.5,-399
14095,1779,1689,1.0,1734.0,90
14096,1550,1635,0.5,1592.5,-85
14097,1927,2050,0.0,1988.5,-123
14098,1646,1688,1.0,1667.0,-42
14099,1498,1583,0.5,1540.5,-85
14100,1816,1675,1.0,1745.5,141
14101,1892,1794,0.0,1843.0,98
14102,1516,1839,0.5,1677.5,-323
14103,1798,1670,0.0,1734.0,128
14104,1640,1988,0.0,1814.0,-348
14105,1536,1705,0.0,1620.5,-169
14106,1542,1566,0.0,1554.0,-24
14107,1720,1825,0.0,1772.5,-105
14108,1528,1594,0.5,1561.0,-66
14109,1631,1760,0.0,1695.5,-129
14110,1782,1581,1.0,1681.5,201
14111,1789,1647,0.5,1718.0,142
14112,1797,1492,0.0,1644.5,305
14113,1997,1952,0.0,1974.5,45
14114,1808,1774,0.0,1791.0,34
14115,2319,2294,0.5,2306.5,25
14116,1994,2066,1.0,2030.0,-72
14117,2036,1837,0.5,1936.5,199
14118,1632,1981,0.0,1806.5,-349
14119,1985,1999,1.0,1992.0,-14
14120,2078,1818,1.0,1948.0,260
14121,1894,1797,1.0,1845.5,97
14122,1501,1565,0.0,1533.0,-64
14123,2599,2291,0.5,2445.0,308
14124,2267,2549,0.0,2408.0,-282
14125,2528,2216,0.5,2372.0,312
14126,2165,2424,1.0,2294.5,-259
14127,2476,2530,0.0,2503.0,-54
14128,2507,2454,1.0,2480.5,53
14129,2349,2489,0.5,2419.0,-140
14130,2448,2338,1.0,2393.0,110
14131,2542,2467,0.5,2504.5,75
14132,2412,2442,0.0,2427.0,-30
14133,2433,2377,0.5,2405.0,56
14134,2375,2404,0.5,2389.5,-29
14135,2285,2442,0.0,2363.5,-157
14136,2284,2324,0.0,2304.0,-40
14137,2245,2261,0.5,2253.0,-16
14138,2253,2208,1.0,2230.5,45
14139,2503,2295,1.0,2399.0,208
14140,2174,2379,0.0,2276.5,-205
14141,2396,2317,0.5,2356.5,79
14142,2202,2271,0.0,2236.5,-69
14143,2483,2422,1.0,2452.5,61
14144,2417,2356,0.5,2386.5,61
14145,2337,2355,0.5,2346.0,-18
14146,2276,2380,0.0,2328.0,-104
14147,2329,2338,0.5,2333.5,-9
14148,2327,2147,1.0,2237.0,180
14149,2185,2239,1.0,2212.0,-54
14150,2087,2143,0.5,2115.0,-56
14151,2434,2512,1.0,2473.0,-78
14152,2467,2311,0.5,2389.0,156
14153,2232,2356,0.5,2294.0,-124
14154,2341,2167,1.0,2254.0,174
14155,2413,2606,1.0,2509.5,-193
14156,2260,2169,0.5,2214.5,91
14157,2160,2240,1.0,2200.0,-80
14158,2211,1858,1.0,2034.5,353
14159,2464,2502,0.5,2483.0,-38
14160,2317,2385,1.0,2351.0,-68
14161,2289,2299,0.5,2294.0,-10
14162,2313,2306,1.0,2309.5,7
14163,2402,2411,1.0,2406.5,-9
14164,2351,2380,0.0,2365.5,-29
14165,2352,2305,0.5,2328.5,47
14166,2235,2372,0.0,2303.5,-137
14167,2313,2066,1.0,2189.5,247
14168,2103,2270,0.5,2186.5,-167
14169,2237,2234,1.0,2235.5,3
14170,2088,2249,0.0,2168.5,-161
14171,2547,2393,1.0,2470.0,154
14172,2212,2458,1.0,2335.0,-246
14173,2444,2228,0.5,2336.0,216
14174,2172,2432,0.0,2302.0,-260
14175,2341,2457,0.5,2399.0,-116
14176,2336,1974,0.5,2155.0,362
14177,1938,2256,1.0,2097.0,-318
14178,2237,1876,1.0,2056.5,361
14179,2392,2228,1.0,2310.0,164
14180,2170,2304,1.0,2237.0,-134
14181,2277,2253,0.5,2265.0,24
14182,2212,2300,0.5,2256.0,-88
14183,2231,2342,0.5,2286.5,-111
14184,2261,2187,1.0,2224.0,74
14185,2033,2130,0.0,2081.5,-97
14186,2057,2006,1.0,2031.5,51
14187,2520,2251,1.0,2385.5,269
14188,2315,2216,0.0,2265.5,99
14189,2052,2306,0.0,2179.0,-254
14190,2226,2053,1.0,2139.5,173
14191,2344,2211,1.0,2277.5,133
14192,2227,2355,0.0,2291.0,-128
14193,2296,2197,1.0,2246.5,99
14194,2101,2264,0.5,2182.5,-163
14195,2259,2280,1.0,2269.5,-21
14196,2353,2276,1.0,2314.5,77
14197,2298,2305,0.5,2301.5,-7
14198,2222,2241,0.5,2231.5,-19
14199,2091,1882,0.5,1986.5,209
14200,1910,1991,0.5,1950.5,-81
14201,2061,1834,0.0,1947.5,227
14202,1778,2022,0.0,1900.0,-244
14203,2218,2159,0.5,2188.5,59
14204,2132,2162,0.0,2147.0,-30
14205,2143,2091,1.0,2117.0,52
14206,1983,1818,1.0,1900.5,165
14207,2384,2258,1.0,2321.0,126
14208,2297,2242,1.0,2269.5,55
14209,2132,2185,0.0,2158.5,-53
14210,2160,2109,1.0,2134.5,51
14211,2158,2254,0.0,2206.0,-96
14212,2058,1947,0.5,2002.5,111
14213,2009,2090,1.0,2049.5,-81
14214,2103,1999,0.5,2051.0,104
14215,2204,2368,0.5,2286.0,-164
14216,2164,2004,0.5,2084.0,160
14217,1990,2160,1.0,2075.0,-170
14218,2095,2105,0.0,2100.0,-10
14219,2193,1993,0.0,2093.0,200
14220,1864,2067,0.0,1965.5,-203
14221,2050,1845,1.0,1947.5,205
14222,1801,1990,1.0,1895.5,-189
14223,2075,2139,0.0,2107.0,-64
14224,1992,2014,0.5,2003.0,-22
14225,1993,1939,1.0,1966.0,54
14226,1782,1937,0.0,1859.5,-155
14227,2178,2174,0.0,2176.0,4
14228,2011,2116,1.0,2063.5,-105
14229,1927,2076,0.5,2001.5,-149
14230,2173,1841,1.0,2007.0,332
14231,2189,2164,1.0,2176.5,25
14232,1755,2035,0.0,1895.0,-280
14233,2014,2028,1.0,2021.0,-14
14234,2235,1788,1.0,2011.5,447
14235,1894,1836,0.5,1865.0,58
14236,2235,2230,1.0,2232.5,5
14237,1593,1863,0.0,1728.0,-270
14238,2199,1954,1.0,2076.5,245
14239,1967,2022,0.0,1994.5,-55
14240,2156,2186,1.0,2171.0,-30
14241,2214,2102,0.5,2158.0,112
14242,2066,2319,1.0,2192.5,-253
14243,2074,2179,1.0,2126.5,-105
14244,1981,2036,1.0,2008.5,-55
14245,2024,2037,1.0,2030.5,-13
14246,2061,2040,1.0,2050.5,21
14247,2002,2115,1.0,2058.5,-113
14248,1894,1818,0.0,1856.0,76
14249,1987,1952,0.0,1969.5,35
14250,1565,2008,0.0,1786.5,-443
14251,1987,2055,0.0,2021.0,-68
14252,1977,1949,0.0,1963.0,28
14253,1786,2026,0.5,1906.0,-240
14254,1916,1788,0.5,1852.0,128
14255,1889,1840,0.5,1864.5,49
14256,1820,1810,0.0,1815.0,10
14257,1898,1949,1.0,1923.5,-51
14258,1707,1654,0.0,1680.5,53
14259,2128,2346,1.0,2237.0,-218
14260,1952,1998,1.0,1975.0,-46
14261,2062,1981,1.0,2021.5,81
14262,1890,1885,1.0,1887.5,5
14263,2035,1843,0.5,1939.0,192
14264,1828,1721,0.0,1774.5,107
14265,2091,1970,1.0,2030.5,121
14266,1896,1927,0.5,1911.5,-31
14267,1942,1782,0.5,1862.0,160
14268,2281,2121,1.0,2201.0,160
14269,1911,1957,0.5,1934.0,-46
14270,1886,1830,1.0,1858.0,56
14271,1732,1832,0.5,1782.0,-100
14272,2023,2070,1.0,2046.5,-47
14273,1933,1705,0.5,1819.0,228
14274,1741,1844,1.0,1792.5,-103
14275,1834,1762,1.0,1798.0,72
14276,1731,1684,1.0,1707.5,47
14277,1788,1533,1.0,1660.5,255
14278,1946,1924,0.5,1935.0,22
14279,1915,1796,0.0,1855.5,119
14280,1657,1546,0.0,1601.5,111
14281,1943,1667,1.0,1805.0,276
14282,1688,1923,0.0,1805.5,-235
14283,1997,1646,1.0,1821.5,351
14284,1583,1927,0.5,1755.0,-344
14285,1921,1498,1.0,1709.5,423
14286,2220,1927,1.0,2073.5,293
14287,2050,2023,0.0,2036.5,27
14288,1949,1746,1.0,1847.5,203
14289,1839,1891,0.0,1865.0,-52
14290,1978,2094,1.0,2036.0,-116
14291,1828,1939,1.0,1883.5,-111
14292,2171,1640,0.0,1905.5,531
14293,1742,2050,1.0,1896.0,-308
14294,1597,1779,0.0,1688.0,-182
14295,1760,1605,1.0,1682.5,155
14296,1834,1638,0.0,1736.0,196
14297,1697,2057,1.0,1877.0,-360
14298,1638,1940,0.0,1789.0,-302
14299,1586,1634,1.0,1610.0,-48
14300,2095,1762,0.5,1928.5,333
14301,1995,2101,0.5,2048.0,-106
14302,1841,1918,0.0,1879.5,-77
14303,1760,1730,1.0,1745.0,30
14304,1892,1782,1.0,1837.0,110
14305,1694,1794,0.5,1744.0,-100
14306,1516,1789,0.0,1652.5,-273
14307,1950,1923,1.0,1936.5,27
14308,1825,1647,1.0,1736.0,178
14309,1682,1838,1.0,1760.0,-156
14310,1988,1713,1.0,1850.5,275
14311,1772,1536,0.0,1654.0,236
14312,1522,1689,1.0,1605.5,-167
14313,1550,1542,0.0,1546.0,8
14314,1997,1670,1.0,1833.5,327
14315,1492,1797,0.0,1644.5,-305
14316,1808,1728,1.0,1768.0,80
14317,1720,1774,0.0,1747.0,-54
14318,1631,1594,0.0,1612.5,37
14319,1923,1806,0.0,1864.5,117
14320,1999,2026,1.0,2012.5,-27
14321,1763,2078,0.0,1920.5,-315
14322,1837,2097,1.0,1967.0,-260
14323,2294,1761,0.0,2027.5,533
14324,2181,2337,1.0,2259.0,-156
14325,1837,1994,0.5,1915.5,-157
14326,1801,2097,1.0,1949.0,-296
14327,2530,1643,1.0,2086.5,887
14328,2267,2291,0.0,2279.0,-24
14329,2524,2507,1.0,2515.5,17
14330,2165,2216,0.0,2190.5,-51
14331,2502,2489,0.5,2495.5,13
14332,2549,2599,1.0,2574.0,-50
14333,2281,2317,1.0,2299.0,-36
14334,2449,2528,1.0,2488.5,-79
14335,2542,2313,1.0,2427.5,229
14336,2356,2483,0.5,2419.5,-127
14337,2442,2466,1.0,2454.0,-24
14338,2380,2337,0.0,2358.5,43
14339,2442,2433,0.0,2437.5,9
14340,2379,2503,0.5,2441.0,-124
14341,2284,2411,1.0,2347.5,-127
14342,2271,2396,1.0,2333.5,-125
14343,2467,2253,0.0,2360.0,214
14344,2454,2476,1.0,2465.0,-22
14345,2377,2412,1.0,2394.5,-35
14346,2338,2349,0.5,2343.5,-11
14347,2413,2375,1.0,2394.0,38
14348,2380,2402,1.0,2391.0,-22
14349,2030,2169,0.0,2099.5,-139
14350,2372,2352,0.5,2362.0,20
14351,2329,2160,0.0,2244.5,169
14352,2270,2313,1.0,2291.5,-43
14353,2147,2178,0.5,2162.5,-31
14354,2249,2237,1.0,2243.0,12
14355,2422,2185,0.0,2303.5,237
14356,2509,2547,0.0,2528.0,-38
14357,2355,2417,0.5,2386.0,-62
14358,2432,2444,1.0,2438.0,-12
14359,2512,2252,1.0,2382.0,260
14360,2174,2295,0.5,2234.5,-121
14361,2341,2467,1.0,2404.0,-126
14362,2202,2317,0.5,2259.5,-115
14363,2342,2303,1.0,2322.5,39
14364,2324,2285,0.0,2304.5,39
14365,2130,2261,0.5,2195.5,-131
14366,2208,2245,1.0,2226.5,-37
14367,2338,2057,0.0,2197.5,281
14368,2311,2434,1.0,2372.5,-123
14369,2239,2327,1.0,2283.0,-88
14370,2146,2232,1.0,2189.0,-86
14371,2228,2087,0.0,2157.5,141
14372,2355,2344,0.5,2349.5,11
14373,2253,2170,1.0,2211.5,83
14374,2264,2296,0.5,2280.0,-32
14375,2457,2212,0.0,2334.5,245
14376,2162,2218,1.0,2190.0,-56
14377,2215,2336,0.0,2275.5,-121
14378,2103,2237,0.0,2170.0,-134
14379,2304,2392,0.0,2348.0,-88
14380,2088,2234,0.0,2161.0,-146
14381,2266,2277,0.0,2271.5,-11
14382,2606,2165,0.0,2385.5,441
14383,2315,2251,0.5,2283.0,64
14384,2240,2260,0.0,2250.0,-20
14385,2226,2306,1.0,2266.0,-80
14386,2520,2211,0.5,2365.5,309
14387,2385,2464,1.0,2424.5,-79
14388,2052,2216,0.0,2134.0,-164
14389,2302,2289,1.0,2295.5,13
14390,2411,2053,0.0,2232.0,358
14391,2004,2204,0.0,2104.0,-200
14392,2235,2305,1.0,2270.0,-70
14393,2104,2105,0.0,2104.5,-1
14394,2280,2151,0.5,2215.5,129
14395,2341,2294,1.0,2317.5,47
14396,2305,2353,1.0,2329.0,-48
14397,1938,1974,0.0,1956.0,-36
14398,2258,2241,0.5,2249.5,17
14399,2014,2075,1.0,2044.5,-61
14400,2185,2297,1.0,2241.0,-112
14401,1993,2072,1.0,2032.5,-79
14402,2259,2160,0.0,2209.5,99
14403,2187,2231,0.0,2209.0,-44
14404,2298,2276,1.0,2287.0,22
14405,2006,1996,0.0,2001.0,10
14406,1993,2241,0.0,2117.0,-248
14407,2226,2212,1.0,2219.0,14
14408,1845,1864,0.0,1854.5,-19
14409,2172,2228,1.0,2200.0,-56
14410,2319,1806,0.0,2062.5,513
14411,1991,2091,0.0,2041.0,-100
14412,2066,2280,1.0,2173.0,-214
14413,2022,2061,1.0,2041.5,-39
14414,2337,2036,1.0,2186.5,301
14415,2230,2235,1.0,2232.5,-5
14416,2004,2181,0.5,2092.5,-177
14417,1861,2235,0.0,2048.0,-374
14418,2227,2097,0.0,2162.0,130
14419,2067,2193,0.5,2130.0,-126
14420,2101,2197,0.0,2149.0,-96
14421,2036,2050,1.0,2043.0,-14
14422,2254,2057,0.5,2155.5,197
14423,2186,2199,1.0,2192.5,-13
14424,2120,2058,1.0,2089.0,62
14425,2102,2156,0.5,2129.0,-54
14426,1882,2103,0.0,1992.5,-221
14427,2189,2164,1.0,2176.5,25
14428,1834,1910,0.5,1872.0,-76
14429,2014,2028,0.5,2021.0,-14
14430,2174,1778,0.0,1976.0,396
14431,1952,2002,1.0,1977.0,-50
14432,2076,2011,1.0,2043.5,65
14433,2008,1987,0.0,1997.5,21
14434,2158,2024,0.0,2091.0,134
14435,2040,2009,0.0,2024.5,31
14436,1947,2061,0.0,2004.0,-114
14437,2115,2009,1.0,2062.0,106
14438,2055,1840,1.0,1947.5,215
14439,1889,1977,0.0,1933.0,-88
14440,2026,1949,0.5,1987.5,77
14441,2368,2384,0.5,2376.0,-16
14442,2163,2351,1.0,2257.0,-188
14443,2164,2132,0.0,2148.0,32
14444,2109,2160,0.0,2134.5,-51
14445,2346,2062,1.0,2204.0,284
14446,1885,2128,0.0,2006.5,-243
14447,1998,2035,1.0,2016.5,-37
14448,1721,1952,0.0,1836.5,-231
14449,2139,2159,1.0,2149.0,-20
14450,2132,1992,0.0,2062.0,140
14451,1939,2091,0.0,2015.0,-152
14452,2012,1782,1.0,1897.0,230
14453,1924,2281,0.0,2102.5,-357
14454,1957,1915,0.0,1936.0,42
14455,1546,1886,0.0,1716.0,-340
14456,1832,1943,1.0,1887.5,-111
14457,2023,1909,0.5,1966.0,114
14458,1731,1705,1.0,1718.0,26
14459,1741,1788,1.0,1764.5,-47
14460,2178,2220,0.0,2199.0,-42
14461,2023,2116,0.5,2069.5,-93
14462,2152,1949,1.0,2050.5,203
14463,2087,1927,0.0,2007.0,160
14464,2101,1923,1.0,2012.0,178
14465,1997,1995,0.5,1996.0,2
14466,1693,1927,1.0,1810.0,-234
14467,2050,1987,0.5,2018.5,63
14468,1949,1742,1.0,1845.5,207
14469,1605,1786,1.0,1695.5,-181
14470,1788,1760,0.0,1774.0,28
14471,2173,2035,1.0,2104.0,138
14472,1762,1788,0.0,1775.0,-26
14473,1818,2091,0.0,1954.5,-273
14474,1747,1896,0.0,1821.5,-149
14475,2094,1916,0.0,2005.0,178
14476,1810,1978,0.5,1894.0,-168
14477,1939,1820,1.0,1879.5,119
14478,1753,1828,0.0,1790.5,-75
14479,2022,1970,0.5,1996.0,52
14480,1914,1967,1.0,1940.5,-53
14481,1942,1541,1.0,1741.5,401
14482,1985,2015,1.0,2000.0,-30
14483,1836,1818,1.0,1827.0,18
14484,1894,1894,1.0,1894.0,0
14485,1981,1707,0.5,1844.0,274
14486,1756,1890,0.5,1823.0,-134
14487,1843,1716,1.0,1779.5,127
14488,2121,1738,1.0,1929.5,383
14489,1782,1760,1.0,1771.0,22
14490,1830,1911,1.0,1870.5,-81
14491,1694,1581,0.0,1637.5,113
14492,1954,2070,1.0,2012.0,-116
14493,2005,1933,0.0,1969.0,72
14494,1946,1482,1.0,1714.0,464
14495,1684,1796,1.0,1740.0,-112
14496,1657,1533,0.5,1595.0,124
14497,1520,1667,1.0,1593.5,-147
14498,1923,2095,0.0,2009.0,-172
14499,1918,1950,1.0,1934.0,-32
14500,1796,1673,0.0,1734.5,123
14501,1730,1988,0.0,1859.0,-258
14502,1536,1892,0.0,1714.0,-356
14503,1794,1566,1.0,1680.0,228
14504,1542,1516,1.0,1529.0,26
14505,1634,2171,0.0,1902.5,-537
14506,1779,1627,0.0,1703.0,152
14507,1586,1635,1.0,1610.5,-49
14508,1597,1547,0.0,1572.0,50
14509,1638,1834,1.0,1736.0,-196
14510,1816,1675,0.5,1745.5,141
14511,1646,1688,1.0,1667.0,-42
14512,1575,1583,1.0,1579.0,-8
14513,1798,1839,1.0,1818.5,-41
14514,1682,1838,0.0,1760.0,-156
14515,1728,1997,1.0,1862.5,-269
14516,1774,1808,1.0,1791.0,-34
14517,2050,1927,0.0,1988.5,123
14518,2026,1746,1.0,1886.0,280
14519,1647,1763,1.0,1705.0,-116
14520,1825,1528,1.0,1676.5,297
14521,1806,1923,1.0,1864.5,-117
14522,1466,1492,0.0,1479.0,-26
14523,1689,1772,1.0,1730.5,-83
14524,1670,1550,1.0,1610.0,120
14525,1631,1594,1.0,1612.5,37
14526,2214,1999,0.5,2106.5,215
14527,2078,2074,1.0,2076.0,4
14528,2037,1797,0.0,1917.0,240
14529,1761,1968,1.0,1864.5,-207
14530,2057,1994,0.5,2025.5,63
14531,1837,1697,0.0,1767.0,140
14532,1940,1632,1.0,1786.0,308
14533,1643,1810,0.0,1726.5,-167
14534,1892,1635,1.0,1763.5,257
14535,2480,1985,1.0,2232.5,495
14536,1956,2462,0.0,2209.0,-506
14537,2476,1801,1.0,2138.5,675
14538,1839,2335,0.0,2087.0,-496
14539,2012,2385,1.0,2198.5,-373
14540,2319,1904,1.0,2111.5,415
14541,1884,2229,0.0,2056.5,-345
14542,2224,1780,1.0,2002.0,444
14543,2328,2015,0.5,2171.5,313
14544,1909,2305,0.0,2107.0,-396
14545,2112,1838,1.0,1975.0,274
14546,1794,2182,0.0,1988.0,-388
14547,2006,2282,0.5,2144.0,-276
14548,2230,1885,1.0,2057.5,345
14549,1812,2184,0.0,1998.0,-372
14550,2237,1784,1.0,2010.5,453
14551,2358,1863,1.0,2110.5,495
14552,1810,2221,0.0,2015.5,-411
14553,2140,1702,1.0,1921.0,438
14554,1643,2129,0.0,1886.0,-486
14555,2184,2308,0.0,2246.0,-124
14556,2286,1749,1.0,2017.5,537
14557,1718,2188,0.0,1953.0,-470
14558,2091,1675,1.0,1883.0,416
14559,2275,1691,1.0,1983.0,584
14560,2000,2200,0.0,2100.0,-200
14561,2158,1814,1.0,1986.0,344
14562,1798,2154,0.0,1976.0,-356
14563,1849,2326,0.0,2087.5,-477
14564,2097,1912,1.0,2004.5,185
14565,1892,2171,0.0,2031.5,-279
14566,2179,1639,1.0,1909.0,540
14567,2402,1756,1.0,2079.0,646
14568,1893,2195,0.0,2044.0,-302
14569,2067,1784,1.0,1925.5,283
14570,1749,2002,0.0,1875.5,-253
14571,2108,2218,0.0,2163.0,-110
14572,2106,2164,1.0,2135.0,-58
14573,2124,1939,1.0,2031.5,185
14574,2331,1914,1.0,2122.5,417
14575,1766,2073,1.0,1919.5,-307
14576,2097,1765,1.0,1931.0,332
14577,1845,2030,0.0,1937.5,-185
14578,2125,2108,1.0,2116.5,17
14579,1756,1782,0.0,1769.0,-26
14580,2137,2109,0.0,2123.0,28
14581,2198,1635,1.0,1916.5,563
14582,1714,1751,0.0,1732.5,-37
14583,2124,2126,1.0,2125.0,-2
14584,1669,1696,0.0,1682.5,-27
14585,1832,2028,0.0,1930.0,-196
14586,2126,2129,1.0,2127.5,-3
14587,1970,1942,0.0,1956.0,28
14588,2017,2027,1.0,2022.0,-10
14589,2252,1702,1.0,1977.0,550
14590,1847,2188,0.0,2017.5,-341
14591,1860,1871,0.0,1865.5,-11
14592,1646,2273,0.0,1959.5,-627
14593,2228,1514,1.0,1871.0,714
14594,1475,1893,0.0,1684.0,-418
14595,1896,1383,1.0,1639.5,513
14596,2081,1869,0.0,1975.0,212
14597,2049,2040,1.0,2044.5,9
14598,1953,1945,0.5,1949.0,8
14599,2032,2134,1.0,2083.0,-102
14600,2191,1861,1.0,2026.0,330
14601,1928,1990,0.0,1959.0,-62
14602,1968,1749,1.0,1858.5,219
14603,2402,1827,1.0,2114.5,575
14604,2462,2480,0.5,2471.0,-18
14605,2067,2195,0.0,2131.0,-128
14606,2292,2335,1.0,2313.5,-43
14607,2146,1919,0.5,2032.5,227
14608,2221,2358,1.0,2289.5,-137
14609,2126,2129,1.0,2127.5,-3
14610,2129,2188,1.0,2158.5,-59
14611,2308,2017,1.0,2162.5,291
14612,2126,2198,1.0,2162.0,-72
14613,2188,2286,1.0,2237.0,-98
14614,2028,2124,1.0,2076.0,-96
14615,2273,2091,0.0,2182.0,182
14616,2200,2275,1.0,2237.5,-75
14617,1893,2228,0.5,2060.5,-335
14618,2154,2158,1.0,2156.0,-4
14619,2326,1896,0.0,2111.0,430
14620,2188,2252,0.5,2220.0,-64
14621,2179,2171,1.0,2175.0,8
14622,1871,2017,0.5,1944.0,-146
14623,2134,1986,0.0,2060.0,148
14624,2305,2328,1.0,2316.5,-23
14625,1861,2032,0.0,1946.5,-171
14626,2182,2287,1.0,2234.5,-105
14627,2282,1958,1.0,2120.0,324
14628,1990,2191,1.0,2090.5,-201
14629,2237,2184,1.0,2210.5,53
14630,1827,1968,0.0,1897.5,-141
14631,2385,2155,0.5,2270.0,230
14632,2073,2331,0.0,2202.0,-258
14633,2229,2319,1.0,2274.0,-90
14634,2030,2097,0.0,2063.5,-67
14635,2108,2224,0.0,2166.0,-116
14636,2141,2218,0.5,2179.5,-77
14637,2109,2125,1.0,2117.0,-16
14638,2124,2164,1.0,2144.0,-40
14639,1869,2060,1.0,1964.5,-191
14640,1659,1525,1.0,1592.0,134
14641,2108,2081,0.0,2094.5,27
14642,2106,2049,1.0,2077.5,57
14643,1945,1939,1.0,1942.0,6
14644,1914,2012,0.5,1963.0,-98
14645,1904,1766,1.0,1835.0,138
14646,1765,1884,0.0,1824.5,-119
14647,1653,1611,1.0,1632.0,42
14648,2015,1845,0.0,1930.0,170
14649,1782,1909,1.0,1845.5,-127
14650,1838,1756,0.0,1797.0,82
14651,1639,1659,1.0,1649.0,-20
14652,1885,2006,1.0,1945.5,-121
14653,1749,1928,0.5,1838.5,-179
14654,1621,1812,1.0,1716.5,-191
14655,1985,1953,0.5,1969.0,32
14656,1801,1956,0.0,1878.5,-155
14657,1985,1832,0.5,1908.5,153
14658,1942,1810,1.0,1876.0,132
14659,1702,1970,0.0,1836.0,-268
14660,1756,1643,0.5,1699.5,113
14661,1749,2184,1.0,1966.5,-435
14662,1784,1893,0.0,1838.5,-109
14663,1675,1718,0.0,1696.5,-43
14664,2000,1749,1.0,1874.5,251
14665,1514,1646,1.0,1580.0,-132
14666,1798,1814,1.0,1806.0,-16
14667,1751,1710,0.0,1730.5,41
14668,1912,1849,0.5,1880.5,63
14669,1696,1714,1.0,1705.0,-18
14670,1639,1892,1.0,1765.5,-253
14671,2328,1612,1.0,1970.0,716
14672,2200,2275,0.5,2237.5,-75
14673,2287,2305,1.0,2296.0,-18
14674,2154,2158,1.0,2156.0,-4
14675,2462,2112,0.5,2287.0,350
14676,2230,2282,0.0,2256.0,-52
14677,2335,2476,0.0,2405.5,-141
14678,2155,2237,0.0,2196.0,-82
14679,2358,2292,0.0,2325.0,66
14680,2319,2385,0.0,2352.0,-66
14681,2188,2221,0.0,2204.5,-33
14682,2201,2229,1.0,2215.0,-28
14683,2252,2140,1.0,2196.0,112
14684,2286,2308,0.5,2297.0,-22
14685,2017,2188,0.5,2102.5,-171
14686,2091,2188,1.0,2139.5,-97
14687,2198,1871,0.5,2034.5,327
14688,2097,2326,0.0,2211.5,-229
14689,2028,2126,0.5,2077.0,-98
14690,2179,2171,1.0,2175.0,8
14691,2146,1841,0.0,1993.5,305
14692,2067,2195,0.5,2131.0,-128
14693,2126,2129,0.5,2127.5,-3
14694,1919,2002,1.0,1960.5,-83
14695,1845,2027,1.0,1936.0,-182
14696,1635,1782,1.0,1708.5,-147
14697,2218,1639,0.5,1928.5,579
14698,2228,2273,1.0,2250.5,-45
14699,2124,2141,1.0,2132.5,-17
14700,1896,1893,1.0,1894.5,3
14701,2191,2063,1.0,2127.0,128
14702,2109,2125,1.0,2117.0,-16
14703,1968,1990,0.0,1979.0,-22
14704,2060,2137,1.0,2098.5,-77
14705,2012,1371,1.0,1691.5,641
14706,1885,2006,0.0,1945.5,-121
14707,1780,1904,1.0,1842.0,-124
14708,1784,1621,1.0,1702.5,163
14709,2331,1653,1.0,1992.0,678
14710,2030,2097,1.0,2063.5,-67
14711,2032,2134,1.0,2083.0,-102
14712,1525,1958,0.0,1741.5,-433
14713,2081,1691,1.0,1886.0,390
14714,2000,2040,1.0,2020.0,-40
14715,2049,1798,0.5,1923.5,251
14716,1710,1945,1.0,1827.5,-235
14717,1849,1985,1.0,1917.0,-136
14718,1956,1912,0.0,1934.0,44
14719,1892,1839,1.0,1865.5,53
14720,2184,1509,1.0,1846.5,675
14721,1942,1832,1.0,1887.0,110
14722,1718,1749,0.0,1733.5,-31
14723,1847,1675,0.0,1761.0,172
14724,1860,1953,1.0,1906.5,-93
14725,1914,1985,1.0,1949.5,-71
14726,1863,1766,0.0,1814.5,97
14727,1643,1702,1.0,1672.5,-59
14728,1751,1611,1.0,1681.0,140
14729,1893,1756,1.0,1824.5,137
14730,1669,1714,0.5,1691.5,-45
14731,1749,1784,0.0,1766.5,-35
14732,1646,1612,1.0,1629.0,34
14733,1383,1514,0.0,1448.5,-131
14734,2385,1749,0.5,2067.0,636
14735,2305,2328,0.0,2316.5,-23
14736,2229,2319,0.5,2274.0,-90
14737,2182,2287,0.5,2234.5,-105
14738,2158,2201,0.0,2179.5,-43
14739,2292,2476,1.0,2384.0,-184
14740,2402,2154,1.0,2278.0,248
14741,1782,1845,0.0,1813.5,-63
14742,2002,2195,0.0,2098.5,-193
14743,1635,1756,0.0,1695.5,-121
14744,2282,1919,1.0,2100.5,363
14745,2126,2198,0.0,2162.0,-72
14746,2184,2230,0.0,2207.0,-46
14747,2097,2124,1.0,2110.5,-27
14748,2188,2286,1.0,2237.0,-98
14749,2179,2171,0.0,2175.0,8
14750,2358,2091,0.0,2224.5,267
14751,2140,2252,1.0,2196.0,-112
14752,2028,2129,0.0,2078.5,-101
14753,2308,2237,1.0,2272.5,71
14754,2188,2326,1.0,2257.0,-138
14755,2462,2188,1.0,2325.0,274
14756,2275,2200,0.5,2237.5,75
14757,2108,2480,0.0,2294.0,-372
14758,1884,2012,0.5,1948.0,-128
14759,2137,2109,1.0,2123.0,28
14760,1653,1780,1.0,1716.5,-127
14761,2273,2060,0.0,2166.5,213
14762,2073,2331,1.0,2202.0,-258
14763,1893,2228,0.0,2060.5,-335
14764,2086,2097,0.0,2091.5,-11
14765,2218,1896,1.0,2057.0,322
14766,1912,1849,1.0,1880.5,63
14767,2164,2141,1.0,2152.5,23
14768,1639,1892,0.5,1765.5,-253
14769,2134,2124,1.0,2129.0,10
14770,2129,2146,1.0,2137.5,-17
14771,1861,2032,0.5,1946.5,-171
14772,2017,2027,1.0,2022.0,-10
14773,1832,1958,0.5,1895.0,-126
14774,1990,2191,1.0,2090.5,-201
14775,1970,1942,0.0,1956.0,28
14776,1827,1968,0.0,1897.5,-141
14777,2000,1869,1.0,1934.5,131
14778,1798,1814,1.0,1806.0,-16
14779,2006,1710,0.5,1858.0,296
14780,2040,2081,1.0,2060.5,-41
14781,1812,1885,0.0,1848.5,-73
14782,1945,2049,1.0,1997.0,-104
14783,1525,1702,0.5,1613.5,-177
14784,1985,1860,1.0,1922.5,125
14785,1696,1751,0.0,1723.5,-55
14786,1810,1863,1.0,1836.5,-53
14787,1612,1669,0.5,1640.5,-57
14788,2184,1643,1.0,1913.5,541
14789,1765,1914,0.0,1839.5,-149
14790,1718,1749,0.0,1733.5,-31
14791,1611,1675,0.0,1643.0,-64
14792,1953,2108,0.0,2030.5,-155
14793,1939,2106,1.0,2022.5,-167
14794,1756,1646,0.5,1701.0,110
14795,1475,1893,0.5,1684.0,-418
14796,1784,1383,1.0,1583.5,401
14797,1838,2015,1.0,1926.5,-177
14798,1749,1928,0.0,1838.5,-179
14799,1659,1794,1.0,1726.5,-135
14800,2328,2480,0.0,2404.0,-152
14801,2462,2305,0.5,2383.5,157
14802,2287,2476,0.0,2381.5,-189
14803,2335,2182,1.0,2258.5,153
14804,2385,2308,1.0,2346.5,77
14805,2286,2229,0.0,2257.5,57
14806,2224,2188,1.0,2206.0,36
14807,2091,2201,0.0,2146.0,-110
14808,2282,2402,0.0,2342.0,-120
14809,2067,2184,0.5,2125.5,-117
14810,2237,2002,0.5,2119.5,235
14811,1919,2155,0.0,2037.0,-236
14812,2326,2012,1.0,2169.0,314
14813,1904,2171,0.0,2037.5,-267
14814,2179,1884,1.0,2031.5,295
14815,1653,1986,0.0,1819.5,-333
14816,2252,2126,1.0,2189.0,126
14817,2124,2188,1.0,2156.0,-64
14818,2017,2028,1.0,2022.5,-11
14819,1841,1871,0.5,1856.0,-30
14820,2331,2129,0.5,2230.0,202
14821,2126,2073,0.0,2099.5,53
14822,2030,2027,1.0,2028.5,3
14823,2017,2086,1.0,2051.5,-69
14824,2358,2108,1.0,2233.0,250
14825,2140,2221,1.0,2180.5,-81
14826,2275,2129,0.5,2202.0,146
14827,1782,1845,0.0,1813.5,-63
14828,2158,2200,0.5,2179.0,-42
14829,1635,1756,0.0,1695.5,-121
14830,2273,2154,1.0,2213.5,119
14831,1810,1863,0.0,1836.5,-53
14832,1893,2228,1.0,2060.5,-335
14833,1643,1702,0.0,1672.5,-59
14834,1832,1896,0.5,1864.0,-64
14835,2032,2134,0.0,2083.0,-102
14836,1970,1942,1.0,1956.0,28
14837,1691,1958,0.0,1824.5,-267
14838,1893,1756,0.0,1824.5,137
14839,1814,2000,0.5,1907.0,-186
14840,1749,1784,1.0,1766.5,-35
14841,2108,1798,1.0,1953.0,310
14842,2040,2081,0.0,2060.5,-41
14843,2137,2125,1.0,2131.0,12
14844,1945,2049,0.0,1997.0,-104
14845,2218,2060,1.0,2139.0,158
14846,1749,2184,0.5,1966.5,-435
14847,2164,2141,1.0,2152.5,23
14848,1675,1718,0.0,1696.5,-43
14849,1849,2124,0.0,1986.5,-275
14850,1968,1990,0.5,1979.0,-22
14851,1892,1912,0.0,1902.0,-20
14852,1371,1827,0.0,1599.0,-456
14853,1751,1639,0.0,1695.0,112
14854,1801,1985,1.0,1893.0,-184
14855,1696,1714,1.0,1705.0,-18
14856,2006,1669,1.0,1837.5,337
14857,1838,1909,1.0,1873.5,-71
14858,1621,1885,0.0,1753.0,-264
14859,1659,1794,0.0,1726.5,-135
14860,1953,1860,0.5,1906.5,93
14861,1766,1914,0.5,1840.0,-148
14862,1928,1765,0.0,1846.5,163
14863,1525,1749,0.0,1637.0,-224
14864,2480,2326,1.0,2403.0,154
14865,2097,2476,0.5,2286.5,-379
14866,2335,2171,0.5,2253.0,164
14867,2179,2292,1.0,2235.5,-113
14868,2282,2385,0.0,2333.5,-103
14869,2319,2230,1.0,2274.5,89
14870,2237,2224,0.0,2230.5,13
14871,2201,2155,0.5,2178.0,46
14872,2252,2328,1.0,2290.0,-76
14873,2305,2188,0.5,2246.5,117
14874,2017,2287,0.0,2152.0,-270
14875,2112,1871,1.0,1991.5,241
14876,2273,2358,0.0,2315.5,-85
14877,2221,2228,1.0,2224.5,-7
14878,1893,2188,1.0,2040.5,-295
14879,2129,1896,0.0,2012.5,233
14880,2402,2331,1.0,2366.5,71
14881,2073,2195,0.5,2134.0,-122
14882,2067,2097,0.5,2082.0,-30
14883,2030,2002,0.0,2016.0,28
14884,2198,2125,1.0,2161.5,73
14885,2109,2124,1.0,2116.5,-15
14886,2028,2137,1.0,2082.5,-109
14887,2060,1841,1.0,1950.5,219
14888,2146,2275,0.5,2210.5,-129
14889,2200,2129,1.0,2164.5,71
14890,2126,2158,1.0,2142.0,-32
14891,2154,2017,0.5,2085.5,137
14892,2308,1832,1.0,2070.0,476
14893,1942,2286,0.0,2114.0,-344
14894,2188,1970,1.0,2079.0,218
14895,2012,2091,0.0,2051.5,-79
14896,2141,2218,0.5,2179.5,-77
14897,1780,1904,0.0,1842.0,-124
14898,2124,2164,1.0,2144.0,-40
14899,2134,1653,0.0,1893.5,481
14900,1782,1845,0.5,1813.5,-63
14901,1958,1861,0.0,1909.5,97
14902,1635,1756,1.0,1695.5,-121
14903,2108,1756,1.0,1932.0,352
14904,2106,1784,1.0,1945.0,322
14905,2191,2000,1.0,2095.5,191
14906,1814,1990,0.0,1902.0,-176
14907,1968,1798,1.0,1883.0,170
14908,1710,1827,1.0,1768.5,-117
14909,1985,1985,0.0,1985.0,0
14910,1956,1810,0.0,1883.0,146
14911,1702,1801,0.0,1751.5,-99
14912,2184,1643,1.0,1913.5,541
14913,2040,2081,0.5,2060.5,-41
14914,1718,1749,0.0,1733.5,-31
14915,1945,2049,1.0,1997.0,-104
14916,1849,1675,1.0,1762.0,174
14917,1639,1892,0.0,1765.5,-253
14918,1914,1509,1.0,1711.5,405
14919,1885,2006,1.0,1945.5,-121
14920,1765,1766,0.0,1765.5,-1
14921,1621,1812,0.0,1716.5,-191
14922,2015,1611,1.0,1813.0,404
14923,1714,1751,0.0,1732.5,-37
14924,1838,1909,1.0,1873.5,-71
14925,1612,1696,0.5,1654.0,-84
14926,1646,1794,0.5,1720.0,-148
14927,1475,1514,0.0,1494.5,-39
14928,1702,1383,1.0,1542.5,319
14929,1928,1847,0.0,1887.5,81
14930,2385,1860,1.0,2122.5,525
14931,2171,2326,0.5,2248.5,-155
14932,2229,2319,0.0,2274.0,-90
14933,1986,2179,0.0,2082.5,-193
14934,2358,2224,0.5,2291.0,134
14935,2462,2480,1.0,2471.0,-18
14936,2140,2221,0.5,2180.5,-81
14937,2335,2476,1.0,2405.5,-141
14938,2328,2129,1.0,2228.5,199
14939,2286,2308,0.5,2297.0,-22
14940,2287,2305,0.5,2296.0,-18
14941,2091,2188,0.0,2139.5,-97
14942,2402,2182,1.0,2292.0,220
14943,2228,2273,0.0,2250.5,-45
14944,2067,2195,0.5,2131.0,-128
14945,1896,1893,1.0,1894.5,3
14946,2218,2002,0.5,2110.0,216
14947,2188,2252,0.0,2220.0,-64
14948,2124,2164,0.5,2144.0,-40
14949,1871,2017,1.0,1944.0,-146
14950,2275,2063,1.0,2169.0,212
14951,2126,2198,1.0,2162.0,-72
14952,2158,2200,0.0,2179.0,-42
14953,2028,2124,0.0,2076.0,-96
14954,2108,2154,0.5,2131.0,-46
14955,2137,2109,1.0,2123.0,28
14956,1845,2060,0.0,1952.5,-215
14957,2073,2331,1.0,2202.0,-258
14958,1635,1782,0.0,1708.5,-147
14959,2086,2097,1.0,2091.5,-11
14960,2146,1639,0.0,1892.5,507
14961,2184,2282,1.0,2233.0,-98
14962,2027,2129,1.0,2078.0,-102
14963,2155,2237,1.0,2196.0,-82
14964,2134,2017,0.0,2075.5,117
14965,1990,2191,0.0,2090.5,-201
14966,1861,2032,1.0,1946.5,-171
14967,1371,1827,0.0,1599.0,-456
14968,1985,2012,0.0,1998.5,-27
14969,1884,1863,0.0,1873.5,21
14970,1702,1780,1.0,1741.0,-78
14971,1653,1643,1.0,1648.0,10
14972,1832,1849,1.0,1840.5,-17
14973,1912,1942,0.0,1927.0,-30
14974,1970,1639,1.0,1804.5,331
14975,1756,2015,0.0,1885.5,-259
14976,1909,1893,0.5,1901.0,16
14977,1784,1838,0.0,1811.0,-54
14978,1659,1617,0.5,1638.0,42
14979,1985,1691,1.0,1838.0,294
14980,2000,1956,1.0,1978.0,44
14981,1801,1814,1.0,1807.5,-13
14982,1798,1839,0.0,1818.5,-41
14983,2081,1702,1.0,1891.5,379
14984,1847,2040,0.0,1943.5,-193
14985,2049,1860,1.0,1954.5,189
14986,2006,1945,0.0,1975.5,61
14987,1749,2184,0.0,1966.5,-435
14988,1812,1885,0.0,1848.5,-73
14989,1675,1718,0.0,1696.5,-43
14990,1766,1914,1.0,1840.0,-148
14991,1869,1646,0.0,1757.5,223
14992,1514,1659,0.0,1586.5,-145
14993,1928,1953,0.0,1940.5,-25
14994,2385,1749,0.5,2067.0,636
14995,2195,2402,0.5,2298.5,-207
14996,2229,2319,0.5,2274.0,-90
14997,1919,2067,0.0,1993.0,-148
14998,2331,2201,0.5,2266.0,130
14999,2462,2480,0.5,2471.0,-18
15000,2097,2073,0.5,2085.0,24
15001,2292,2335,0.5,2313.5,-43
15002,2326,2030,0.5,2178.0,296
15003,2305,2328,1.0,2316.5,-23
15004,2171,2097,0.0,2134.0,74
15005,2182,2287,0.0,2234.5,-105
15006,2252,2179,0.5,2215.5,73
15007,2109,2108,1.0,2108.5,1
15008,2017,2188,0.5,2102.5,-171
15009,2060,2137,0.0,2098.5,-77
15010,2282,1871,0.0,2076.5,411
15011,2141,2218,1.0,2179.5,-77
15012,2184,2230,1.0,2207.0,-46
15013,2124,2164,0.0,2144.0,-40
15014,2308,2155,0.5,2231.5,153
15015,2228,2273,0.0,2250.5,-45
15016,2188,2286,1.0,2237.0,-98
15017,1896,1893,0.0,1894.5,3
15018,2198,2091,0.0,2144.5,107
15019,2221,2358,1.0,2289.5,-137
15020,2124,2126,0.0,2125.0,-2
15021,2140,2188,0.5,2164.0,-48
15022,1832,2028,0.0,1930.0,-196
15023,2200,2275,0.5,2237.5,-75
15024,1970,1942,0.0,1956.0,28
15025,2154,2158,1.0,2156.0,-4
15026,2108,2146,0.0,2127.0,-38
15027,1939,2126,0.5,2032.5,-187
15028,1845,2081,0.0,1963.0,-236
15029,2040,1782,0.5,1911.0,258
15030,1756,2049,1.0,1902.5,-293
15031,1945,1635,1.0,1790.0,310
15032,2015,2134,0.5,2074.5,-119
15033,2032,1909,0.0,1970.5,123
15034,1794,1958,0.5,1876.0,-164
15035,2191,1659,1.0,1925.0,532
15036,1863,1985,0.0,1924.0,-122
15037,1968,1990,0.5,1979.0,-22
15038,1643,1810,1.0,1726.5,-167
15039,1985,1371,0.0,1678.0,614
15040,1904,2012,1.0,1958.0,-108
15041,1839,1801,0.0,1820.0,38
15042,1653,1884,1.0,1768.5,-231
15043,1691,2006,0.0,1848.5,-315
15044,1885,2000,0.0,1942.5,-115
15045,1798,1812,0.5,1805.0,-14
15046,1784,1710,0.0,1747.0,74
15047,1914,1756,1.0,1835.0,158
15048,1893,1765,1.0,1829.0,128
15049,1749,1784,0.5,1766.5,-35
15050,2184,1611,1.0,1897.5,573
15051,1718,1749,1.0,1733.5,-31
15052,1953,1675,1.0,1814.0,278
15053,1702,1646,0.5,1674.0,56
15054,1475,1847,0.5,1661.0,-372
15055,1751,1860,1.0,1805.5,-109
15056,1928,1696,0.0,1812.0,232
15057,1669,1749,0.5,1709.0,-80
15058,2275,1612,0.0,1943.5,663
15059,2319,2385,0.0,2352.0,-66
15060,2158,2200,0.0,2179.0,-42
15061,2201,2229,0.5,2215.0,-28
15062,2480,2154,1.0,2317.0,326
15063,2286,2308,0.0,2297.0,-22
15064,2476,2462,1.0,2469.0,14
15065,2091,2188,0.5,2139.5,-97
15066,2358,2292,0.5,2325.0,66
15067,2305,2328,0.5,2316.5,-23
15068,2140,2221,0.0,2180.5,-81
15069,2112,2287,0.5,2199.5,-175
15070,2326,2129,0.5,2227.5,197
15071,2195,2402,0.5,2298.5,-207
15072,2171,2097,0.5,2134.0,74
15073,2002,2067,0.0,2034.5,-65
15074,2108,2179,0.0,2143.5,-71
15075,2073,2331,1.0,2202.0,-258
15076,2109,2125,0.5,2117.0,-16
15077,2030,2097,0.0,2063.5,-67
15078,2252,2137,1.0,2194.5,115
15079,2184,2230,0.0,2207.0,-46
15080,2017,2188,0.0,2102.5,-171
15081,2155,2237,0.5,2196.0,-82
15082,2218,1871,0.0,2044.5,347
15083,2126,2146,1.0,2136.0,-20
15084,2164,2141,0.0,2152.5,23
15085,2017,2027,1.0,2022.0,-10
15086,2273,2124,0.5,2198.5,149
15087,2126,2198,0.0,2162.0,-72
15088,1893,2228,0.5,2060.5,-335
15089,1841,2028,0.0,1934.5,-187
15090,2012,1896,0.5,1954.0,116
15091,2040,2081,0.0,2060.5,-41
15092,1884,1904,0.0,1894.0,-20
15093,1945,2049,1.0,1997.0,-104
15094,2015,1653,0.0,1834.0,362
15095,1990,2191,0.5,2090.5,-201
15096,1838,1909,0.0,1873.5,-71
15097,1827,1968,0.0,1897.5,-141
15098,2032,1794,0.0,1913.0,238
15099,1958,1861,0.5,1909.5,97
15100,1985,1939,1.0,1962.0,46
15101,1782,1845,0.5,1813.5,-63
15102,1810,1863,0.0,1836.5,-53
15103,1639,1756,1.0,1697.5,-117
15104,1691,1702,0.0,1696.5,-11
15105,1942,1832,1.0,1887.0,110
15106,1798,1814,0.0,1806.0,-16
15107,1756,1710,0.0,1733.0,46
15108,1812,2006,0.0,1909.0,-194
15109,1784,1893,1.0,1838.5,-109
15110,1784,1621,1.0,1702.5,163
15111,1869,1749,0.5,1809.0,120
15112,1765,1766,1.0,1765.5,-1
15113,1847,1985,0.0,1916.0,-138
15114,1860,1839,0.0,1849.5,21
15115,1912,1849,1.0,1880.5,63
15116,1749,1928,0.5,1838.5,-179
15117,1639,1892,0.0,1765.5,-253
15118,1525,1953,0.0,1739.0,-428
15119,1646,1751,0.5,1698.5,-105
15120,1696,1514,1.0,1605.0,182
15121,1383,1669,1.0,1526.0,-286
15122,1393,1562,0.0,1477.5,-169
15123,2840,2695,1.0,2767.5,145
15124,2773,2702,0.5,2737.5,71
15125,2767,2766,0.5,2766.5,1
15126,2750,2785,0.5,2767.5,-35
15127,2736,2755,0.5,2745.5,-19
15128,2808,2780,0.5,2794.0,28
15129,2706,2653,0.5,2679.5,53
15130,2766,2840,0.5,2803.0,-74
15131,2695,2773,0.5,2734.0,-78
15132,2780,2702,1.0,2741.0,78
15133,2653,2767,0.5,2710.0,-114
15134,2755,2706,0.5,2730.5,49
15135,2785,2736,1.0,2760.5,49
15136,2808,2750,1.0,2779.0,58
15137,2840,2653,0.5,2746.5,187
15138,2773,2766,0.5,2769.5,7
15139,2702,2695,0.5,2698.5,7
15140,2767,2755,0.5,2761.0,12
15141,2736,2808,0.5,2772.0,-72
15142,2706,2785,1.0,2745.5,-79
15143,2750,2780,0.5,2765.0,-30
15144,2755,2840,0.0,2797.5,-85
15145,2653,2773,0.5,2713.0,-120
15146,2750,2736,0.5,2743.0,14
15147,2780,2695,1.0,2737.5,85
15148,2808,2706,0.5,2757.0,102
15149,2785,2767,0.5,2776.0,18
15150,2766,2702,0.5,2734.0,64
15151,2840,2785,0.5,2812.5,55
15152,2767,2808,0.0,2787.5,-41
15153,2736,2780,1.0,2758.0,-44
15154,2706,2750,0.0,2728.0,-44
15155,2695,2766,1.0,2730.5,-71
15156,2702,2653,0.0,2677.5,49
15157,2773,2755,0.5,2764.0,18
15158,2467,2612,0.5,2539.5,-145
15159,2697,2584,0.5,2640.5,113
15160,2667,2665,1.0,2666.0,2
15161,2612,2667,0.0,2639.5,-55
15162,2605,2370,1.0,2487.5,235
15163,2603,2499,1.0,2551.0,104
15164,2608,2642,0.5,2625.0,-34
15165,2642,2499,1.0,2570.5,143
15166,2612,2603,0.0,2607.5,9
15167,2667,2605,0.5,2636.0,62
15168,2608,2697,0.5,2652.5,-89
15169,2370,2667,0.0,2518.5,-297
15170,2665,2467,0.5,2566.0,198
15171,2584,2612,0.5,2598.0,-28
15172,2605,2584,0.5,2594.5,21
15173,2667,2667,1.0,2667.0,0
15174,2697,2642,0.5,2669.5,55
15175,2467,2370,1.0,2418.5,97
15176,2499,2612,0.0,2555.5,-113
15177,2612,2608,0.5,2610.0,4
15178,2603,2665,0.0,2634.0,-62
15179,2665,2499,1.0,2582.0,166
15180,2584,2667,1.0,2625.5,-83
15181,2667,2467,1.0,2567.0,200
15182,2608,2605,0.5,2606.5,3
15183,2697,2612,1.0,2654.5,85
15184,2642,2612,0.0,2627.0,30
15185,2370,2603,0.5,2486.5,-233
15186,2612,2665,0.5,2638.5,-53
15187,2605,2697,0.5,2651.0,-92
15188,2603,2667,1.0,2635.0,-64
15189,2667,2608,0.5,2637.5,59
15190,2612,2642,0.5,2627.0,-30
15191,2467,2584,0.0,2525.5,-117
15192,2499,2370,1.0,2434.5,129
15193,1702,2045,0.0,1873.5,-343
15194,2545,2603,0.0,2574.0,-58
15195,2449,2531,0.5,2490.0,-82
15196,2450,2410,1.0,2430.0,40
15197,2346,2573,0.0,2459.5,-227
15198,2418,2273,1.0,2345.5,145
15199,2301,2374,0.5,2337.5,-73
15200,2399,2416,0.0,2407.5,-17
15201,2233,2373,0.5,2303.0,-140
15202,2216,2021,0.5,2118.5,195
15203,2291,2432,0.0,2361.5,-141
15204,2473,2263,1.0,2368.0,210
15205,2369,2491,0.5,2430.0,-122
15206,2661,2474,1.0,2567.5,187
15207,2318,2279,0.5,2298.5,39
15208,2448,2288,1.0,2368.0,160
15209,2397,2325,0.5,2361.0,72
15210,2443,2346,0.5,2394.5,97
15211,1979,2379,0.0,2179.0,-400
15212,2300,2383,0.5,2341.5,-83
15213,2308,2177,1.0,2242.5,131
15214,2651,2591,1.0,2621.0,60
15215,2552,2590,1.0,2571.0,-38
15216,2273,2501,0.0,2387.0,-228
15217,2424,2449,0.0,2436.5,-25
15218,2410,2341,1.0,2375.5,69
15219,2527,2291,1.0,2409.0,236
15220,2346,2340,0.5,2343.0,6
15221,2289,2233,0.0,2261.0,56
15222,2416,2289,1.0,2352.5,127
15223,2233,2301,1.0,2267.0,-68
15224,2486,2450,0.0,2468.0,36
15225,2573,2322,1.0,2447.5,251
15226,2383,2418,0.5,2400.5,-35
15227,2374,2318,0.5,2346.0,56
15228,2288,2399,0.5,2343.5,-111
15229,2324,2397,0.0,2360.5,-73
15230,2346,2373,0.5,2359.5,-27
15231,2432,2308,0.5,2370.0,124
15232,2244,2236,0.5,2240.0,8
15233,2216,2263,0.0,2239.5,-47
15234,2511,2516,1.0,2513.5,-5
15235,2620,2468,0.0,2544.0,152
15236,2411,2348,1.0,2379.5,63
15237,2611,2399,1.0,2505.0,212
15238,2379,2253,1.0,2316.0,126
15239,2285,2366,0.5,2325.5,-81
15240,2405,2222,1.0,2313.5,183
15241,2358,2380,1.0,2369.0,-22
15242,1981,2214,0.0,2097.5,-233
15243,2185,2328,1.0,2256.5,-143
15244,2340,2769,0.0,2554.5,-429
15245,2731,2336,1.0,2533.5,395
15246,2334,2740,0.0,2537.0,-406
15247,2754,2272,1.0,2513.0,482
15248,2789,2482,1.0,2635.5,307
15249,2503,2782,0.0,2642.5,-279
15250,2679,2142,1.0,2410.5,537
15251,2153,2674,0.0,2413.5,-521
15252,2337,2753,0.0,2545.0,-416
15253,2725,2289,1.0,2507.0,436
15254,2298,2746,0.0,2522.0,-448
15255,2717,2189,1.0,2453.0,528
15256,2761,2405,1.0,2583.0,356
15257,2363,2722,0.0,2542.5,-359
15258,2696,2200,1.0,2448.0,496
15259,2187,2688,0.0,2437.5,-501
15260,2709,2209,1.0,2459.0,500
15261,2245,2693,0.0,2469.0,-448
15262,2675,2253,1.0,2464.0,422
15263,2294,2647,0.0,2470.5,-353
15264,2161,2736,0.0,2448.5,-575
15265,2675,2251,1.0,2463.0,424
15266,2302,2646,0.0,2474.0,-344
15267,2639,2236,1.0,2437.5,403
15268,2617,2318,1.0,2467.5,299
15269,2392,2635,0.0,2513.5,-243
15270,2664,2239,1.0,2451.5,425
15271,2174,2623,0.0,2398.5,-449
15272,2384,2671,0.0,2527.5,-287
15273,2669,2301,1.0,2485.0,368
15274,2232,2640,0.0,2436.0,-408
15275,2527,2173,1.0,2350.0,354
15276,2640,2398,1.0,2519.0,242
15277,2340,2684,0.5,2512.0,-344
15278,2614,2223,1.0,2418.5,391
15279,2100,2585,0.0,2342.5,-485
15280,2388,2755,0.0,2571.5,-367
15281,2611,2269,1.0,2440.0,342
15282,2229,2640,0.0,2434.5,-411
15283,2592,2134,1.0,2363.0,458
15284,2651,2396,0.5,2523.5,255
15285,2239,2570,0.0,2404.5,-331
15286,2537,2227,1.0,2382.0,310
15287,2127,2445,0.5,2286.0,-318
15288,2285,2654,0.5,2469.5,-369
15289,2626,2248,1.0,2437.0,378
15290,2205,2640,0.0,2422.5,-435
15291,2618,1909,1.0,2263.5,709
15292,2716,2254,1.0,2485.0,462
15293,2299,2662,0.5,2480.5,-363
15294,2630,2096,1.0,2363.0,534
15295,2153,2566,0.0,2359.5,-413
15296,2348,2623,0.0,2485.5,-275
15297,2636,2175,1.0,2405.5,461
15298,2219,2581,0.0,2400.0,-362
15299,2553,2188,0.5,2370.5,365
15300,2619,2257,1.0,2438.0,362
15301,2248,2630,0.0,2439.0,-382
15302,2605,2196,1.0,2400.5,409
15303,2203,2553,0.0,2378.0,-350
15304,2373,2742,0.0,2557.5,-369
15305,2591,2190,1.0,2390.5,401
15306,2137,2540,0.5,2338.5,-403
15307,2519,2202,1.0,2360.5,317
15308,2623,2354,1.0,2488.5,269
15309,2260,2608,0.5,2434.0,-348
15310,2622,2142,1.0,2382.0,480
15311,2026,2584,0.0,2305.0,-558
15312,2305,2652,0.0,2478.5,-347
15313,2616,2285,1.0,2450.5,331
15314,2208,2565,0.0,2386.5,-357
15315,2524,2077,1.0,2300.5,447
15316,2609,2407,0.5,2508.0,202
15317,2289,2601,0.0,2445.0,-312
15318,2575,2148,1.0,2361.5,427
15319,2031,2497,0.0,2264.0,-466
15320,2334,2651,0.5,2492.5,-317
15321,2628,2111,1.0,2369.5,517
15322,2018,2476,0.0,2247.0,-458
15323,2404,2343,1.0,2373.5,61
15324,2768,2199,1.0,2483.5,569
15325,2216,2585,1.0,2400.5,-369
15326,2548,2109,1.0,2328.5,439
15327,2183,2458,1.0,2320.5,-275
15328,2339,2652,0.0,2495.5,-313
15329,2599,2215,1.0,2407.0,384
15330,2051,2591,0.0,2321.0,-540
15331,2561,2126,1.0,2343.5,435
15332,2662,2215,1.0,2438.5,447
15333,2166,2537,1.0,2351.5,-371
15334,2548,2158,1.0,2353.0,390
15335,2119,2459,0.0,2289.0,-340
15336,2269,2675,0.0,2472.0,-406
15337,2512,2166,1.0,2339.0,346
15338,2149,2582,0.0,2365.5,-433
15339,2430,2099,1.0,2264.5,331
15340,2606,2238,1.0,2422.0,368
15341,2117,2585,0.5,2351.0,-468
15342,2595,2161,1.0,2378.0,434
15343,2146,2536,0.0,2341.0,-390
15344,2183,2631,0.0,2407.0,-448
15345,2601,2128,1.0,2364.5,473
15346,2199,2571,0.0,2385.0,-372
15347,2555,2116,0.5,2335.5,439
15348,2612,2164,0.5,2388.0,448
15349,2190,2552,0.0,2371.0,-362
15350,2625,2034,1.0,2329.5,591
15351,2164,2577,0.0,2370.5,-413
15352,2297,2602,0.0,2449.5,-305
15353,2622,2053,1.0,2337.5,569
15354,2092,2558,0.0,2325.0,-466
15355,2562,2036,1.0,2299.0,526
15356,2618,2172,1.0,2395.0,446
15357,2151,2595,0.0,2373.0,-444
15358,2524,2068,1.0,2296.0,456
15359,2057,2572,0.0,2314.5,-515
15360,2293,2583,0.0,2438.0,-290
15361,2582,2168,1.0,2375.0,414
15362,2004,2450,0.0,2227.0,-446
15363,2633,2060,1.0,2346.5,573
15364,2058,2435,0.0,2246.5,-377
15365,2448,2065,1.0,2256.5,383
15366,2172,2486,0.5,2329.0,-314
15367,2150,2634,0.0,2392.0,-484
15368,2523,2145,1.0,2334.0,378
15369,2119,2509,0.0,2314.0,-390
15370,2499,1929,1.0,2214.0,570
15371,2609,2238,1.0,2423.5,371
15372,1918,2499,0.0,2208.5,-581
15373,2519,2025,1.0,2272.0,494
15374,1950,2410,0.0,2180.0,-460
15375,2120,2584,0.0,2352.0,-464
15376,2543,2020,1.0,2281.5,523
15377,2015,2489,0.0,2252.0,-474
15378,2437,2107,1.0,2272.0,330
15379,2543,2070,1.0,2306.5,473
15380,2204,2567,0.0,2385.5,-363
15381,2568,2047,1.0,2307.5,521
15382,1970,2459,0.0,2214.5,-489
15383,2131,2513,0.0,2322.0,-382
15384,2594,2018,1.0,2306.0,576
15385,1879,2542,0.0,2210.5,-663
15386,2641,2099,1.0,2370.0,542
15387,2034,2545,0.0,2289.5,-511
15388,2516,2071,1.0,2293.5,445
15389,2013,2491,0.0,2252.0,-478
15390,2116,2618,0.5,2367.0,-502
15391,2470,2000,1.0,2235.0,470
15392,1956,2496,0.0,2226.0,-540
15393,2318,2002,1.0,2160.0,316
15394,2087,2448,0.0,2267.5,-361
15395,2430,1999,1.0,2214.5,431
15396,1850,2478,0.0,2164.0,-628
15397,2082,2642,0.0,2362.0,-560
15398,2583,2042,1.0,2312.5,541
15399,2027,2505,0.0,2266.0,-478
15400,2432,2012,1.0,2222.0,420
15401,2595,2082,1.0,2338.5,513
15402,2037,2535,0.0,2286.0,-498
15403,2526,2034,1.0,2280.0,492
15404,1993,2522,0.0,2257.5,-529
15405,2007,2661,0.0,2334.0,-654
15406,2603,2169,1.0,2386.0,434
15407,1994,2431,0.0,2212.5,-437
15408,2419,1963,1.0,2191.0,456
15409,2574,2129,1.0,2351.5,445
15410,1933,2547,0.0,2240.0,-614
15411,2442,1944,1.0,2193.0,498
15412,1868,2430,0.0,2149.0,-562
15413,2050,2531,0.0,2290.5,-481
15414,2550,1932,1.0,2241.0,618
15415,2044,2482,0.0,2263.0,-438
15416,2458,1914,1.0,2186.0,544
15417,2566,2003,1.0,2284.5,563
15418,1930,2566,0.0,2248.0,-636
15419,2478,2119,1.0,2298.5,359
15420,1988,2463,0.0,2225.5,-475
15421,2128,2554,0.0,2341.0,-426
15422,2546,2000,1.0,2273.0,546
15423,1963,2508,0.0,2235.5,-545
15424,2444,1956,1.0,2200.0,488
15425,2555,2170,1.0,2362.5,385
15426,1997,2559,0.0,2278.0,-562
15427,2475,2009,1.0,2242.0,466
15428,1842,2459,0.0,2150.5,-617
15429,2192,2499,0.0,2345.5,-307
15430,2486,1900,1.0,2193.0,586
15431,1890,2484,0.0,2187.0,-594
15432,2464,2030,1.0,2247.0,434
15433,2534,2216,0.0,2375.0,318
15434,2482,2517,1.0,2499.5,-35
15435,1831,1991,0.0,1911.0,-160
15436,2014,2448,0.0,2231.0,-434
15437,2519,2437,1.0,2478.0,82
15438,1940,1909,0.0,1924.5,31
15439,2351,2434,1.0,2392.5,-83
15440,2490,1785,1.0,2137.5,705
15441,1992,1970,0.0,1981.0,22
15442,2510,2489,1.0,2499.5,21
15443,1889,1914,0.0,1901.5,-25
15444,1992,2465,0.0,2228.5,-473
15445,2447,2492,1.0,2469.5,-45
15446,1911,2044,0.0,1977.5,-133
15447,2408,2455,1.0,2431.5,-47
15448,2458,1840,1.0,2149.0,618
15449,2043,2073,0.0,2058.0,-30
15450,2447,2468,1.0,2457.5,-21
15451,1753,1911,0.0,1832.0,-158
15452,2176,2354,0.0,2265.0,-178
15453,2427,2521,1.0,2474.0,-94
15454,1766,2076,0.0,1921.0,-310
15455,1574,2418,1.0,1996.0,-844
15456,2436,1726,1.0,2081.0,710
15457,1852,1796,0.0,1824.0,56
15458,2434,2378,1.0,2406.0,56
15459,2032,2063,0.0,2047.5,-31
15460,1964,2245,0.5,2104.5,-281
15461,2513,2492,1.0,2502.5,21
15462,1908,1675,0.0,1791.5,233
15463,2402,2444,1.0,2423.0,-42
15464,2431,1841,1.0,2136.0,590
15465,2413,2488,1.0,2450.5,-75
15466,1976,1971,0.0,1973.5,5
15467,2095,2439,0.0,2267.0,-344
15468,2439,2444,1.0,2441.5,-5
15469,1787,1943,0.0,1865.0,-156
15470,2233,2345,1.0,2289.0,-112
15471,2458,1781,1.0,2119.5,677
15472,1825,1842,0.0,1833.5,-17
15473,2413,2444,1.0,2428.5,-31
15474,1869,1867,0.0,1868.0,2
15475,1655,2379,0.0,2017.0,-724
15476,2407,2501,0.5,2454.0,-94
15477,2069,2097,0.0,2083.0,-28
15478,2283,2368,1.0,2325.5,-85
15479,2485,1715,1.0,2100.0,770
15480,1986,2013,0.0,1999.5,-27
15481,2406,2453,1.0,2429.5,-47
15482,1656,1717,0.0,1686.5,-61
15483,1924,2401,0.0,2162.5,-477
15484,2434,2455,1.0,2444.5,-21
15485,1889,1861,0.0,1875.0,28
15486,2315,2393,1.0,2354.0,-78
15487,2401,1676,1.0,2038.5,725
15488,1915,1960,0.0,1937.5,-45
15489,2373,2398,1.0,2385.5,-25
15490,1671,1782,0.0,1726.5,-111
15491,1923,2282,0.0,2102.5,-359
15492,2503,2484,1.0,2493.5,19
15493,1723,1877,0.0,1800.0,-154
15494,2288,2432,1.0,2360.0,-144
15495,2564,1800,1.0,2182.0,764
15496,1880,1855,0.0,1867.5,25
15497,2374,2415,1.0,2394.5,-41
15498,1692,1853,0.0,1772.5,-161
15499,2205,2322,0.0,2263.5,-117
15500,2321,2411,1.0,2366.0,-90
15501,1952,1576,0.0,1764.0,376
15502,1860,2327,1.0,2093.5,-467
15503,2377,1793,1.0,2085.0,584
15504,1768,2310,0.0,2039.0,-542
15505,2291,1713,1.0,2002.0,578
15506,1322,2054,0.0,1688.0,-732
15507,2179,2487,0.0,2333.0,-308
15508,2367,2053,1.0,2210.0,314
15509,1899,2366,0.0,2132.5,-467
15510,2329,1758,1.0,2043.5,571
15511,1850,2374,0.0,2112.0,-524
15512,2348,1782,1.0,2065.0,566
15513,1732,2267,0.5,1999.5,-535
15514,1712,2451,0.0,2081.5,-739
15515,2219,1750,1.0,1984.5,469
15516,1768,2401,0.0,2084.5,-633
15517,2049,1651,1.0,1850.0,398
15518,2434,2036,1.0,2235.0,398
15519,2024,2340,0.0,2182.0,-316
15520,2279,1912,1.0,2095.5,367
15521,1880,2230,1.0,2055.0,-350
15522,2314,2506,0.0,2410.0,-192
15523,1918,2115,1.0,2016.5,-197
15524,2308,2255,0.0,2281.5,53
15525,1995,2406,0.0,2200.5,-411
15526,2387,1939,1.0,2163.0,448
15527,2323,2331,1.0,2327.0,-8
15528,2610,1944,1.0,2277.0,666
15529,1910,2212,0.0,2061.0,-302
15530,2150,1762,1.0,1956.0,388
15531,1832,2119,0.0,1975.5,-287
15532,2433,2390,1.0,2411.5,43
15533,1779,1784,0.0,1781.5,-5
15534,2127,2350,1.0,2238.5,-223
15535,2371,1516,1.0,1943.5,855
15536,1592,2350,0.0,1971.0,-758
15537,2247,1615,1.0,1931.0,632
15538,1447,2177,0.0,1812.0,-730
15539,1806,2439,0.0,2122.5,-633
15540,2320,1718,1.0,2019.0,602
15541,2259,2326,1.0,2292.5,-67
15542,2493,1830,1.0,2161.5,663
15543,1534,2280,0.0,1907.0,-746
15544,2340,2241,0.0,2290.5,99
15545,1606,2488,0.0,2047.0,-882
15546,2351,1567,1.0,1959.0,784
15547,2239,2276,1.0,2257.5,-37
15548,2342,2054,1.0,2198.0,288
15549,2240,2335,1.0,2287.5,-95
15550,1899,2178,0.0,2038.5,-279
15551,2345,2546,1.0,2445.5,-201
15552,2187,2239,1.0,2213.0,-52
15553,2458,1678,1.0,2068.0,780
15554,2233,2328,1.0,2280.5,-95
15555,2309,2348,1.0,2328.5,-39
15556,2217,2341,1.0,2279.0,-124
15557,2398,1798,1.0,2098.0,600
15558,1677,2402,0.0,2039.5,-725
15559,2322,1610,1.0,1966.0,712
15560,2665,2347,1.0,2506.0,318
15561,2339,2354,0.0,2346.5,-15
15562,2635,2671,1.0,2653.0,-36
15563,2192,2272,0.0,2232.0,-80
15564,2391,2666,1.0,2528.5,-275
15565,1754,1663,0.0,1708.5,91
15566,2387,2481,1.0,2434.0,-94
15567,1685,1736,0.0,1710.5,-51
15568,2769,2272,1.0,2520.5,497
15569,2453,2485,0.0,2469.0,-32
15570,2740,2808,1.0,2774.0,-68
15571,2401,2406,0.0,2403.5,-5
15572,2455,2754,0.0,2604.5,-299
15573,2789,2808,1.0,2798.5,-19
15574,2434,2454,0.5,2444.0,-20
15575,2674,2679,1.0,2676.5,-5
15576,2737,2393,1.0,2565.0,344
15577,2401,2558,0.0,2479.5,-157
15578,2746,2725,1.0,2735.5,21
15579,2373,2398,0.5,2385.5,-25
15580,2484,2717,0.0,2600.5,-233
15581,2722,2761,1.0,2741.5,-39
15582,2432,2503,0.0,2467.5,-71
15583,2696,2666,1.0,2681.0,30
15584,2564,2265,0.0,2414.5,299
15585,2693,2739,0.5,2716.0,-46
15586,2316,2415,0.0,2365.5,-99
15587,2647,2675,1.0,2661.0,-28
15588,2411,2322,0.5,2366.5,89
15589,2665,2738,1.0,2701.5,-73
15590,2327,2321,1.0,2324.0,6
15591,2666,2671,1.0,2668.5,-5
15592,2736,1860,1.0,2298.0,876
15593,2377,2628,0.0,2502.5,-251
15594,2646,2675,1.0,2660.5,-29
15595,2291,2310,0.0,2300.5,-19
15596,2487,2639,0.5,2563.0,-152
15597,2617,2813,1.0,2715.0,-196
15598,2366,2367,0.0,2366.5,-1
15599,2623,2635,1.0,2629.0,-12
15600,2671,2328,1.0,2499.5,343
15601,2481,2391,0.0,2436.0,90
15602,2640,2669,1.0,2654.5,-29
15603,2272,2387,0.0,2329.5,-115
15604,2755,2527,1.0,2641.0,228
15605,2441,2451,0.0,2446.0,-10
15606,2640,2674,1.0,2657.0,-34
15607,2401,2219,0.0,2310.0,182
15608,2453,2592,0.0,2522.5,-139
15609,2630,2687,1.0,2658.5,-57
15610,2340,2434,0.5,2387.0,-94
15611,2553,2605,1.0,2579.0,-52
15612,2652,2279,1.0,2465.5,373
15613,2387,2406,0.5,2396.5,-19
15614,2561,2591,1.0,2576.0,-30
15615,2331,2294,0.0,2312.5,37
15616,2617,2547,1.0,2582.0,70
15617,2436,2610,0.0,2523.0,-174
15618,2582,2512,1.0,2547.0,70
15619,2150,2212,0.0,2181.0,-62
15620,2602,2430,1.0,2516.0,172
15621,2433,2390,0.5,2411.5,43
15622,2558,2622,1.0,2590.0,-64
15623,2223,2350,0.0,2286.5,-127
15624,2371,2526,0.0,2448.5,-155
15625,2524,2595,1.0,2559.5,-71
15626,2350,2416,0.5,2383.0,-66
15627,2554,2572,1.0,2563.0,-18
15628,2696,2247,1.0,2471.5,449
15629,2320,2439,0.0,2379.5,-119
15630,2582,2583,1.0,2582.5,-1
15631,2326,2273,0.0,2299.5,53
15632,2634,2431,0.5,2532.5,203
15633,2280,2493,0.5,2386.5,-213
15634,2523,2616,1.0,2569.5,-93
15635,2241,2340,0.5,2290.5,-99
15636,2488,2499,0.0,2493.5,-11
15637,2499,2638,1.0,2568.5,-139
15638,2276,2351,0.5,2313.5,-75
15639,2410,2519,1.0,2464.5,-109
15640,2648,2239,1.0,2443.5,409
15641,2342,2422,0.5,2382.0,-80
15642,2489,2543,1.0,2516.0,-54
15643,2240,2335,0.0,2287.5,-95
15644,2458,2437,0.0,2447.5,21
15645,2567,2583,0.0,2575.0,-16
15646,2295,2328,0.0,2311.5,-33
15647,2459,2568,1.0,2513.5,-109
15648,2604,2233,1.0,2418.5,371
15649,2309,2348,0.0,2328.5,-39
15650,2542,2594,1.0,2568.0,-52
15651,2217,2341,0.0,2279.0,-124
15652,2115,2476,0.0,2295.5,-361
15653,2545,2641,1.0,2593.0,-96
15654,1918,1880,0.0,1899.0,38
15655,2491,2523,1.0,2507.0,-32
15656,2752,2697,0.5,2724.5,55
15657,2573,2640,0.0,2606.5,-67
15658,2684,2448,1.0,2566.0,236
15659,2430,2585,0.0,2507.5,-155
15660,2642,2687,0.5,2664.5,-45
15661,2654,2583,0.5,2618.5,71
15662,2505,2626,0.0,2565.5,-121
15663,2618,2432,0.5,2525.0,186
15664,2595,2716,0.5,2655.5,-121
15665,2662,2535,0.5,2598.5,127
15666,2526,2630,0.0,2578.0,-104
15667,2580,2515,0.5,2547.5,65
15668,2661,2720,0.0,2690.5,-59
15669,2636,2603,0.5,2619.5,33
15670,2431,2581,0.0,2506.0,-150
15671,2553,2419,1.0,2486.0,134
15672,2742,2574,1.0,2658.0,168
15673,2547,2651,1.0,2599.0,-104
15674,2540,2545,1.0,2542.5,-5
15675,2442,2519,0.0,2480.5,-77
15676,2531,2668,0.0,2599.5,-137
15677,2623,2550,1.0,2586.5,73
15678,2513,2622,0.0,2567.5,-109
15679,2584,2482,0.0,2533.0,102
15680,2665,2566,1.0,2615.5,99
15681,2566,2609,1.0,2587.5,-43
15682,2601,2478,0.5,2539.5,123
15683,2463,2575,0.5,2519.0,-112
15684,2554,2673,0.5,2613.5,-119
15685,2651,2546,1.0,2598.5,105
15686,2508,2628,0.5,2568.0,-120
15687,2476,2439,1.0,2457.5,37
15688,2590,2555,0.5,2572.5,35
15689,2559,2606,0.5,2582.5,-47
15690,2585,2475,1.0,2530.0,110
15691,2445,2595,0.0,2520.0,-150
15692,2548,2631,0.5,2589.5,-83
15693,2571,2499,0.5,2535.0,72
15694,2486,2555,0.5,2520.5,-69
15695,2565,2484,0.5,2524.5,81
15696,2565,2612,0.0,2588.5,-47
15697,2552,2437,1.0,2494.5,115
15698,2519,2509,0.5,2514.0,10
15699,2577,2434,1.0,2505.5,143
15700,2723,2490,0.5,2606.5,233
15701,2489,2633,0.0,2561.0,-144
15702,2435,2510,1.0,2472.5,-75
15703,2465,2448,0.0,2456.5,17
15704,2560,2618,0.5,2589.0,-58
15705,2641,2492,1.0,2566.5,149
15706,2447,2470,1.0,2458.5,-23
15707,2496,2455,1.0,2475.5,41
15708,2446,2580,0.5,2513.0,-134
15709,2458,2492,0.5,2475.0,-34
15710,2513,2468,1.0,2490.5,45
15711,2447,2444,1.0,2445.5,3
15712,2550,2473,0.5,2511.5,77
15713,2501,2521,1.0,2511.0,-20
15714,2427,2407,1.0,2417.0,20
15715,2368,2418,0.5,2393.0,-50
15716,2475,2650,0.0,2562.5,-175
15717,2436,2329,0.0,2382.5,107
15718,2374,2378,1.0,2376.0,-4
15719,2434,2348,0.5,2391.0,86
15720,2857,2431,1.0,2644.0,426
15721,2488,2651,0.5,2569.5,-163
15722,2570,2512,1.0,2541.0,58
15723,2439,2537,1.0,2488.0,-98
15724,2637,2650,0.5,2643.5,-13
15725,2537,2444,0.5,2490.5,93
15726,2439,2548,0.0,2493.5,-109
15727,2459,2345,1.0,2402.0,114
15728,2534,2511,0.5,2522.5,23
15729,2458,2517,0.5,2487.5,-59
15730,2482,2413,0.5,2447.5,69
15731,2379,2448,0.0,2413.5,-69
15732,2546,2768,0.5,2657.0,-222
15733,2585,2345,0.5,2465.0,240
15734,2239,2518,0.0,2378.5,-279
15735,2548,2187,1.0,2367.5,361
15736,2199,2396,0.0,2297.5,-197
15737,2239,2216,1.0,2227.5,23
15738,2183,2227,0.0,2205.0,-44
15739,2127,2167,0.5,2147.0,-40
15740,2215,2293,1.0,2254.0,-78
15741,2004,2166,0.5,2085.0,-162
15742,1927,2119,1.0,2023.0,-192
15743,2216,2145,1.0,2180.5,71
15744,1831,1929,0.0,1880.0,-98
15745,2150,1917,1.0,2033.5,233
15746,2238,1899,1.0,2068.5,339
15747,1950,1918,0.0,1934.0,32
15748,2398,2111,1.0,2254.5,287
15749,2020,2120,0.5,2070.0,-100
15750,2100,2340,1.0,2220.0,-240
15751,2107,2015,1.0,2061.0,92
15752,2070,2108,0.0,2089.0,-38
15753,2248,2285,0.5,2266.5,-37
15754,2047,2204,0.0,2125.5,-157
15755,2205,2235,1.0,2220.0,-30
15756,2254,1970,1.0,2112.0,284
15757,2018,2131,0.5,2074.5,-113
15758,2153,2096,1.0,2124.5,57
15759,2034,2259,0.0,2146.5,-225
15760,2175,2348,1.0,2261.5,-173
15761,2013,2071,0.0,2042.0,-58
15762,2188,2219,0.0,2203.5,-31
15763,2087,2017,0.0,2052.0,70
15764,2190,2373,1.0,2281.5,-183
15765,1850,1999,0.5,1924.5,-149
15766,2100,2137,1.0,2118.5,-37
15767,2354,2234,1.0,2294.0,120
15768,1979,2042,0.0,2010.5,-63
15769,2142,2260,0.5,2201.0,-118
15770,2012,2082,0.5,2047.0,-70
15771,2407,2123,1.0,2265.0,284
15772,1994,2007,0.0,2000.5,-13
15773,2148,2289,0.0,2218.5,-141
15774,1894,1963,0.0,1928.5,-69
15775,2129,2031,0.5,2080.0,98
15776,2111,2334,1.0,2222.5,-223
15777,1944,1933,0.0,1938.5,11
15778,2343,2018,0.0,2180.5,325
15779,2238,2104,1.0,2171.0,134
15780,1932,2050,0.0,1991.0,-118
15781,2161,2117,0.5,2139.0,44
15782,1914,2044,0.0,1979.0,-130
15783,1930,2074,0.5,2002.0,-144
15784,2199,2183,1.0,2191.0,16
15785,1972,2119,0.0,2045.5,-147
15786,2060,2116,1.0,2088.0,-56
15787,2164,1988,0.5,2076.0,176
15788,2000,2128,0.0,2064.0,-128
15789,2034,2190,1.0,2112.0,-156
15790,1857,1963,0.0,1910.0,-106
15791,2060,2170,0.0,2115.0,-110
15792,1997,2058,0.0,2027.5,-61
15793,2172,2009,1.0,2090.5,163
15794,1842,1983,1.0,1912.5,-141
15795,2192,2000,0.5,2096.0,192
15796,1956,1900,0.0,1928.0,56
15797,1890,2056,0.0,1973.0,-166
15798,2002,2030,1.0,2016.0,-28
15799,2014,1964,0.5,1989.0,50
15800,1908,1966,1.0,1937.0,-58
15801,1909,1841,0.5,1875.0,68
15802,1977,1940,0.5,1958.5,37
15803,1970,1655,1.0,1812.5,315
15804,2097,1992,0.5,2044.5,105
15805,1914,2069,0.5,1991.5,-155
15806,1715,1889,1.0,1802.0,-174
15807,1758,1992,0.0,1875.0,-234
15808,2044,1850,1.0,1947.0,194
15809,1782,1911,0.5,1846.5,-129
15810,1880,1732,0.0,1806.0,148
15811,2506,2176,0.0,2341.0,330
15812,2076,2314,0.0,2195.0,-238
15813,2255,1766,0.5,2010.5,489
15814,1726,2308,1.0,2017.0,-582
15815,1796,2340,0.0,2068.0,-544
15816,2336,1852,1.0,2094.0,484
15817,2063,2334,0.0,2198.5,-271
15818,2259,2032,1.0,2145.5,227
15819,2482,1692,1.0,2087.0,790
15820,2142,2503,0.5,2322.5,-361
15821,1976,1971,1.0,1973.5,5
15822,2095,2153,0.0,2124.0,-58
15823,2289,2337,1.0,2313.0,-48
15824,1787,1943,0.0,1865.0,-156
15825,2298,2270,1.0,2284.0,28
15826,2245,1781,1.0,2013.0,464
15827,1986,2013,0.0,1999.5,-27
15828,2294,2253,1.0,2273.5,41
15829,1717,1812,0.0,1764.5,-95
15830,2405,2373,1.0,2389.0,32
15831,1861,1924,0.0,1892.5,-63
15832,2200,2363,1.0,2281.5,-163
15833,1670,1889,0.5,1779.5,-219
15834,1960,2187,1.0,2073.5,-227
15835,2251,2161,1.0,2206.0,90
15836,1782,1915,0.0,1848.5,-133
15837,2361,2302,1.0,2331.5,59
15838,2318,1671,1.0,1994.5,647
15839,1877,1923,0.5,1900.0,-46
15840,2239,2392,1.0,2315.5,-153
15841,1800,1723,1.0,1761.5,77
15842,1855,2174,0.0,2014.5,-319
15843,2301,2384,1.0,2342.5,-83
15844,1853,1880,0.0,1866.5,-27
15845,2173,2232,0.5,2202.5,-59
15846,2315,1692,1.0,2003.5,623
15847,1576,2205,0.0,1890.5,-629
15848,2274,2276,1.0,2275.0,-2
15849,1793,2208,0.0,2000.5,-415
15850,2269,2388,1.0,2328.5,-119
15851,1713,1768,0.0,1740.5,-55
15852,2134,2229,1.0,2181.5,-95
15853,2257,1322,1.0,1789.5,935
15854,1768,1712,0.0,1740.0,56
15855,2196,2248,1.0,2222.0,-52
15856,1651,1798,0.0,1724.5,-147
15857,2036,1992,0.5,2014.0,44
15858,2208,2285,1.0,2246.5,-77
15859,1912,2024,0.0,1968.0,-112
15860,2027,2077,1.0,2052.0,-50
15861,2169,1663,1.0,1916.0,506
15862,1754,2150,0.0,1952.0,-396
15863,2058,1736,1.0,1897.0,322
15864,1685,2060,0.0,1872.5,-375
15865,1798,2215,0.0,2006.5,-417
15866,2051,1677,1.0,1864.0,374
15867,1610,2126,0.0,1868.0,-516
15868,2261,1995,0.0,2128.0,266
15869,1851,2251,1.0,2051.0,-400
15870,2096,2094,1.0,2095.0,2
15871,1516,2269,0.0,1892.5,-753
15872,2166,1592,1.0,1879.0,574
15873,1447,2149,0.0,1798.0,-702
15874,2016,1301,1.0,1658.5,715
15875,1606,2297,0.0,1951.5,-691
15876,2053,1567,0.5,1810.0,486
15877,2023,2036,1.0,2029.5,-13
15878,2172,1678,1.0,1925.0,494
15879,2057,2068,1.0,2062.5,-11
15880,2339,2017,1.0,2178.0,322
15881,1825,1842,0.0,1833.5,-17
15882,2272,2192,1.0,2232.0,80
15883,1869,1987,1.0,1928.0,-118
15884,2635,2209,1.0,2422.0,426
15885,2322,2402,0.0,2362.0,-80
15886,2565,2616,1.0,2590.5,-51
15887,2283,2347,0.0,2315.0,-64
15888,2648,2524,0.5,2586.0,124
15889,2731,2769,0.5,2750.0,-38
15890,2543,2584,0.0,2563.5,-41
15891,2754,2740,1.0,2747.0,14
15892,2720,2489,0.5,2604.5,231
15893,2675,2736,1.0,2705.5,-61
15894,2636,2623,1.0,2629.5,13
15895,2639,2646,0.0,2642.5,-7
15896,2612,2581,0.5,2596.5,31
15897,2671,2752,1.0,2711.5,-81
15898,2509,2552,0.0,2530.5,-43
15899,2640,2669,0.5,2654.5,-29
15900,2761,2625,1.0,2693.0,136
15901,2684,2752,1.0,2718.0,-68
15902,2666,2722,1.0,2694.0,-56
15903,2585,2614,0.0,2599.5,-29
15904,2755,2696,1.0,2725.5,59
15905,2633,2723,0.5,2678.0,-90
15906,2674,2611,0.5,2642.5,63
15907,2448,2435,0.5,2441.5,13
15908,2583,2640,0.5,2611.5,-57
15909,2652,2635,0.5,2643.5,17
15910,2568,2543,0.5,2555.5,25
15911,2565,2616,0.0,2590.5,-51
15912,2738,2459,1.0,2598.5,279
15913,2617,2675,1.0,2646.0,-58
15914,2635,2665,1.0,2650.0,-30
15915,2582,2512,0.5,2547.0,70
15916,2808,2666,1.0,2737.0,142
15917,2606,2590,0.5,2598.0,16
15918,2782,2789,1.0,2785.5,-7
15919,2595,2585,0.5,2590.0,10
15920,2634,2674,0.0,2654.0,-40
15921,2753,2737,0.5,2745.0,16
15922,2509,2616,0.0,2562.5,-107
15923,2746,2725,0.5,2735.5,21
15924,2687,2499,0.5,2593.0,188
15925,2693,2739,0.5,2716.0,-46
15926,2640,2626,0.5,2633.0,14
15927,2647,2675,1.0,2661.0,-28
15928,2813,2618,0.5,2715.5,195
15929,2662,2716,0.5,2689.0,-54
15930,2635,2617,0.5,2626.0,18
15931,2566,2630,0.5,2598.0,-64
15932,2687,2623,0.5,2655.0,64
15933,2662,2650,0.5,2656.0,12
15934,2630,2619,0.5,2624.5,11
15935,2548,2537,1.0,2542.5,11
15936,2618,2553,0.5,2585.5,65
15937,2591,2652,0.5,2621.5,-61
15938,2470,2641,0.0,2555.5,-171
15939,2547,2561,1.0,2554.0,-14
15940,2622,2318,1.0,2470.0,304
15941,2329,2475,0.5,2402.0,-146
15942,2562,2558,0.5,2560.0,4
15943,2267,2374,0.0,2320.5,-107
15944,2618,2526,0.5,2572.0,92
15945,2651,2857,0.5,2754.0,-206
15946,2524,2595,1.0,2559.5,-71
15947,2537,2570,0.5,2553.5,-33
15948,2638,2554,0.5,2596.0,84
15949,2517,2534,0.0,2525.5,-17
15950,2499,2609,0.5,2554.0,-110
15951,2448,2482,1.0,2465.0,-34
15952,2742,2410,1.0,2576.0,332
15953,2583,2696,0.0,2639.5,-113
15954,2591,2651,0.5,2621.0,-60
15955,2450,2582,0.5,2516.0,-132
15956,2668,2540,0.5,2604.0,128
15957,2513,2604,0.5,2558.5,-91
15958,2608,2623,0.5,2615.5,-15
15959,2476,2542,0.5,2509.0,-66
15960,2673,2622,0.5,2647.5,51
15961,2545,2641,0.0,2593.0,-96
15962,2628,2651,0.5,2639.5,-23
15963,2516,2523,0.5,2519.5,-7
15964,2446,2404,1.0,2425.0,42
15965,2521,2550,0.0,2535.5,-29
15966,2513,2492,0.5,2502.5,21
15967,2418,2427,1.0,2422.5,-9
15968,2631,2402,0.5,2516.5,229
15969,2566,2566,0.5,2566.0,0
15970,2555,2601,0.5,2578.0,-46
15971,2435,2478,0.0,2456.5,-43
15972,2548,2565,0.5,2556.5,-17
15973,2601,2665,1.0,2633.0,-64
15974,2484,2486,0.5,2485.0,-2
15975,2497,2575,1.0,2536.0,-78
15976,2473,2464,0.5,2468.5,9
15977,2458,2580,0.5,2519.0,-122
15978,2407,2501,1.0,2454.0,-94
15979,2354,2447,0.0,2400.5,-93
15980,2768,2283,0.5,2525.5,485
15981,2583,2642,0.5,2612.5,-59
15982,2518,2585,1.0,2551.5,-67
15983,2432,2460,0.5,2446.0,-28
15984,2348,2548,0.5,2448.0,-200
15985,2526,2535,0.5,2530.5,-9
15986,2309,2312,0.5,2310.5,-3
15987,2515,2522,1.0,2518.5,-7
15988,2340,2341,0.0,2340.5,-1
15989,2447,2492,1.0,2469.5,-45
15990,2334,2336,0.0,2335.0,-2
15991,2408,2455,0.0,2431.5,-47
15992,2650,2259,1.0,2454.5,391
15993,2289,2337,0.0,2313.0,-48
15994,2378,2436,1.0,2407.0,-58
15995,2298,2270,0.0,2284.0,28
15996,2431,2245,1.0,2338.0,186
15997,2245,2209,0.5,2227.0,36
15998,2512,2488,1.0,2500.0,24
15999,2294,2253,0.0,2273.5,41
16000,2511,2413,1.0,2462.0,98
16001,2276,2315,0.0,2295.5,-39
16002,2444,2458,1.0,2451.0,-14
16003,2208,2274,0.0,2241.0,-66
16004,2388,2379,0.5,2383.5,9
16005,2321,2411,1.0,2366.0,-90
16006,2229,2269,0.0,2249.0,-40
16007,1860,2327,0.0,2093.5,-467
16008,2493,2175,1.0,2334.0,318
16009,2248,2285,0.5,2266.5,-37
16010,2340,2280,1.0,2310.0,60
16011,2205,2235,0.0,2220.0,-30
16012,2574,2241,1.0,2407.5,333
16013,2096,2254,0.0,2175.0,-158
16014,2545,2547,0.5,2546.0,-2
16015,2259,2153,0.0,2206.0,106
16016,2257,2430,0.5,2343.5,-173
16017,2513,2550,1.0,2531.5,-37
16018,2196,2248,0.0,2222.0,-52
16019,2458,2482,1.0,2470.0,-24
16020,2373,2203,0.0,2288.0,170
16021,2546,2554,1.0,2550.0,-8
16022,2137,2190,1.0,2163.5,-53
16023,2439,2444,1.0,2441.5,-5
16024,2559,2100,1.0,2329.5,459
16025,2169,2439,0.0,2304.0,-270
16026,2445,2475,1.0,2460.0,-30
16027,2058,2150,0.0,2104.0,-92
16028,2339,2459,0.0,2399.0,-120
16029,2444,2637,1.0,2540.5,-193
16030,2126,2051,0.5,2088.5,75
16031,2233,2439,1.0,2336.0,-206
16032,2269,1904,0.0,2086.5,365
16033,2328,2458,1.0,2393.0,-130
16034,2149,2166,0.5,2157.5,-17
16035,2181,2295,0.5,2238.0,-114
16036,2396,2099,0.5,2247.5,297
16037,2302,2251,0.0,2276.5,51
16038,2227,2239,0.5,2233.0,-12
16039,2236,2361,1.0,2298.5,-125
16040,2215,2122,0.0,2168.5,93
16041,2351,2488,1.0,2419.5,-137
16042,2158,2166,0.0,2162.0,-8
16043,2088,2276,0.0,2182.0,-188
16044,1992,2119,0.0,2055.5,-127
16045,2345,2546,1.0,2445.5,-201
16046,1840,2044,0.0,1942.0,-204
16047,2187,2239,0.5,2213.0,-52
16048,2697,1880,1.0,2288.5,817
16049,2117,2238,0.0,2177.5,-121
16050,2448,2573,1.0,2510.5,-125
16051,2074,2161,0.0,2117.5,-87
16052,2128,2478,0.0,2303.0,-350
16053,2603,2661,1.0,2632.0,-58
16054,2116,2199,0.0,2157.5,-83
16055,2419,2451,1.0,2435.0,-32
16056,2164,2060,0.0,2112.0,104
16057,2437,2565,1.0,2501.0,-128
16058,2164,2190,0.0,2177.0,-26
16059,2351,2434,1.0,2392.5,-83
16060,2490,2172,1.0,2331.0,318
16061,2151,2489,0.0,2320.0,-338
16062,2510,2068,1.0,2289.0,442
16063,2017,2427,0.0,2222.0,-410
16064,2454,2115,1.0,2284.5,339
16065,1880,2434,0.0,2157.0,-554
16066,2393,1918,1.0,2155.5,475
16067,2558,2315,1.0,2436.5,243
16068,1851,1995,0.0,1923.0,-144
16069,2398,2401,1.0,2399.5,-3
16070,2405,2282,0.5,2343.5,123
16071,2415,2564,1.0,2489.5,-149
16072,2200,2363,0.5,2281.5,-163
16073,2374,2316,1.0,2345.0,58
16074,2384,2114,0.5,2249.0,270
16075,2367,2487,1.0,2427.0,-120
16076,2232,2301,0.5,2266.5,-69
16077,2328,2343,1.0,2335.5,-15
16078,2348,2173,0.5,2260.5,175
16079,2434,2453,0.0,2443.5,-19
16080,2219,2175,1.0,2197.0,44
16081,2230,2340,0.5,2285.0,-110
16082,2406,2188,1.0,2297.0,218
16083,2260,2354,0.0,2307.0,-94
16084,2294,2387,1.0,2340.5,-93
16085,2123,2026,0.0,2074.5,97
16086,2390,2323,1.0,2356.5,67
16087,2285,2305,0.0,2295.0,-20
16088,2127,2350,1.0,2238.5,-223
16089,2077,2208,0.5,2142.5,-131
16090,2407,2223,0.5,2315.0,184
16091,2416,2371,1.0,2393.5,45
16092,2148,2289,0.0,2218.5,-141
16093,2177,2350,0.5,2263.5,-173
16094,2485,2031,0.5,2258.0,454
16095,2340,2398,0.0,2369.0,-58
16096,2406,2453,0.0,2429.5,-47
16097,2108,2223,0.0,2165.5,-115
16098,2334,2401,0.0,2367.5,-67
16099,2432,2503,1.0,2467.5,-71
16100,2018,2111,0.5,2064.5,-93
16101,2265,2288,0.5,2276.5,-23
16102,2451,2343,1.0,2397.0,108
16103,2000,2116,0.0,2058.0,-116
16104,2401,2441,1.0,2421.0,-40
16105,2056,1956,1.0,2006.0,100
16106,2628,2049,1.0,2338.5,579
16107,2092,2297,0.0,2194.5,-205
16108,2310,2377,1.0,2343.5,-67
16109,2023,2036,0.5,2029.5,-13
16110,2391,2054,1.0,2222.5,337
16111,1918,2238,0.0,2078.0,-320
16112,2387,2481,1.0,2434.0,-94
16113,2111,2025,1.0,2068.0,86
16114,2610,2214,1.0,2412.0,396
16115,2503,2482,0.5,2492.5,21
16116,2212,2436,1.0,2324.0,-224
16117,2107,2142,0.0,2124.5,-35
16118,2439,2119,0.5,2279.0,320
16119,2392,2318,1.0,2355.0,74
16120,2273,2320,0.0,2296.5,-47
16121,2114,2239,0.0,2176.5,-125
16122,2176,2326,1.0,2251.0,-150
16123,1766,2076,1.0,1921.0,-310
16124,1917,1991,0.5,1954.0,-74
16125,2145,1726,1.0,1935.5,419
16126,2109,2199,0.0,2154.0,-90
16127,1929,2119,0.0,2024.0,-190
16128,2167,2183,0.5,2175.0,-16
16129,1970,2150,0.5,2060.0,-180
16130,2058,2060,1.0,2059.0,-2
16131,1914,1992,0.0,1953.0,-78
16132,2172,2065,1.0,2118.5,107
16133,2170,1889,1.0,2029.5,281
16134,2069,2097,0.5,2083.0,-28
16135,2009,1997,1.0,2003.0,12
16136,1624,1715,1.0,1669.5,-91
16137,2003,1842,0.0,1922.5,161
16138,2314,2506,1.0,2410.0,-192
16139,1972,1930,0.0,1951.0,42
16140,2345,2308,1.0,2326.5,37
16141,1855,1988,0.0,1921.5,-133
16142,1933,2129,1.0,2031.0,-196
16143,1853,1880,1.0,1866.5,-27
16144,2104,1868,1.0,1986.0,236
16145,1796,1692,0.0,1744.0,104
16146,1966,2014,0.5,1990.0,-48
16147,2063,1852,1.0,1957.5,211
16148,1785,1909,0.0,1847.0,-124
16149,1692,2032,0.0,1862.0,-340
16150,1943,2095,1.0,2019.0,-152
16151,1971,1787,0.5,1879.0,184
16152,1764,1976,0.0,1870.0,-212
16153,2013,1923,0.5,1968.0,90
16154,1877,1986,0.5,1931.5,-109
16155,1812,1723,1.0,1767.5,89
16156,1800,1656,1.0,1728.0,144
16157,2087,1850,0.5,1968.5,237
16158,1782,1999,0.0,1890.5,-217
16159,1850,1732,1.0,1791.0,118
16160,1662,2234,0.0,1948.0,-572
16161,1899,2050,1.0,1974.5,-151
16162,1932,1914,1.0,1923.0,18
16163,1979,1793,1.0,1886.0,186
16164,1768,2027,0.5,1897.5,-259
16165,2082,1713,1.0,1897.5,369
16166,1322,2012,0.0,1667.0,-690
16167,2007,1750,1.0,1878.5,257
16168,1768,2169,0.0,1968.5,-401
16169,1963,1798,1.0,1880.5,165
16170,1651,1894,0.0,1772.5,-243
16171,1842,1663,0.5,1752.5,179
16172,1754,1867,0.5,1810.5,-113
16173,1987,1736,0.0,1861.5,251
16174,1685,1869,0.0,1777.0,-184
16175,1798,1960,0.0,1879.0,-162
16176,1915,1677,1.0,1796.0,238
16177,1610,1782,1.0,1696.0,-172
16178,1671,1730,1.0,1700.5,-59
16179,2034,1606,1.0,1820.0,428
16180,1567,1993,0.0,1780.0,-426
16181,2082,2037,0.5,2059.5,45
16182,2293,2128,1.0,2210.5,165
16183,2000,2168,1.0,2084.0,-168
16184,2004,1956,1.0,1980.0,48
16185,1857,1927,1.0,1892.0,-70
16186,2120,2036,0.5,2078.0,84
16187,2024,2020,0.0,2022.0,4
16188,2052,1912,1.0,1982.0,140
16189,1924,2107,0.0,2015.5,-183
16190,1900,2192,1.0,2046.0,-292
16191,1670,1861,0.5,1765.5,-191
16192,1861,2030,0.0,1945.5,-169
16193,2205,1676,0.0,1940.5,529
16194,2034,2099,1.0,2066.5,-65
16195,1952,1576,0.0,1764.0,376
16196,2017,2071,1.0,2044.0,-54
16197,1760,2070,0.0,1915.0,-310
16198,2204,1970,0.0,2087.0,234
16199,1678,2234,0.0,1956.0,-556
16200,2131,2018,0.0,2074.5,113
16201,2422,2354,0.0,2388.0,68
16202,2339,2342,1.0,2340.5,-3
16203,2335,2272,0.5,2303.5,63
16204,2209,2240,0.0,2224.5,-31
16205,2398,1964,1.0,2181.0,434
16206,1675,2402,0.0,2038.5,-727
16207,2347,1841,1.0,2094.0,506
16208,1977,2283,0.0,2130.0,-306
16209,2739,2808,0.5,2773.5,-69
16210,2731,2709,0.0,2720.0,22
16211,2675,2740,0.0,2707.5,-65
16212,2754,2647,0.0,2700.5,107
16213,2752,2720,0.5,2736.0,32
16214,2623,2671,0.5,2647.0,-48
16215,2669,2636,1.0,2652.5,33
16216,2581,2640,0.5,2610.5,-59
16217,2808,2742,0.5,2775.0,66
16218,2651,2789,0.5,2720.0,-138
16219,2782,2591,0.5,2686.5,191
16220,2519,2679,0.5,2599.0,-160
16221,2618,2761,0.0,2689.5,-143
16222,2722,2524,0.5,2623.0,198
16223,2572,2666,0.5,2619.0,-94
16224,2696,2554,1.0,2625.0,142
16225,2737,2543,1.0,2640.0,194
16226,2567,2753,0.0,2660.0,-186
16227,2725,2568,0.5,2646.5,157
16228,2459,2717,0.5,2588.0,-258
16229,2738,2755,0.5,2746.5,-17
16230,2611,2665,1.0,2638.0,-54
16231,2671,2674,0.0,2672.5,-3
16232,2592,2635,1.0,2613.5,-43
16233,2652,2673,1.0,2662.5,-21
16234,2651,2599,0.5,2625.0,52
16235,2591,2628,0.5,2609.5,-37
16236,2476,2561,0.5,2518.5,-85
16237,2650,2602,0.5,2626.0,48
16238,2622,2662,1.0,2642.0,-40
16239,2548,2562,1.0,2555.0,-14
16240,2526,2459,0.5,2492.5,67
16241,2631,2813,0.5,2722.0,-182
16242,2617,2601,0.5,2609.0,16
16243,2571,2664,0.5,2617.5,-93
16244,2623,2555,0.5,2589.0,68
16245,2716,2638,1.0,2677.0,78
16246,2609,2662,0.0,2635.5,-53
16247,2630,2499,1.0,2564.5,131
16248,2519,2580,0.5,2549.5,-61
16249,2668,2446,0.5,2557.0,222
16250,2492,2623,0.5,2557.5,-131
16251,2622,2513,0.0,2567.5,109
16252,2444,2584,0.5,2514.0,-140
16253,2604,2473,1.0,2538.5,131
16254,2501,2513,0.5,2507.0,-12
16255,2594,2368,0.0,2481.0,226
16256,2283,2476,0.5,2379.5,-193
16257,2665,2768,1.0,2716.5,-103
16258,2585,2609,0.0,2597.0,-24
16259,2601,2518,0.5,2559.5,83
16260,2548,2497,0.5,2522.5,51
16261,2675,2534,1.0,2604.5,141
16262,2482,2646,0.5,2564.0,-164
16263,2681,2448,1.0,2564.5,233
16264,2457,2639,0.5,2548.0,-182
16265,2635,2455,1.0,2545.0,180
16266,2454,2652,0.0,2553.0,-198
16267,2616,2434,1.0,2525.0,182
16268,2315,2524,0.0,2419.5,-209
16269,2367,2723,0.0,2545.0,-356
16270,2435,2366,1.0,2400.5,69
16271,2343,2448,0.5,2395.5,-105
16272,2486,2328,0.5,2407.0,158
16273,2675,2411,1.0,2543.0,264
16274,2321,2617,0.0,2469.0,-296
16275,2582,2327,1.0,2454.5,255
16276,1860,2430,0.0,2145.0,-570
16277,2752,2348,1.0,2550.0,404
16278,2175,2640,0.0,2407.5,-465
16279,2614,2188,1.0,2401.0,426
16280,2194,2585,0.0,2389.5,-391
16281,2458,2511,1.0,2484.5,-53
16282,2458,2328,1.0,2393.0,130
16283,2233,2444,1.0,2338.5,-211
16284,2413,2181,1.0,2297.0,232
16285,2531,2857,0.5,2694.0,-326
16286,2651,2513,0.5,2582.0,138
16287,2482,2570,0.5,2526.0,-88
16288,2537,2458,1.0,2497.5,79
16289,2696,2590,1.0,2643.0,106
16290,2606,2582,0.5,2594.0,24
16291,2450,2595,0.0,2522.5,-145
16292,2536,2431,1.0,2483.5,105
16293,2555,2634,0.0,2594.5,-79
16294,2616,2559,0.5,2587.5,57
16295,2445,2523,0.5,2484.0,-78
16296,2509,2459,1.0,2484.0,50
16297,2687,2687,0.5,2687.0,0
16298,2619,2654,0.5,2636.5,-35
16299,2626,2605,1.0,2615.5,21
16300,2553,2640,0.0,2596.5,-87
16301,2437,2618,0.0,2527.5,-181
16302,2641,2519,1.0,2580.0,122
16303,2434,2496,0.0,2465.0,-62
16304,2318,2351,0.0,2334.5,-33
16305,2637,2475,1.0,2556.0,162
16306,2329,2444,0.0,2386.5,-115
16307,2439,2374,1.0,2406.5,65
16308,2348,2233,0.5,2290.5,115
16309,2318,2595,0.0,2456.5,-277
16310,2535,2392,1.0,2463.5,143
16311,2239,2526,0.0,2382.5,-287
16312,2522,2114,1.0,2318.0,408
16313,2390,2436,0.0,2413.0,-46
16314,2378,2433,0.5,2405.5,-55
16315,2350,2434,1.0,2392.0,-84
16316,2245,2127,1.0,2186.0,118
16317,2493,2628,0.5,2560.5,-135
16318,2377,2280,0.5,2328.5,97
16319,2340,2310,0.0,2325.0,30
16320,2291,2241,1.0,2266.0,50
16321,2610,2648,0.5,2629.0,-38
16322,2584,2436,1.0,2510.0,148
16323,2212,2489,1.0,2350.5,-277
16324,2437,2119,1.0,2278.0,318
16325,2546,2574,0.5,2560.0,-28
16326,2547,2345,1.0,2446.0,202
16327,2239,2442,0.0,2340.5,-203
16328,2430,2187,1.0,2308.5,243
16329,2492,2391,1.0,2441.5,101
16330,2481,2447,0.5,2464.0,34
16331,2455,2387,1.0,2421.0,68
16332,2272,2408,0.0,2340.0,-136
16333,2564,2431,0.0,2497.5,133
16334,2488,2415,0.5,2451.5,73
16335,2374,2512,0.0,2443.0,-138
16336,2439,2322,1.0,2380.5,117
16337,2554,2176,1.0,2365.0,378
16338,2076,2508,0.0,2292.0,-432
16339,2444,1766,1.0,2105.0,678
16340,1726,2439,0.0,2082.5,-713
16341,2661,2488,1.0,2574.5,173
16342,2351,2603,1.0,2477.0,-252
16343,2451,2276,1.0,2363.5,175
16344,2239,2419,0.5,2329.0,-180
16345,2451,2558,0.5,2504.5,-107
16346,2401,2441,0.5,2421.0,-40
16347,2219,2398,0.0,2308.5,-179
16348,2373,2401,1.0,2387.0,-28
16349,2406,2485,0.5,2445.5,-79
16350,2453,2387,1.0,2420.0,66
16351,2294,2406,0.0,2350.0,-112
16352,2401,2331,1.0,2366.0,70
16353,2371,2697,0.5,2534.0,-326
16354,2573,2416,0.0,2494.5,157
16355,2350,2448,0.5,2399.0,-98
16356,2478,2247,0.0,2362.5,231
16357,2484,2490,0.5,2487.0,-6
16358,2489,2503,0.5,2496.0,-14
16359,2432,2510,0.5,2471.0,-78
16360,2427,2288,0.5,2357.5,139
16361,2566,2396,1.0,2481.0,170
16362,2239,2566,0.0,2402.5,-327
16363,2478,2127,1.0,2302.5,351
16364,2122,2435,0.0,2278.5,-313
16365,2550,2060,1.0,2305.0,490
16366,2065,2521,0.5,2293.0,-456
16367,2427,2172,0.5,2299.5,255
16368,1983,2418,0.5,2200.5,-435
16369,2161,2548,0.0,2354.5,-387
16370,2499,2251,1.0,2375.0,248
16371,2361,2486,1.0,2423.5,-125
16372,2464,2236,1.0,2350.0,228
16373,2580,2145,1.0,2362.5,435
16374,2119,2458,0.0,2288.5,-339
16375,2468,2150,1.0,2309.0,318
16376,1893,2354,0.0,2123.5,-461
16377,2642,2170,1.0,2406.0,472
16378,1997,2583,0.0,2290.0,-586
16379,2460,2009,1.0,2234.5,451
16380,1842,2432,0.0,2137.0,-590
16381,1675,2215,0.0,1945.0,-540
16382,2166,1908,1.0,2037.0,258
16383,1841,2119,0.0,1980.0,-278
16384,2154,1977,1.0,2065.5,177
16385,2129,2422,0.0,2275.5,-293
16386,2335,1933,1.0,2134.0,402
16387,1944,2240,0.0,2092.0,-296
16388,2178,2104,1.0,2141.0,74
16389,2398,1960,1.0,2179.0,438
16390,1915,2340,1.0,2127.5,-425
16391,2223,1782,1.0,2002.5,441
16392,1671,2100,0.0,1885.5,-429
16393,2183,2373,1.0,2278.0,-190
16394,2137,2128,1.0,2132.5,9
16395,2199,2100,1.0,2149.5,99
16396,2202,2060,1.0,2131.0,142
16397,2334,1899,1.0,2116.5,435
16398,2018,2111,1.0,2064.5,-93
16399,2482,2343,1.0,2412.5,139
16400,2289,2407,0.5,2348.0,-118
16401,2153,2503,0.0,2328.0,-350
16402,2031,2148,1.0,2089.5,-117
16403,2439,2107,1.0,2273.0,332
16404,2269,2388,0.5,2328.5,-119
16405,2058,2169,0.5,2113.5,-111
16406,2134,2229,0.5,2181.5,-95
16407,2453,2060,1.0,2256.5,393
16408,1880,2115,1.0,1997.5,-235
16409,2279,2340,1.0,2309.5,-61
16410,2315,2230,0.0,2272.5,85
16411,2320,2439,0.5,2379.5,-119
16412,2274,2276,0.0,2275.0,-2
16413,2259,2326,1.0,2292.5,-67
16414,2337,2208,0.5,2272.5,129
16415,2314,2506,1.0,2410.0,-192
16416,2270,2289,0.5,2279.5,-19
16417,2308,2255,1.0,2281.5,53
16418,2116,2189,0.0,2152.5,-73
16419,2363,2405,1.0,2384.0,-42
16420,2056,2000,1.0,2028.0,56
16421,2114,2200,1.0,2157.0,-86
16422,2305,2002,0.0,2153.5,303
16423,2312,2348,1.0,2330.0,-36
16424,2077,2208,0.5,2142.5,-131
16425,2217,2309,1.0,2263.0,-92
16426,2254,2027,1.0,2140.5,227
16427,2260,2354,1.0,2307.0,-94
16428,2153,2096,0.5,2124.5,57
16429,2026,2142,1.0,2084.0,-116
16430,2238,2259,1.0,2248.5,-21
16431,2336,2340,0.5,2338.0,-4
16432,2146,2117,0.0,2131.5,29
16433,2272,2259,0.0,2265.5,13
16434,2099,2074,0.0,2086.5,25
16435,2025,2238,0.0,2131.5,-213
16436,2071,2034,0.0,2052.5,37
16437,2111,1950,0.0,2030.5,161
16438,2248,2017,1.0,2132.5,231
16439,1939,1851,0.0,1895.0,88
16440,2205,2235,1.0,2220.0,-30
16441,2166,1909,0.5,2037.5,257
16442,2034,2164,0.5,2099.0,-130
16443,2099,2149,0.0,2124.0,-50
16444,2172,2016,0.5,2094.0,156
16445,2015,2020,0.0,2017.5,-5
16446,2057,2068,0.0,2062.5,-11
16447,2107,2052,0.5,2079.5,55
16448,2192,2017,0.0,2104.5,175
16449,2301,2384,1.0,2342.5,-83
16450,2030,1900,0.0,1965.0,130
16451,2173,2232,1.0,2202.5,-59
16452,2234,1861,0.0,2047.5,373
16453,1994,2169,0.0,2081.5,-175
16454,2018,2131,0.0,2074.5,-113
16455,1894,1963,1.0,1928.5,-69
16456,2209,1879,1.0,2044.0,330
16457,1999,2087,0.0,2043.0,-88
16458,2294,2245,1.0,2269.5,49
16459,2234,1850,0.0,2042.0,384
16460,1992,2373,0.0,2182.5,-381
16461,2215,2339,1.0,2277.0,-124
16462,1840,1911,0.0,1875.5,-71
16463,2126,2051,1.0,2088.5,75
16464,2297,1880,1.0,2088.5,417
16465,2248,2257,0.5,2252.5,-9
16466,2092,2053,0.5,2072.5,39
16467,1992,2203,0.5,2097.5,-211
16468,2042,2023,1.0,2032.5,19
16469,1852,1796,0.0,1824.0,56
16470,2082,2027,1.0,2054.5,55
16471,2032,2063,0.0,2047.5,-31
16472,2070,2012,0.0,2041.0,58
16473,1993,2034,0.0,2013.5,-41
16474,2047,2204,0.5,2125.5,-157
16475,1879,2037,0.5,1958.0,-158
16476,2216,1612,1.0,1914.0,604
16477,1943,2095,0.0,2019.0,-152
16478,1991,1781,1.0,1886.0,210
16479,1764,1917,0.0,1840.5,-153
16480,2128,2199,0.5,2163.5,-71
16481,2216,2000,1.0,2108.0,216
16482,1963,2109,0.0,2036.0,-146
16483,2167,1956,1.0,2061.5,211
16484,1655,1986,0.0,1820.5,-331
16485,1812,2097,0.0,1954.5,-285
16486,2069,1717,1.0,1893.0,352
16487,1656,1624,0.0,1640.0,32
16488,1923,1970,0.0,1946.5,-47
16489,1992,1877,1.0,1934.5,115
16490,1800,1914,0.0,1857.0,-114
16491,1889,1561,1.0,1725.0,328
16492,1825,1516,1.0,1670.5,309
16493,1592,1867,0.0,1729.5,-275
16494,1987,1615,1.0,1801.0,372
16495,1447,1869,0.0,1658.0,-422
16496,1663,2293,0.0,1978.0,-630
16497,2168,1754,1.0,1961.0,414
16498,1736,2004,0.0,1870.0,-268
16499,1927,1685,0.0,1806.0,242
16500,1793,1606,0.5,1699.5,187
16501,1567,1768,0.0,1667.5,-201
16502,1713,1322,1.0,1517.5,391
16503,1758,2003,0.0,1880.5,-245
16504,1930,1850,1.0,1890.0,80
16505,1782,2119,0.0,1950.5,-337
16506,1972,1662,1.0,1817.0,310
16507,2036,2014,0.0,2025.0,22
16508,1966,2024,1.0,1995.0,-58
16509,1912,1940,1.0,1926.0,-28
16510,1785,1878,0.0,1831.5,-93
16511,1692,1798,0.5,1745.0,-106
16512,1971,1610,1.0,1790.5,361
16513,1678,1976,0.0,1827.0,-298
16514,1889,1924,1.0,1906.5,-35
16515,1676,1670,0.0,1673.0,6
16516,2261,1855,1.0,2058.0,406
16517,1880,2251,0.0,2065.5,-371
16518,2096,1853,1.0,1974.5,243
16519,1692,2094,1.0,1893.0,-402
16520,2050,2205,1.0,2127.5,-155
16521,1576,2044,0.0,1810.0,-468
16522,1914,1952,1.0,1933.0,-38
16523,2641,2060,1.0,2350.5,581
16524,2402,2398,0.5,2400.0,4
16525,2516,2523,1.0,2519.5,-7
16526,2283,2322,0.0,2302.5,-39
16527,2354,2491,0.0,2422.5,-137
16528,2509,2612,1.0,2560.5,-103
16529,2192,2339,0.0,2265.5,-147
16530,2577,2625,0.5,2601.0,-48
16531,1712,2272,0.0,1992.0,-560
16532,1798,1750,1.0,1774.0,48
16533,2583,2159,1.0,2371.0,424
16534,1953,2522,0.0,2237.5,-569
16535,2475,1898,1.0,2186.5,577
16536,1844,2417,0.0,2130.5,-573
16537,2125,2539,0.0,2332.0,-414
16538,2475,2078,1.0,2276.5,397
16539,1789,2457,0.0,2123.0,-668
16540,2416,1855,1.0,2135.5,561
16541,2538,2381,1.0,2459.5,157
16542,1894,2475,0.0,2184.5,-581
16543,2484,1894,1.0,2189.0,590
16544,1679,2452,0.0,2065.5,-773
16545,1943,2295,0.0,2119.0,-352
16546,2304,1831,1.0,2067.5,473
16547,1834,2339,0.0,2086.5,-505
16548,2302,1732,1.0,2017.0,570
16549,2200,2486,0.0,2343.0,-286
16550,2463,1910,1.0,2186.5,553
16551,1922,2474,0.0,2198.0,-552
16552,2419,1807,1.0,2113.0,612
16553,2408,2033,1.0,2220.5,375
16554,2063,2402,0.0,2232.5,-339
16555,2379,1886,1.0,2132.5,493
16556,1695,2287,0.0,1991.0,-592
16557,2015,2444,0.0,2229.5,-429
16558,2366,2073,1.0,2219.5,293
16559,1735,2449,0.0,2092.0,-714
16560,2365,1881,1.0,2123.0,484
16561,2429,2048,1.0,2238.5,381
16562,1868,2409,0.0,2138.5,-541
16563,2346,1913,1.0,2129.5,433
16564,1836,2246,0.0,2041.0,-410
16565,1947,2372,0.0,2159.5,-425
16566,2336,1932,1.0,2134.0,404
16567,1881,2379,0.0,2130.0,-498
16568,2355,1807,1.0,2081.0,548
16569,2386,2023,1.0,2204.5,363
16570,1971,2358,0.0,2164.5,-387
16571,2232,1763,1.0,1997.5,469
16572,1770,2290,0.0,2030.0,-520
16573,2353,1889,1.0,2121.0,464
16574,1899,2331,0.0,2115.0,-432
16575,2395,1923,1.0,2159.0,472
16576,1768,2227,0.0,1997.5,-459
16577,1908,2421,0.0,2164.5,-513
16578,2298,1773,1.0,2035.5,525
16579,1641,2189,0.0,1915.0,-548
16580,2161,1314,1.0,1737.5,847
16581,2335,1787,1.0,2061.0,548
16582,1876,2314,0.0,2095.0,-438
16583,2308,1942,1.0,2125.0,366
16584,1825,1997,0.0,1911.0,-172
16585,1948,2249,0.0,2098.5,-301
16586,2411,1781,1.0,2096.0,630
16587,1837,2383,0.0,2110.0,-546
16588,2279,1766,1.0,2022.5,513
16589,2391,1897,1.0,2144.0,494
16590,1926,2228,0.5,2077.0,-302
16591,2288,1751,1.0,2019.5,537
16592,1773,2147,0.0,1960.0,-374
16593,2422,2002,1.0,2212.0,420
16594,1888,2369,0.0,2128.5,-481
16595,2277,1718,1.0,1997.5,559
16596,1631,2188,0.0,1909.5,-557
16597,2290,2408,1.0,2349.0,-118
16598,1961,1704,0.0,1832.5,257
16599,2054,2216,1.0,2135.0,-162
16600,2338,1826,1.0,2082.0,512
16601,1907,1948,0.0,1927.5,-41
16602,2316,2325,1.0,2320.5,-9
16603,1654,1786,0.0,1720.0,-132
16604,2001,2249,0.0,2125.0,-248
16605,2376,2389,1.0,2382.5,-13
16606,1728,1824,0.0,1776.0,-96
16607,2183,2268,1.0,2225.5,-85
16608,2306,1703,0.5,2004.5,603
16609,1814,1803,0.0,1808.5,11
16610,2231,2258,1.0,2244.5,-27
16611,1701,1922,0.0,1811.5,-221
16612,2050,2221,0.0,2135.5,-171
16613,2324,2324,1.0,2324.0,0
16614,1729,1860,0.0,1794.5,-131
16615,2126,2223,1.0,2174.5,-97
16616,2362,1561,1.0,1961.5,801
16617,1783,1935,0.0,1859.0,-152
16618,2232,2256,1.0,2244.0,-24
16619,1683,1746,0.0,1714.5,-63
16620,1808,2235,0.0,2021.5,-427
16621,2281,2315,1.0,2298.0,-34
16622,1766,1738,0.0,1752.0,28
16623,2269,2276,1.0,2272.5,-7
16624,2360,1815,1.0,2087.5,545
16625,1763,1802,0.5,1782.5,-39
16626,2234,2271,1.0,2252.5,-37
16627,1611,1794,0.0,1702.5,-183
16628,1812,2230,0.0,2021.0,-418
16629,2189,2272,1.0,2230.5,-83
16630,1699,1778,0.0,1738.5,-79
16631,2120,2219,1.0,2169.5,-99
16632,2318,1670,1.0,1994.0,648
16633,1662,1759,0.0,1710.5,-97
16634,2161,2260,1.0,2210.5,-99
16635,1495,1794,0.0,1644.5,-299
16636,1778,2207,0.0,1992.5,-429
16637,2214,2304,1.0,2259.0,-90
16638,1703,1802,0.0,1752.5,-99
16639,2247,2234,1.0,2240.5,13
16640,2243,1638,1.0,1940.5,605
16641,1577,2017,0.0,1797.0,-440
16642,2241,2306,1.0,2273.5,-65
16643,1626,1544,1.0,1585.0,82
16644,1731,2051,0.0,1891.0,-320
16645,2140,2355,0.5,2247.5,-215
16646,1699,1750,0.0,1724.5,-51
16647,2188,2273,0.0,2230.5,-85
16648,2389,1688,1.0,2038.5,701
16649,1857,1685,0.5,1771.0,172
16650,2162,2275,1.0,2218.5,-113
16651,1983,2126,0.0,2054.5,-143
16652,2017,2386,1.0,2201.5,-369
16653,1584,1668,0.0,1626.0,-84
16654,2133,2103,1.0,2118.0,30
16655,2326,1606,1.0,1966.0,720
16656,1721,2040,0.0,1880.5,-319
16657,2201,2209,1.0,2205.0,-8
16658,1392,1681,0.0,1536.5,-289
16659,1696,2194,0.0,1945.0,-498
16660,2267,2245,1.0,2256.0,22
16661,1773,1748,0.0,1760.5,25
16662,2137,2201,1.0,2169.0,-64
16663,2214,1594,0.5,1904.0,620
16664,1531,1777,0.0,1654.0,-246
16665,2133,2220,1.0,2176.5,-87
16666,1771,1700,0.0,1735.5,71
16667,1605,2021,0.0,1813.0,-416
16668,2222,2170,1.0,2196.0,52
16669,1535,1928,0.0,1731.5,-393
16670,2087,2120,1.0,2103.5,-33
16671,2247,1894,1.0,2070.5,353
16672,1617,2186,0.0,1901.5,-569
16673,2109,1483,1.0,1796.0,626
16674,1490,2112,0.5,1801.0,-622
16675,1821,2332,0.0,2076.5,-511
16676,2259,1665,1.0,1962.0,594
16677,1616,2079,0.0,1847.5,-463
16678,2121,1605,1.0,1863.0,516
16679,2276,1671,1.0,1973.5,605
16680,1864,2205,0.0,2034.5,-341
16681,2164,1625,1.0,1894.5,539
16682,1544,2101,0.0,1822.5,-557
16683,1574,2367,0.0,1970.5,-793
16684,2205,1632,1.0,1918.5,573
16685,1740,2064,0.0,1902.0,-324
16686,1992,1693,1.0,1842.5,299
16687,2402,1716,1.0,2059.0,686
16688,1649,2150,0.0,1899.5,-501
16689,2096,1594,1.0,1845.0,502
16690,1574,2053,0.0,1813.5,-479
16691,1724,2252,0.0,1988.0,-528
16692,2127,1637,1.0,1882.0,490
16693,1585,2073,0.0,1829.0,-488
16694,1957,1563,1.0,1760.0,394
16695,2444,2199,1.0,2321.5,245
16696,1667,2222,0.0,1944.5,-555
16697,2005,1623,0.5,1814.0,382
16698,1685,1913,0.0,1799.0,-228
16699,2176,2279,1.0,2227.5,-103
16700,1492,1584,0.0,1538.0,-92
16701,1892,2125,1.0,2008.5,-233
16702,2369,1603,1.0,1986.0,766
16703,1450,1258,0.0,1354.0,192
16704,2046,2075,1.0,2060.5,-29
16705,1488,1570,0.0,1529.0,-82
16706,1715,2106,0.0,1910.5,-391
16707,2128,2281,1.0,2204.5,-153
16708,1403,2065,0.0,1734.0,-662
16709,2268,1232,1.0,1750.0,1036
16710,1375,2135,0.0,1755.0,-760
16711,2093,1372,1.0,1732.5,721
16712,1407,2079,0.0,1743.0,-672
16713,1642,2181,0.0,1911.5,-539
16714,2139,1419,1.0,1779.0,720
16715,1312,2056,0.0,1684.0,-744
16716,2060,1226,1.0,1643.0,834
16717,2254,1480,1.0,1867.0,774
16718,1621,2216,0.0,1918.5,-595
16719,2047,1517,1.0,1782.0,530
16720,2194,2182,1.0,2188.0,12
16721,1390,1504,0.0,1447.0,-114
16722,2062,2035,1.0,2048.5,27
16723,2149,1477,1.0,1813.0,672
16724,1455,1476,0.0,1465.5,-21
16725,2117,1983,1.0,2050.0,134
16726,1339,1363,0.0,1351.0,-24
16727,1741,1928,0.0,1834.5,-187
16728,2031,2285,1.0,2158.0,-254
16729,1476,2021,0.0,1748.5,-545
16730,1994,1350,1.0,1672.0,644
16731,2175,1668,1.0,1921.5,507
16732,1104,2106,0.0,1605.0,-1002
16733,2113,1566,1.0,1839.5,547
16734,1515,2028,0.0,1771.5,-513
16735,2035,2119,1.0,2077.0,-84
16736,2000,2064,1.0,2032.0,-64
16737,2262,1351,1.0,1806.5,911
16738,1233,1775,0.0,1504.0,-542
16739,1883,1892,1.0,1887.5,-9
16740,1392,1607,0.0,1499.5,-215
16741,2095,2238,1.0,2166.5,-143
16742,2009,2003,1.0,2006.0,6
16743,2136,1754,1.0,1945.0,382
16744,1993,2142,1.0,2067.5,-149
16745,1406,2006,0.0,1706.0,-600
16746,2147,2230,1.0,2188.5,-83
16747,1784,1994,1.0,1889.0,-210
16748,2104,1259,1.0,1681.5,845
16749,1059,1072,0.0,1065.5,-13
16750,1954,2105,1.0,2029.5,-151
16751,2002,2129,1.0,2065.5,-127
16752,1479,1965,0.0,1722.0,-486
16753,1993,1195,1.0,1594.0,798
16754,2159,1022,1.0,1590.5,1137
16755,1793,2015,1.0,1904.0,-222
16756,2008,2025,1.0,2016.5,-17
16757,1825,1830,1.0,1827.5,-5
16758,2092,2027,0.0,2059.5,65
16759,2019,1840,0.0,1929.5,179
16760,2043,2059,1.0,2051.0,-16
16761,1953,1918,1.0,1935.5,35
16762,1964,1983,0.0,1973.5,-19
16763,2064,1896,0.0,1980.0,168
16764,1923,1993,1.0,1958.0,-70
16765,1973,1994,1.0,1983.5,-21
16766,1953,2474,0.0,2213.5,-521
16767,2342,1848,1.0,2095.0,494
16768,1915,2324,0.0,2119.5,-409
16769,2287,1809,1.0,2048.0,478
16770,2252,2583,0.0,2417.5,-331
16771,2522,2223,1.0,2372.5,299
16772,2127,2475,0.0,2301.0,-348
16773,2417,2073,1.0,2245.0,344
16774,2550,2279,0.5,2414.5,271
16775,2176,2475,0.0,2325.5,-299
16776,2457,2125,1.0,2291.0,332
16777,2086,2416,0.0,2251.0,-330
16778,2369,2520,0.0,2444.5,-151
16779,2475,2075,1.0,2275.0,400
16780,2046,2484,0.0,2265.0,-438
16781,2452,2011,1.0,2231.5,441
16782,2295,2136,0.0,2215.5,159
16783,2043,2361,0.0,2202.0,-318
16784,2339,2142,1.0,2240.5,197
16785,2006,2302,0.5,2154.0,-296
16786,2522,2281,0.5,2401.5,241
16787,2128,2463,1.0,2295.5,-335
16788,2474,2065,1.0,2269.5,409
16789,2119,2419,1.0,2269.0,-300
16790,2268,2542,1.0,2405.0,-274
16791,2402,2135,1.0,2268.5,267
16792,2093,2379,0.0,2236.0,-286
16793,2287,2079,1.0,2183.0,208
16794,2444,2181,0.5,2312.5,263
16795,2167,2366,0.0,2266.5,-199
16796,2449,2139,0.5,2294.0,310
16797,2056,2365,0.5,2210.5,-309
16798,2254,2437,0.5,2345.5,-183
16799,2409,2216,1.0,2312.5,193
16800,1992,2346,0.0,2169.0,-354
16801,2246,1908,1.0,2077.0,338
16802,2467,2182,1.0,2324.5,285
16803,2194,2336,0.5,2265.0,-142
16804,2379,2035,1.0,2207.0,344
16805,2062,2355,0.0,2208.5,-293
16806,2204,2515,0.0,2359.5,-311
16807,2386,2149,0.0,2267.5,237
16808,2117,2358,1.0,2237.5,-241
16809,2232,1928,1.0,2080.0,304
16810,2474,2285,1.0,2379.5,189
16811,2031,2342,0.5,2186.5,-311
16812,2324,2021,1.0,2172.5,303
16813,1994,2287,0.0,2140.5,-293
16814,2175,2394,0.0,2284.5,-219
16815,2353,2106,1.0,2229.5,247
16816,2113,2395,0.5,2254.0,-282
16817,2227,2028,0.5,2127.5,199
16818,2421,2199,1.0,2310.0,222
16819,2119,2298,0.0,2208.5,-179
16820,2189,2035,1.0,2112.0,154
16821,2064,2161,0.0,2112.5,-97
16822,2353,2429,0.5,2391.0,-76
16823,2335,2262,0.5,2298.5,73
16824,1892,2308,0.0,2100.0,-416
16825,1997,1883,1.0,1940.0,114
16826,2411,2238,1.0,2324.5,173
16827,2095,2383,0.0,2239.0,-288
16828,2268,2003,0.0,2135.5,265
16829,2023,2279,1.0,2151.0,-256
16830,2230,2422,0.5,2326.0,-192
16831,2369,2147,0.5,2258.0,222
16832,1994,2277,0.5,2135.5,-283
16833,2156,1780,1.0,1968.0,376
16834,2408,2104,1.0,2256.0,304
16835,2105,2322,1.0,2213.5,-217
16836,2216,1954,1.0,2085.0,262
16837,1941,2054,0.0,1997.5,-113
16838,2129,2338,0.0,2233.5,-209
16839,2325,2002,0.0,2163.5,323
16840,1965,2316,0.0,2140.5,-351
16841,2249,1993,1.0,2121.0,256
16842,2389,2159,1.0,2274.0,230
16843,2046,2376,0.0,2211.0,-330
16844,2268,2015,1.0,2141.5,253
16845,1793,2183,0.0,1988.0,-390
16846,2324,2149,0.5,2236.5,175
16847,2025,2289,0.5,2157.0,-264
16848,2324,1830,1.0,2077.0,494
16849,1825,2223,0.0,2024.0,-398
16850,2092,2362,0.0,2227.0,-270
16851,2301,2027,1.0,2164.0,274
16852,2019,2232,0.0,2125.5,-213
16853,2235,1779,1.0,2007.0,456
16854,2315,2059,1.0,2187.0,256
16855,2043,2276,0.0,2159.5,-233
16856,2269,1918,1.0,2093.5,351
16857,1953,2264,1.0,2108.5,-311
16858,2378,1964,1.0,2171.0,414
16859,1983,2189,1.0,2086.0,-206
16860,2219,2064,1.0,2141.5,155
16861,1896,2120,0.0,2008.0,-224
16862,1993,2318,0.0,2155.5,-325
16863,2260,1923,1.0,2091.5,337
16864,1994,2161,0.5,2077.5,-167
16865,2207,1973,1.0,2090.0,234
16866,2304,2422,0.5,2363.0,-118
16867,2391,2219,0.5,2305.0,172
16868,2234,2228,1.0,2231.0,6
16869,2288,2247,0.5,2267.5,41
16870,2386,2368,1.0,2377.0,18
16871,2306,2323,0.5,2314.5,-17
16872,2017,2258,0.0,2137.5,-241
16873,2231,2103,1.0,2167.0,128
16874,2360,2326,0.5,2343.0,34
16875,2183,2271,0.5,2227.0,-88
16876,2255,2201,0.0,2228.0,54
16877,2194,2234,1.0,2214.0,-40
16878,2245,2389,0.0,2317.0,-144
16879,2275,2267,0.5,2271.0,8
16880,2201,2162,0.0,2181.5,39
16881,2065,2185,0.0,2125.0,-120
16882,2382,2331,1.0,2356.5,51
16883,2220,2170,0.5,2195.0,50
16884,2222,2133,1.0,2177.5,89
16885,2021,2087,0.0,2054.0,-66
16886,2332,2332,0.5,2332.0,0
16887,2247,2259,1.0,2253.0,-12
16888,2121,2186,0.5,2153.5,-65
16889,2109,2024,1.0,2066.5,85
16890,2444,2276,1.0,2360.0,168
16891,2205,2222,0.5,2213.5,-17
16892,1996,2101,1.0,2048.5,-105
16893,2084,1913,0.5,1998.5,171
16894,2367,2243,0.0,2305.0,124
16895,2306,2205,0.5,2255.5,101
16896,2092,2241,0.0,2166.5,-149
16897,2178,2064,0.5,2121.0,114
16898,2355,2402,0.5,2378.5,-47
16899,2150,2140,0.0,2145.0,10
16900,2273,2096,1.0,2184.5,177
16901,2053,2188,0.0,2120.5,-135
16902,1903,1731,0.0,1817.0,172
16903,1750,1857,1.0,1803.5,-107
16904,1859,1699,0.0,1779.0,160
16905,1688,1833,1.0,1760.5,-145
16906,2017,1736,1.0,1876.5,281
16907,1759,1577,0.0,1668.0,182
16908,1626,1662,1.0,1644.0,-36
16909,1794,1660,1.0,1727.0,134
16910,1897,1778,1.0,1837.5,119
16911,1802,1926,1.0,1864.0,-124
16912,1751,1703,0.5,1727.0,48
16913,1636,1735,0.0,1685.5,-99
16914,1803,1495,0.0,1649.0,308
16915,1983,1814,0.0,1898.5,169
16916,1922,1584,0.0,1753.0,338
16917,1606,1643,1.0,1624.5,-37
16918,1802,2040,0.0,1921.0,-238
16919,1721,1763,0.5,1742.0,-42
16920,1794,1681,1.0,1737.5,113
16921,1392,1611,0.0,1501.5,-219
16922,1783,1696,1.0,1739.5,87
16923,1748,1685,1.0,1716.5,63
16924,1857,1773,0.0,1815.0,84
16925,1584,1528,0.5,1556.0,56
16926,1777,1871,1.0,1824.0,-94
16927,1689,1531,1.0,1610.0,158
16928,1700,1659,0.5,1679.5,41
16929,1563,1771,0.0,1667.0,-208
16930,1894,1605,1.0,1749.5,289
16931,1928,1737,1.0,1832.5,191
16932,1617,1535,0.5,1576.0,82
16933,1679,1490,1.0,1584.5,189
16934,2199,1821,1.0,2010.0,378
16935,1616,1667,0.0,1641.5,-51
16936,1623,1665,1.0,1644.0,-42
16937,2159,1671,0.5,1915.0,488
16938,1864,1953,1.0,1908.5,-89
16939,1898,1625,1.0,1761.5,273
16940,1497,1844,0.0,1670.5,-347
16941,1574,2125,0.0,1849.5,-551
16942,2078,1632,1.0,1855.0,446
16943,1740,1791,0.0,1765.5,-51
16944,1855,1693,0.0,1774.0,162
16945,1894,1716,1.0,1805.0,178
16946,1649,1894,0.0,1771.5,-245
16947,1679,1594,1.0,1636.5,85
16948,1574,1643,0.0,1608.5,-69
16949,1724,1910,0.0,1817.0,-186
16950,1922,1637,1.0,1779.5,285
16951,1585,1807,0.5,1696.0,-222
16952,1793,1563,0.0,1678.0,230
16953,2033,1685,1.0,1859.0,348
16954,1584,2063,0.0,1823.5,-479
16955,1886,1492,0.0,1689.0,394
16956,1603,1695,1.0,1649.0,-92
16957,1450,2015,0.0,1732.5,-565
16958,2073,1570,1.0,1821.5,503
16959,1488,1735,0.0,1611.5,-247
16960,1881,1499,1.0,1690.0,382
16961,2048,1715,1.0,1881.5,333
16962,1913,1868,1.0,1890.5,45
16963,1668,1403,0.0,1535.5,265
16964,1375,1611,0.0,1493.0,-236
16965,1947,1932,1.0,1939.5,15
16966,1407,1372,0.0,1389.5,35
16967,1609,1881,1.0,1745.0,-272
16968,2023,1561,1.0,1792.0,462
16969,1419,1642,0.0,1530.5,-223
16970,1763,1971,1.0,1867.0,-208
16971,1291,1226,0.0,1258.5,65
16972,1899,1719,1.0,1809.0,180
16973,1264,1923,0.0,1593.5,-659
16974,1768,1390,1.0,1579.0,378
16975,1477,1781,0.0,1629.0,-304
16976,1476,2142,0.0,1809.0,-666
16977,1908,1455,1.0,1681.5,453
16978,1363,1773,0.0,1568.0,-410
16979,1641,1339,1.0,1490.0,302
16980,1787,1741,0.0,1764.0,46
16981,1942,1876,1.0,1909.0,66
16982,1476,1825,0.5,1650.5,-349
16983,1668,1781,0.0,1724.5,-113
16984,1837,1104,1.0,1470.5,733
16985,1566,1766,0.0,1666.0,-200
16986,1515,1943,0.0,1729.0,-428
16987,1831,1460,0.0,1645.5,371
16988,1732,1834,1.0,1783.0,-102
16989,2002,1351,0.5,1676.5,651
16990,1233,1775,0.0,1504.0,-542
16991,1687,1718,1.0,1702.5,-31
16992,1948,1631,1.0,1789.5,317
16993,1392,1907,0.0,1649.5,-515
16994,1786,1565,0.0,1675.5,221
16995,1754,1704,0.0,1729.0,50
16996,1961,1826,0.0,1893.5,135
16997,1406,1592,1.0,1499.0,-186
16998,2001,1824,0.0,1912.5,177
16999,1703,1259,1.0,1481.0,444
17000,1072,2050,0.0,1561.0,-978
17001,1860,1059,1.0,1459.5,801
17002,1204,1729,0.0,1466.5,-525
17003,1576,1393,1.0,1484.5,183
17004,1935,1746,1.0,1840.5,189
17005,1683,1479,0.0,1581.0,204
17006,1022,1529,0.0,1275.5,-507
17007,1738,1808,1.0,1773.0,-70
17008,1756,1766,1.0,1761.0,-10
17009,1778,1812,1.0,1795.0,-34
17010,1670,1699,1.0,1684.5,-29
17011,1480,1953,0.0,1716.5,-473
17012,1848,1621,1.0,1734.5,227
17013,1517,1915,0.0,1716.0,-398
17014,2658,2338,1.0,2498.0,320
17015,2325,2583,0.5,2454.0,-258
17016,2522,2316,0.0,2419.0,206
17017,2249,2475,0.5,2362.0,-226
17018,2538,2324,1.0,2431.0,214
17019,2289,2520,0.0,2404.5,-231
17020,2475,2324,0.5,2399.5,151
17021,2223,2452,0.5,2337.5,-229
17022,2315,2421,0.5,2368.0,-106
17023,2298,2281,1.0,2289.5,17
17024,2276,2189,0.5,2232.5,87
17025,2161,2269,0.5,2215.0,-108
17026,2437,2295,0.0,2366.0,142
17027,2361,2429,1.0,2395.0,-68
17028,2409,2304,0.5,2356.5,105
17029,2339,2346,0.0,2342.5,-7
17030,2378,2389,0.0,2383.5,-11
17031,2376,2272,1.0,2324.0,104
17032,2189,2268,1.0,2228.5,-79
17033,2001,2219,0.0,2110.0,-218
17034,2362,2326,0.5,2344.0,36
17035,2183,2301,0.0,2242.0,-118
17036,2256,2209,1.0,2232.5,47
17037,2201,2235,0.0,2218.0,-34
17038,2444,2550,0.5,2497.0,-106
17039,2539,2366,0.5,2452.5,173
17040,2449,2475,0.5,2462.0,-26
17041,2457,2365,1.0,2411.0,92
17042,2422,2467,0.5,2444.5,-45
17043,2372,2369,1.0,2370.5,3
17044,2277,2336,0.5,2306.5,-59
17045,2379,2156,0.5,2267.5,223
17046,2304,2474,0.5,2389.0,-170
17047,2383,2214,1.0,2298.5,169
17048,2219,2324,1.0,2271.5,-105
17049,2287,2234,0.5,2260.5,53
17050,2382,2444,0.5,2413.0,-62
17051,2222,2222,1.0,2222.0,0
17052,2120,2005,0.5,2062.5,115
17053,1996,2087,0.5,2041.5,-91
17054,2394,2368,1.0,2381.0,26
17055,2258,2353,0.0,2305.5,-95
17056,2331,2231,0.5,2281.0,100
17057,2221,2395,0.0,2308.0,-174
17058,2429,2243,1.0,2336.0,186
17059,2306,2335,1.0,2320.5,-29
17060,2314,2241,0.0,2277.5,73
17061,2051,2308,0.5,2179.5,-257
17062,2355,2408,1.0,2381.5,-53
17063,2322,2140,1.0,2231.0,182
17064,2188,2290,0.5,2239.0,-102
17065,2216,2085,1.0,2150.5,131
17066,2318,2332,1.0,2325.0,-14
17067,2247,2221,0.0,2234.0,26
17068,2161,2186,0.5,2173.5,-25
17069,2109,2207,0.5,2158.0,-98
17070,2281,2542,0.5,2411.5,-261
17071,2408,2128,1.0,2268.0,280
17072,2065,2402,0.0,2233.5,-337
17073,2379,2119,1.0,2249.0,260
17074,2389,2515,1.0,2452.0,-126
17075,2386,2162,0.5,2274.0,224
17076,2126,2232,1.0,2179.0,-106
17077,2290,2065,0.5,2177.5,225
17078,2249,2204,1.0,2226.5,45
17079,2149,2411,0.0,2280.0,-262
17080,2383,1983,1.0,2183.0,400
17081,2117,2268,0.5,2192.5,-151
17082,2238,2522,0.0,2380.0,-284
17083,2486,2095,0.5,2290.5,391
17084,2003,2463,0.0,2233.0,-460
17085,2474,2009,1.0,2241.5,465
17086,2159,2386,1.0,2272.5,-227
17087,2323,2046,0.5,2184.5,277
17088,2015,2103,1.0,2059.0,-88
17089,2133,1793,1.0,1963.0,340
17090,2245,2092,1.0,2168.5,153
17091,2027,2267,0.5,2147.0,-240
17092,2185,2019,0.5,2102.0,166
17093,1840,2137,1.0,1988.5,-297
17094,2181,2381,0.0,2281.0,-200
17095,1894,2167,0.0,2030.5,-273
17096,2056,1894,1.0,1975.0,162
17097,1679,2060,0.0,1869.5,-381
17098,2136,2015,1.0,2075.5,121
17099,2073,2043,0.0,2058.0,30
17100,1993,1735,0.0,1864.0,258
17101,1881,2006,1.0,1943.5,-125
17102,2048,2230,0.0,2139.0,-182
17103,2147,1868,1.0,2007.5,279
17104,1913,1994,0.0,1953.5,-81
17105,1780,1836,1.0,1808.0,-56
17106,1731,1932,0.0,1831.5,-201
17107,1947,1584,0.0,1765.5,363
17108,1750,1881,1.0,1815.5,-131
17109,1807,1688,0.5,1747.5,119
17110,2422,2023,0.5,2222.5,399
17111,1971,2228,0.0,2099.5,-257
17112,2288,1763,1.0,2025.5,525
17113,1719,2147,0.0,1933.0,-428
17114,2205,1889,1.0,2047.0,316
17115,1899,2164,0.5,2031.5,-265
17116,2101,1923,1.0,2012.0,178
17117,1768,2084,0.0,1926.0,-316
17118,2142,2367,0.5,2254.5,-225
17119,2205,1908,1.0,2056.5,297
17120,1773,2092,0.5,1932.5,-319
17121,1992,1641,1.0,1816.5,351
17122,1948,2268,0.0,2108.0,-320
17123,2135,1907,1.0,2021.0,228
17124,1786,2093,0.0,1939.5,-307
17125,2030,1654,0.0,1842.0,376
17126,2106,2175,1.0,2140.5,-69
17127,1826,1961,0.5,1893.5,-135
17128,1949,2113,0.5,2031.0,-164
17129,2050,1797,0.5,1923.5,253
17130,2262,2353,1.0,2307.5,-91
17131,1576,1860,0.0,1718.0,-284
17132,1607,1883,1.0,1745.0,-276
17133,2104,1561,1.0,1832.5,543
17134,1738,1808,0.0,1773.0,-70
17135,1954,2105,1.0,2029.5,-151
17136,1756,1766,0.0,1761.0,-10
17137,1812,1883,0.0,1847.5,-71
17138,2002,2129,0.5,2065.5,-127
17139,1699,1778,0.5,1738.5,-79
17140,1885,1965,0.5,1925.0,-80
17141,2149,1621,0.5,1885.0,528
17142,1577,2017,1.0,1797.0,-440
17143,1830,2008,1.0,1919.0,-178
17144,1660,1544,0.5,1602.0,116
17145,2059,1825,0.5,1942.0,234
17146,1781,1948,0.0,1864.5,-167
17147,1953,2043,0.0,1998.0,-90
17148,1795,1837,0.5,1816.0,-42
17149,1547,1921,0.0,1734.0,-374
17150,1718,2002,0.0,1860.0,-284
17151,2064,1983,1.0,2023.5,81
17152,1631,1687,0.0,1659.0,-56
17153,2125,1896,0.0,2010.5,229
17154,2271,2360,0.5,2315.5,-89
17155,1789,2078,0.5,1933.5,-289
17156,2234,2255,1.0,2244.5,-21
17157,2402,1791,1.0,2096.5,611
17158,1926,1897,1.0,1911.5,29
17159,2150,1892,1.0,2021.0,258
17160,1735,1773,0.0,1754.0,-38
17161,2279,2096,1.0,2187.5,183
17162,1831,1943,0.5,1887.0,-112
17163,2125,2176,1.0,2150.5,-51
17164,1703,1834,0.0,1768.5,-131
17165,2001,2086,0.5,2043.5,-85
17166,2216,2254,1.0,2235.0,-38
17167,1728,1824,0.5,1776.0,-96
17168,1908,2047,1.0,1977.5,-139
17169,2182,1703,1.0,1942.5,479
17170,1763,1802,0.0,1782.5,-39
17171,2062,2035,1.0,2048.5,27
17172,1611,1794,0.0,1702.5,-183
17173,2285,1994,1.0,2139.5,291
17174,1983,1495,1.0,1739.0,488
17175,2021,2031,1.0,2026.0,-10
17176,1606,1668,1.0,1637.0,-62
17177,1777,1994,0.5,1885.5,-217
17178,1923,1993,1.0,1958.0,-70
17179,1700,1531,0.0,1615.5,169
17180,1945,1994,1.0,1969.5,-49
17181,2159,2199,0.5,2179.0,-40
17182,1667,1898,1.0,1782.5,-231
17183,1844,1623,0.0,1733.5,221
17184,2331,1745,0.5,2038.0,586
17185,1910,2200,0.0,2055.0,-290
17186,2220,2214,1.0,2217.0,6
17187,1807,1922,0.5,1864.5,-115
17188,1876,2133,0.0,2004.5,-257
17189,2223,2252,1.0,2237.5,-29
17190,1825,1942,0.0,1883.5,-117
17191,2073,2127,1.0,2100.0,-54
17192,1696,1763,0.0,1729.5,-67
17193,2075,2369,0.5,2222.0,-294
17194,1594,1748,0.0,1671.0,-154
17195,2011,2106,1.0,2058.5,-95
17196,2199,1584,1.0,1891.5,615
17197,1535,1928,0.0,1731.5,-393
17198,2064,2119,1.0,2091.5,-55
17199,1685,2000,0.0,1842.5,-315
17200,1857,1903,1.0,1880.0,-46
17201,1492,1584,0.0,1538.0,-92
17202,1822,1859,1.0,1840.5,-37
17203,2063,2033,1.0,2048.0,30
17204,1195,1479,0.0,1337.0,-284
17205,1724,1886,1.0,1805.0,-162
17206,1783,1935,1.0,1859.0,-152
17207,1683,1746,1.0,1714.5,-63
17208,1871,1232,1.0,1551.5,639
17209,1375,1689,0.0,1532.0,-314
17210,1659,1372,1.0,1515.5,287
17211,1561,1563,0.5,1562.0,-2
17212,1671,1642,1.0,1656.5,29
17213,1419,1864,0.0,1641.5,-445
17214,1625,1312,1.0,1468.5,313
17215,1226,1497,0.0,1361.5,-271
17216,1480,1724,0.0,1602.0,-244
17217,1585,1621,1.0,1603.0,-36
17218,1517,1563,0.0,1540.0,-46
17219,1491,1025,1.0,1258.0,466
17220,1741,1264,1.0,1502.5,477
17221,1476,1390,1.0,1433.0,86
17222,1477,1350,1.0,1413.5,127
17223,1851,1783,1.0,1817.0,68
17224,1857,1674,0.0,1765.5,183
17225,1684,1528,0.5,1606.0,156
17226,1821,1725,0.5,1773.0,96
17227,1737,1894,1.0,1815.5,-157
17228,1665,1616,1.0,1640.5,49
17229,1483,1617,0.5,1550.0,-134
17230,1716,1474,1.0,1595.0,242
17231,1814,1803,1.0,1808.5,11
17232,1594,1649,1.0,1621.5,-55
17233,1643,1701,0.0,1672.0,-58
17234,1392,1574,0.0,1483.0,-182
17235,1632,1392,1.0,1512.0,240
17236,1488,1693,1.0,1590.5,-205
17237,1754,1515,1.0,1634.5,239
17238,1072,1406,0.0,1239.0,-334
17239,1393,1204,0.0,1298.5,189
17240,1022,1668,0.0,1345.0,-646
17241,1104,1566,0.0,1335.0,-462
17242,1775,1233,0.0,1504.0,542
17243,1778,1450,1.0,1614.0,328
17244,1570,1802,0.0,1686.0,-232
17245,1638,1488,1.0,1563.0,150
17246,1499,1636,0.0,1567.5,-137
17247,2040,1715,1.0,1877.5,325
17248,1681,1721,0.5,1701.0,-40
17249,1668,1276,1.0,1472.0,392
17250,1736,1476,0.0,1606.0,260
17251,1455,1759,0.0,1607.0,-304
17252,1662,1363,1.0,1512.5,299
17253,1276,1794,0.0,1535.0,-518
17254,1953,2259,0.0,2106.0,-306
17255,2079,1848,1.0,1963.5,231
17256,1809,2121,0.0,1965.0,-312
17257,2024,1595,1.0,1809.5,429
17258,2467,2538,0.5,2502.5,-71
17259,2520,2372,0.5,2446.0,148
17260,2336,2475,0.5,2405.5,-139
17261,2484,2355,1.0,2419.5,129
17262,2550,2301,1.0,2425.5,249
17263,2256,2539,0.0,2397.5,-283
17264,2475,2232,1.0,2353.5,243
17265,2235,2416,0.5,2325.5,-181
17266,2542,2408,0.5,2475.0,134
17267,2322,2408,1.0,2365.0,-86
17268,2402,2290,1.0,2346.0,112
17269,2216,2379,0.5,2297.5,-163
17270,2295,2394,1.0,2344.5,-99
17271,2353,2361,1.0,2357.0,-8
17272,2304,2331,0.5,2317.5,-27
17273,2395,2302,0.5,2348.5,93
17274,2421,2389,1.0,2405.0,32
17275,2275,2298,1.0,2286.5,-23
17276,2189,2162,0.0,2175.5,27
17277,2065,2161,0.5,2113.0,-96
17278,2444,2318,1.0,2381.0,126
17279,2221,2222,1.0,2221.5,-1
17280,2005,2260,0.0,2132.5,-255
17281,2161,1913,1.0,2037.0,248
17282,2243,2658,1.0,2450.5,-415
17283,2583,2306,1.0,2444.5,277
17284,2241,2475,0.5,2358.0,-234
17285,2417,2051,1.0,2234.0,366
17286,2389,2304,1.0,2346.5,85
17287,2214,2376,0.0,2295.0,-162
17288,2183,2219,0.5,2201.0,-36
17289,2247,2001,1.0,2124.0,246
17290,2338,2249,1.0,2293.5,89
17291,2411,2325,1.0,2368.0,86
17292,2316,2383,0.5,2349.5,-67
17293,2279,2249,0.0,2264.0,30
17294,2474,2378,0.5,2426.0,96
17295,2272,2383,0.0,2327.5,-111
17296,2342,2189,0.5,2265.5,153
17297,2120,2287,0.0,2203.5,-167
17298,2199,2437,0.0,2318.0,-238
17299,2429,2119,1.0,2274.0,310
17300,2035,2346,0.0,2190.5,-311
17301,2246,2000,1.0,2123.0,246
17302,1547,2382,0.0,1964.5,-835
17303,2170,1964,1.0,2067.0,206
17304,1983,2120,0.0,2051.5,-137
17305,2087,2064,1.0,2075.5,23
17306,2276,2355,0.5,2315.5,-79
17307,2140,2164,1.0,2152.0,-24
17308,2101,2273,0.5,2187.0,-172
17309,2085,2084,0.5,2084.5,1
17310,2199,2429,0.0,2314.0,-230
17311,2335,1667,1.0,2001.0,668
17312,1623,2314,0.5,1968.5,-691
17313,2254,2444,0.5,2349.0,-190
17314,2366,2047,0.0,2206.5,319
17315,1992,2449,0.0,2220.5,-457
17316,2279,1908,1.0,2093.5,371
17317,1584,2105,1.0,1844.5,-521
17318,1954,1750,1.0,1852.0,204
17319,1699,1941,1.0,1820.0,-242
17320,1883,1688,1.0,1785.5,195
17321,2332,2167,1.0,2249.5,165
17322,2139,2247,0.5,2193.0,-108
17323,2186,2056,0.5,2121.0,130
17324,2060,2112,1.0,2086.0,-52
17325,2326,2315,0.5,2320.5,11
17326,2281,2183,1.0,2232.0,98
17327,2201,2276,0.5,2238.5,-75
17328,2264,2194,0.5,2229.0,70
17329,2522,2175,1.0,2348.5,347
17330,2106,2486,0.0,2296.0,-380
17331,2463,2028,1.0,2245.5,435
17332,1949,2474,0.0,2211.5,-525
17333,2129,2422,0.0,2275.5,-293
17334,2369,2002,1.0,2185.5,367
17335,1993,2277,0.0,2135.0,-284
17336,2188,1885,1.0,2036.5,303
17337,2360,2422,1.0,2391.0,-62
17338,2391,2255,0.5,2323.0,136
17339,2234,2288,0.0,2261.0,-54
17340,2147,2230,0.0,2188.5,-83
17341,2230,2268,0.5,2249.0,-38
17342,2135,2147,0.0,2141.0,-12
17343,1994,2093,0.0,2043.5,-99
17344,2079,1784,0.5,1931.5,295
17345,2324,2331,1.0,2327.5,-7
17346,2214,2289,0.5,2251.5,-75
17347,2223,2220,0.5,2221.5,3
17348,2021,2126,1.0,2073.5,-105
17349,2367,2281,0.5,2324.0,86
17350,2128,2205,0.0,2166.5,-77
17351,2064,2119,0.5,2091.5,-55
17352,1965,1992,1.0,1978.5,-27
17353,2332,1923,1.0,2127.5,409
17354,1994,2079,0.0,2036.5,-85
17355,2121,1973,0.5,2047.0,148
17356,1945,2024,0.5,1984.5,-79
17357,2369,2353,1.0,2361.0,16
17358,2262,2046,1.0,2154.0,216
17359,2106,1883,0.0,1994.5,223
17360,1607,2011,0.5,1809.0,-404
17361,2182,2402,0.0,2292.0,-220
17362,2150,2194,1.0,2172.0,-44
17363,2062,2096,0.0,2079.0,-34
17364,2053,1994,1.0,2023.5,59
17365,2279,2159,0.0,2219.0,120
17366,2046,2176,0.0,2111.0,-130
17367,2125,2015,0.0,2070.0,110
17368,1777,2086,0.5,1931.5,-309
17369,2368,2252,1.0,2310.0,116
17370,2223,2306,0.5,2264.5,-83
17371,2231,2127,1.0,2179.0,104
17372,2073,2221,0.0,2147.0,-148
17373,2033,2245,1.0,2139.0,-212
17374,2201,2063,1.0,2132.0,138
17375,1886,2185,0.0,2035.5,-299
17376,2137,1724,1.0,1930.5,413
17377,2027,2136,0.0,2081.5,-109
17378,2043,2019,1.0,2031.0,24
17379,1840,2142,0.0,1991.0,-302
17380,1993,1779,1.0,1886.0,214
17381,2515,1903,1.0,2209.0,612
17382,1857,2386,0.0,2121.5,-529
17383,2358,1859,1.0,2108.5,499
17384,1822,2232,0.0,2027.0,-410
17385,1495,2095,0.5,1795.0,-600
17386,2003,1983,0.0,1993.0,20
17387,1668,2023,0.0,1845.5,-355
17388,2009,1606,0.5,1807.5,403
17389,2017,2059,0.5,2038.0,-42
17390,2043,1577,1.0,1810.0,466
17391,1544,1953,0.0,1748.5,-409
17392,1921,1626,1.0,1773.5,295
17393,2015,2149,1.0,2082.0,-134
17394,2025,2073,0.0,2049.0,-48
17395,1735,2008,0.0,1871.5,-273
17396,1830,1881,0.5,1855.5,-51
17397,1948,2204,0.0,2076.0,-256
17398,1983,1837,1.0,1910.0,146
17399,1766,2117,0.0,1941.5,-351
17400,1928,1795,1.0,1861.5,133
17401,1935,2285,0.0,2110.0,-350
17402,2031,1783,1.0,1907.0,248
17403,1746,2021,0.0,1883.5,-275
17404,2103,1683,1.0,1893.0,420
17405,2323,2125,1.0,2224.0,198
17406,2078,2017,0.0,2047.5,61
17407,2103,1789,0.0,1946.0,314
17408,1791,2133,1.0,1962.0,-342
17409,1932,2048,0.5,1990.0,-116
17410,1868,1947,0.0,1907.5,-79
17411,1881,1913,1.0,1897.0,-32
17412,1611,1609,0.5,1610.0,2
17413,1897,1778,1.0,1837.5,119
17414,1699,1926,0.5,1812.5,-227
17415,1751,1670,0.5,1710.5,81
17416,1621,1773,1.0,1697.0,-152
17417,2381,1736,1.0,2058.5,645
17418,1662,1894,0.0,1778.0,-232
17419,1894,1794,1.0,1844.0,100
17420,1495,1643,0.0,1569.0,-148
17421,2040,2142,0.0,2091.0,-102
17422,1908,1721,0.5,1814.5,187
17423,1681,1773,1.0,1727.0,-92
17424,1314,1276,1.0,1295.0,38
17425,1943,1704,0.0,1823.5,239
17426,1961,1831,1.0,1896.0,130
17427,1834,1826,0.5,1830.0,8
17428,1797,1732,0.0,1764.5,65
17429,2200,1948,1.0,2074.0,252
17430,1907,1910,0.0,1908.5,-3
17431,1922,1654,1.0,1788.0,268
17432,1565,1807,0.0,1686.0,-242
17433,1671,2001,0.0,1836.0,-330
17434,1824,1864,0.0,1844.0,-40
17435,1625,1728,0.0,1676.5,-103
17436,1703,1497,1.0,1600.0,206
17437,1632,1777,0.0,1704.5,-145
17438,1531,1740,0.0,1635.5,-209
17439,1693,1700,0.0,1696.5,-7
17440,1808,1488,1.0,1648.0,320
17441,1637,1724,0.0,1680.5,-87
17442,1815,1738,1.0,1776.5,77
17443,1491,1563,0.0,1527.0,-72
17444,1871,1756,1.0,1813.5,115
17445,1674,1851,1.0,1762.5,-177
17446,1659,1689,0.0,1674.0,-30
17447,1725,1684,0.5,1704.5,41
17448,2002,1563,0.5,1782.5,439
17449,1794,1763,0.5,1778.5,31
17450,1718,1888,1.0,1803.0,-170
17451,1096,1611,0.0,1353.5,-515
17452,1716,1687,0.5,1701.5,29
17453,1574,1594,1.0,1584.0,-20
17454,1668,1406,0.0,1537.0,262
17455,1566,1104,0.5,1335.0,462
17456,1889,2159,0.0,2024.0,-270
17457,1953,1899,0.5,1926.0,54
17458,1923,1898,0.0,1910.5,25
17459,1745,1781,1.0,1763.0,-36
17460,1748,2050,0.0,1899.0,-302
17461,1860,1773,1.0,1816.5,87
17462,1594,1729,0.0,1661.5,-135
17463,1561,1584,1.0,1572.5,-23
17464,1971,1515,1.0,1743.0,456
17465,1460,1763,1.0,1611.5,-303
17466,1351,1719,1.0,1535.0,-368
17467,1605,1775,0.0,1690.0,-170
17468,1233,1928,0.0,1580.5,-695
17469,1679,1151,1.0,1415.0,528
17470,1894,1787,1.0,1840.5,107
17471,1876,1737,1.0,1806.5,139
17472,1483,1942,0.0,1712.5,-459
17473,1825,1490,1.0,1657.5,335
17474,1492,1685,1.0,1588.5,-193
17475,1244,1603,0.5,1423.5,-359
17476,1665,1616,1.0,1640.5,49
17477,1479,1605,0.0,1542.0,-126
17478,1474,1195,1.0,1334.5,279
17479,1783,1632,0.0,1707.5,151
17480,1613,1685,1.0,1649.0,-72
17481,1528,1559,0.5,1543.5,-31
17482,1803,1232,1.0,1517.5,571
17483,1375,1814,0.0,1594.5,-439
17484,1922,1407,1.0,1664.5,515
17485,1561,1701,0.0,1631.0,-140
17486,1715,1450,1.0,1582.5,265
17487,1570,1403,1.0,1486.5,167
17488,1499,1488,0.0,1493.5,11
17489,1642,1668,1.0,1655.0,-26
17490,1226,1312,0.0,1269.0,-86
17491,1621,1480,1.0,1550.5,141
17492,1504,1264,0.0,1384.0,240
17493,1392,1477,1.0,1434.5,-85
17494,1476,1022,1.0,1249.0,454
17495,1059,1072,0.0,1065.5,-13
17496,1363,1455,1.0,1409.0,-92
17497,1393,1204,1.0,1298.5,189
17498,1953,1339,0.5,1646.0,614
17499,1802,1778,0.0,1790.0,24
17500,1915,1848,0.5,1881.5,67
17501,1636,1703,1.0,1669.5,-67
17502,2059,1754,0.0,1906.5,305
17503,2447,2428,0.5,2437.5,19
17504,2388,2622,0.0,2505.0,-234
17505,2352,2459,0.5,2405.5,-107
17506,2373,2454,0.5,2413.5,-81
17507,2405,2404,1.0,2404.5,1
17508,2344,2297,0.5,2320.5,47
17509,2346,2492,0.0,2419.0,-146
17510,2290,2409,1.0,2349.5,-119
17511,2480,2159,1.0,2319.5,321
17512,2325,2386,0.5,2355.5,-61
17513,2769,2668,1.0,2718.5,101
17514,2606,1821,1.0,2213.5,785
17515,1871,2610,0.0,2240.5,-739
17516,2586,2055,1.0,2320.5,531
17517,2138,2565,0.0,2351.5,-427
17518,2553,2155,1.0,2354.0,398
17519,2159,2539,0.0,2349.0,-380
17520,2524,2175,0.5,2349.5,349
17521,2190,2521,0.5,2355.5,-331
17522,2517,2209,1.0,2363.0,308
17523,2219,2516,0.0,2367.5,-297
17524,2515,2220,0.5,2367.5,295
17525,2251,2512,0.5,2381.5,-261
17526,2504,2273,1.0,2388.5,231
17527,2304,2501,0.5,2402.5,-197
17528,2501,2321,1.0,2411.0,180
17529,2355,2491,0.0,2423.0,-136
17530,2491,2367,1.0,2429.0,124
17531,2369,2489,0.5,2429.0,-120
17532,2478,2377,0.5,2427.5,101
17533,2383,2476,0.5,2429.5,-93
17534,2476,2383,1.0,2429.5,93
17535,2384,2470,0.5,2427.0,-86
17536,2470,2394,0.5,2432.0,76
17537,2409,2468,0.5,2438.5,-59
17538,2467,2410,0.5,2438.5,57
17539,2413,2465,0.0,2439.0,-52
17540,2457,2414,1.0,2435.5,43
17541,2415,2455,1.0,2435.0,-40
17542,2454,2428,0.5,2441.0,26
17543,2429,2452,0.5,2440.5,-23
17544,2451,2432,0.5,2441.5,19
17545,2441,2445,0.0,2443.0,-4
17546,1821,2606,0.0,2213.5,-785
17547,2610,1871,1.0,2240.5,739
17548,2055,2586,0.0,2320.5,-531
17549,2565,2138,1.0,2351.5,427
17550,2155,2553,0.0,2354.0,-398
17551,2539,2159,1.0,2349.0,380
17552,2175,2524,0.0,2349.5,-349
17553,2521,2190,1.0,2355.5,331
17554,2209,2517,0.0,2363.0,-308
17555,2516,2219,1.0,2367.5,297
17556,2220,2515,0.0,2367.5,-295
17557,2512,2251,1.0,2381.5,261
17558,2273,2504,1.0,2388.5,-231
17559,2501,2304,1.0,2402.5,197
17560,2321,2501,1.0,2411.0,-180
17561,2491,2355,1.0,2423.0,136
17562,2367,2491,0.0,2429.0,-124
17563,2489,2369,1.0,2429.0,120
17564,2377,2478,0.5,2427.5,-101
17565,2476,2383,0.5,2429.5,93
17566,2383,2476,1.0,2429.5,-93
17567,2470,2384,1.0,2427.0,86
17568,2394,2470,0.5,2432.0,-76
17569,2468,2409,0.5,2438.5,59
17570,2410,2467,0.0,2438.5,-57
17571,2465,2413,0.5,2439.0,52
17572,2414,2457,0.0,2435.5,-43
17573,2455,2415,1.0,2435.0,40
17574,2428,2454,1.0,2441.0,-26
17575,2452,2429,1.0,2440.5,23
17576,2432,2451,0.0,2441.5,-19
17577,2445,2441,0.5,2443.0,4
17578,2233,2224,0.5,2228.5,9
17579,2420,2201,0.5,2310.5,219
17580,2379,2537,1.0,2458.0,-158
17581,2395,2337,0.5,2366.0,58
17582,2305,2112,1.0,2208.5,193
17583,2242,2424,0.0,2333.0,-182
17584,2330,2216,0.0,2273.0,114
17585,2209,2315,0.5,2262.0,-106
17586,2210,2206,0.0,2208.0,4
17587,2107,2234,0.5,2170.5,-127
17588,2619,2292,1.0,2455.5,327
17589,2546,2576,0.5,2561.0,-30
17590,2545,2187,1.0,2366.0,358
17591,2455,2590,0.5,2522.5,-135
17592,2392,2266,1.0,2329.0,126
17593,2536,2352,0.5,2444.0,184
17594,2382,2256,0.0,2319.0,126
17595,2556,2205,1.0,2380.5,351
17596,2286,2325,0.0,2305.5,-39
17597,2340,2424,0.5,2382.0,-84
17598,2555,2378,0.5,2466.5,177
17599,2497,2523,0.0,2510.0,-26
17600,2534,2523,0.5,2528.5,11
17601,2493,2340,1.0,2416.5,153
17602,2345,2379,0.5,2362.0,-34
17603,2425,2282,1.0,2353.5,143
17604,2220,2380,0.0,2300.0,-160
17605,2324,2266,1.0,2295.0,58
17606,2217,2349,0.0,2283.0,-132
17607,2327,2185,1.0,2256.0,142
17608,2457,2151,0.5,2304.0,306
17609,2568,2257,1.0,2412.5,311
17610,2461,2387,1.0,2424.0,74
17611,2313,2170,0.5,2241.5,143
17612,2204,2419,0.5,2311.5,-215
17613,2448,2214,1.0,2331.0,234
17614,2244,2303,0.5,2273.5,-59
17615,2147,2363,0.0,2255.0,-216
17616,2130,2129,1.0,2129.5,1
17617,2198,2223,0.5,2210.5,-25
17618,2472,2489,0.5,2480.5,-17
17619,2802,2679,0.5,2740.5,123
17620,2861,2781,0.5,2821.0,80
17621,2698,2720,1.0,2709.0,-22
17622,2772,2769,0.5,2770.5,3
17623,2663,2752,0.5,2707.5,-89
17624,2735,2627,0.5,2681.0,108
17625,2780,2603,1.0,2691.5,177
17626,2752,2735,0.5,2743.5,17
17627,2679,2603,0.5,2641.0,76
17628,2627,2780,0.5,2703.5,-153
17629,2802,2861,0.5,2831.5,-59
17630,2781,2698,0.5,2739.5,83
17631,2769,2663,0.5,2716.0,106
17632,2720,2772,0.5,2746.0,-52
17633,2663,2720,0.5,2691.5,-57
17634,2698,2802,0.5,2750.0,-104
17635,2772,2781,1.0,2776.5,-9
17636,2780,2752,1.0,2766.0,28
17637,2603,2627,0.5,2615.0,-24
17638,2861,2679,1.0,2770.0,182
17639,2735,2769,0.5,2752.0,-34
17640,2621,2581,0.5,2601.0,40
17641,2686,2619,0.5,2652.5,67
17642,2556,2566,0.0,2561.0,-10
17643,2688,2708,0.5,2698.0,-20
17644,2655,2587,1.0,2621.0,68
17645,2630,2572,0.5,2601.0,58
17646,2600,2615,0.5,2607.5,-15
17647,2587,2630,0.5,2608.5,-43
17648,2572,2600,0.5,2586.0,-28
17649,2581,2615,0.5,2598.0,-34
17650,2621,2686,1.0,2653.5,-65
17651,2566,2688,0.5,2627.0,-122
17652,2708,2655,0.0,2681.5,53
17653,2619,2556,1.0,2587.5,63
17654,2688,2619,1.0,2653.5,69
17655,2630,2708,0.0,2669.0,-78
17656,2600,2587,0.5,2593.5,13
17657,2655,2566,0.5,2610.5,89
17658,2615,2572,1.0,2593.5,43
17659,2556,2621,0.0,2588.5,-65
17660,2686,2581,1.0,2633.5,105
17661,2617,2402,1.0,2509.5,215
17662,2508,2579,0.5,2543.5,-71
17663,2572,2445,1.0,2508.5,127
17664,2295,2321,0.5,2308.0,-26
17665,2400,2521,0.5,2460.5,-121
17666,2543,2492,1.0,2517.5,51
17667,2516,2450,0.5,2483.0,66
17668,2445,2295,1.0,2370.0,150
17669,2521,2543,0.5,2532.0,-22
17670,2492,2516,0.0,2504.0,-24
17671,2402,2450,0.5,2426.0,-48
17672,2579,2572,0.0,2575.5,7
17673,2321,2400,0.5,2360.5,-79
17674,2617,2508,1.0,2562.5,109
17675,2450,2492,0.0,2471.0,-42
17676,2572,2617,0.5,2594.5,-45
17677,2295,2579,0.0,2437.0,-284
17678,2516,2521,1.0,2518.5,-5
17679,2543,2321,1.0,2432.0,222
17680,2508,2402,1.0,2455.0,106
17681,2400,2445,1.0,2422.5,-45
17682,2357,2264,1.0,2310.5,93
17683,2318,2511,1.0,2414.5,-193
17684,2625,2469,0.5,2547.0,156
17685,2383,2468,0.0,2425.5,-85
17686,2358,2474,0.0,2416.0,-116
17687,2486,2411,1.0,2448.5,75
17688,2399,2322,0.0,2360.5,77
17689,2308,2285,1.0,2296.5,23
17690,2379,2369,0.0,2374.0,10
17691,2288,2312,0.5,2300.0,-24
17692,2405,2263,1.0,2334.0,142
17693,2271,2399,1.0,2335.0,-128
17694,2531,2422,0.5,2476.5,109
17695,2497,2374,1.0,2435.5,123
17696,2432,2347,0.5,2389.5,85
17697,2339,2373,1.0,2356.0,-34
17698,2324,2295,1.0,2309.5,29
17699,2201,2216,1.0,2208.5,-15
17700,2004,2335,0.0,2169.5,-331
17701,2147,2165,0.5,2156.0,-18
17702,2236,2289,0.5,2262.5,-53
17703,2387,2516,0.0,2451.5,-129
17704,2605,2403,1.0,2504.0,202
17705,2399,2620,0.0,2509.5,-221
17706,2526,2428,1.0,2477.0,98
17707,2396,2405,0.0,2400.5,-9
17708,2253,2336,0.0,2294.5,-83
17709,2359,2372,0.0,2365.5,-13
17710,2279,2380,0.0,2329.5,-101
17711,2348,2288,0.0,2318.0,60
17712,2408,2481,0.0,2444.5,-73
17713,2763,2794,0.0,2778.5,-31
17714,2767,2769,0.5,2768.0,-2
17715,2809,2799,0.5,2804.0,10
17716,2800,2784,0.0,2792.0,16
17717,2794,2767,0.5,2780.5,27
17718,2784,2763,0.5,2773.5,21
17719,2799,2800,0.5,2799.5,-1
17720,2769,2809,0.5,2789.0,-40
17721,2799,2794,1.0,2796.5,5
17722,2769,2763,0.5,2766.0,6
17723,2809,2800,1.0,2804.5,9
17724,2784,2767,0.5,2775.5,17
17725,2763,2799,1.0,2781.0,-36
17726,2794,2784,0.0,2789.0,10
17727,2767,2809,0.5,2788.0,-42
17728,2800,2769,0.5,2784.5,31
17729,2799,2784,0.5,2791.5,15
17730,2767,2800,1.0,2783.5,-33
17731,2809,2763,0.5,2786.0,46
17732,2769,2794,0.5,2781.5,-25
17733,2115,2212,0.5,2163.5,-97
17734,2334,2398,0.0,2366.0,-64
17735,2444,2215,1.0,2329.5,229
17736,2592,2317,1.0,2454.5,275
17737,2429,2440,1.0,2434.5,-11
17738,2297,2382,0.0,2339.5,-85
17739,2411,2353,0.5,2382.0,58
17740,2229,2259,0.0,2244.0,-30
17741,2844,2747,0.5,2795.5,97
17742,2798,2787,0.5,2792.5,11
17743,2744,2706,0.5,2725.0,38
17744,2673,2730,1.0,2701.5,-57
17745,2773,2766,0.5,2769.5,7
17746,2760,2640,1.0,2700.0,120
17747,2769,2728,1.0,2748.5,41
17748,2747,2744,1.0,2745.5,3
17749,2640,2844,0.0,2742.0,-204
17750,2706,2798,0.5,2752.0,-92
17751,2730,2773,0.5,2751.5,-43
17752,2766,2769,1.0,2767.5,-3
17753,2787,2673,0.5,2730.0,114
17754,2728,2760,0.5,2744.0,-32
17755,2844,2728,1.0,2786.0,116
17756,2798,2747,1.0,2772.5,51
17757,2769,2760,0.5,2764.5,9
17758,2773,2787,0.5,2780.0,-14
17759,2766,2730,0.5,2748.0,36
17760,2673,2706,0.5,2689.5,-33
17761,2744,2640,0.5,2692.0,104
17762,2760,2844,0.0,2802.0,-84
17763,2640,2798,0.0,2719.0,-158
17764,2728,2744,0.5,2736.0,-16
17765,2706,2773,0.5,2739.5,-67
17766,2747,2673,1.0,2710.0,74
17767,2787,2766,1.0,2776.5,21
17768,2730,2769,0.5,2749.5,-39
17769,2769,2844,0.5,2806.5,-75
17770,2798,2728,0.5,2763.0,70
17771,2673,2640,0.0,2656.5,33
17772,2766,2706,0.5,2736.0,60
17773,2730,2787,1.0,2758.5,-57
17774,2773,2747,0.5,2760.0,26
17775,2744,2760,0.5,2752.0,-16
17776,2441,2679,0.5,2560.0,-238
17777,2391,2627,0.0,2509.0,-236
17778,2541,2578,1.0,2559.5,-37
17779,2607,2653,0.0,2630.0,-46
17780,2567,2644,0.0,2605.5,-77
17781,2548,2653,0.0,2600.5,-105
17782,2556,2485,0.0,2520.5,71
17783,2578,2556,1.0,2567.0,22
17784,2679,2607,0.5,2643.0,72
17785,2627,2567,0.0,2597.0,60
17786,2644,2541,0.5,2592.5,103
17787,2653,2391,1.0,2522.0,262
17788,2485,2441,1.0,2463.0,44
17789,2653,2548,0.5,2600.5,105
17790,2567,2653,0.5,2610.0,-86
17791,2441,2578,1.0,2509.5,-137
17792,2607,2485,0.5,2546.0,122
17793,2644,2627,0.5,2635.5,17
17794,2548,2679,0.5,2613.5,-131
17795,2391,2653,0.0,2522.0,-262
17796,2541,2556,0.0,2548.5,-15
17797,2679,2391,0.0,2535.0,288
17798,2653,2644,1.0,2648.5,9
17799,2556,2441,0.5,2498.5,115
17800,2485,2548,0.5,2516.5,-63
17801,2653,2567,1.0,2610.0,86
17802,2627,2541,0.0,2584.0,86
17803,2578,2607,0.5,2592.5,-29
17804,2644,2653,0.5,2648.5,-9
17805,2607,2556,0.5,2581.5,51
17806,2548,2578,0.0,2563.0,-30
17807,2391,2485,1.0,2438.0,-94
17808,2541,2441,0.5,2491.0,100
17809,2567,2679,0.5,2623.0,-112
17810,2627,2653,0.5,2640.0,-26
17811,2594,2450,0.0,2522.0,144
17812,2339,2596,0.0,2467.5,-257
17813,2184,2465,0.5,2324.5,-281
17814,2348,2240,0.5,2294.0,108
17815,2335,2382,1.0,2358.5,-47
17816,2384,2498,1.0,2441.0,-114
17817,2553,2331,1.0,2442.0,222
17818,2596,2331,1.0,2463.5,265
17819,2498,2553,0.0,2525.5,-55
17820,2382,2384,0.5,2383.0,-2
17821,2240,2335,0.0,2287.5,-95
17822,2465,2348,0.5,2406.5,117
17823,2339,2184,0.0,2261.5,155
17824,2184,2596,0.5,2390.0,-412
17825,2348,2339,0.5,2343.5,9
17826,2335,2465,0.5,2400.0,-130
17827,2384,2240,0.0,2312.0,144
17828,2553,2382,1.0,2467.5,171
17829,2331,2498,0.5,2414.5,-167
17830,2596,2498,1.0,2547.0,98
17831,2382,2331,0.5,2356.5,51
17832,2240,2553,0.5,2396.5,-313
17833,2465,2384,0.5,2424.5,81
17834,2339,2335,0.5,2337.0,4
17835,2184,2348,1.0,2266.0,-164
17836,2348,2596,0.5,2472.0,-248
17837,2335,2184,0.5,2259.5,151
17838,2384,2339,1.0,2361.5,45
17839,2553,2465,0.5,2509.0,88
17840,2331,2240,0.5,2285.5,91
17841,2498,2382,1.0,2440.0,116
17842,2596,2382,1.0,2489.0,214
17843,2240,2498,0.0,2369.0,-258
17844,2465,2331,1.0,2398.0,134
17845,2339,2553,0.5,2446.0,-214
17846,2184,2384,0.5,2284.0,-200
17847,2348,2335,1.0,2341.5,13
17848,2335,2596,1.0,2465.5,-261
17849,2384,2348,1.0,2366.0,36
17850,2553,2184,0.5,2368.5,369
17851,2331,2339,1.0,2335.0,-8
17852,2498,2465,1.0,2481.5,33
17853,2382,2240,0.5,2311.0,142
17854,2596,2240,1.0,2418.0,356
17855,2465,2382,0.5,2423.5,83
17856,2339,2498,0.0,2418.5,-159
17857,2184,2331,0.0,2257.5,-147
17858,2348,2553,1.0,2450.5,-205
17859,2335,2384,1.0,2359.5,-49
17860,2384,2596,0.0,2490.0,-212
17861,2553,2335,1.0,2444.0,218
17862,2331,2348,0.5,2339.5,-17
17863,2498,2184,1.0,2341.0,314
17864,2382,2339,0.5,2360.5,43
17865,2240,2465,0.0,2352.5,-225
17866,2596,2465,1.0,2530.5,131
17867,2339,2240,0.0,2289.5,99
17868,2184,2382,1.0,2283.0,-198
17869,2348,2498,0.0,2423.0,-150
17870,2335,2331,0.0,2333.0,4
17871,2384,2553,0.5,2468.5,-169
17872,2553,2596,0.5,2574.5,-43
17873,2331,2384,0.0,2357.5,-53
17874,2498,2335,0.5,2416.5,163
17875,2382,2348,0.5,2365.0,34
17876,2240,2184,0.5,2212.0,56
17877,2465,2339,1.0,2402.0,126
17878,2078,1388,1.0,1733.0,690
17879,2360,2650,0.0,2505.0,-290
17880,2546,2112,1.0,2329.0,434
17881,2234,2556,0.0,2395.0,-322
17882,2455,2288,0.5,2371.5,167
17883,2504,2256,0.5,2380.0,248
17884,2503,2231,1.0,2367.0,272
17885,2330,2325,1.0,2327.5,5
17886,2329,2163,1.0,2246.0,166
17887,2138,2340,0.5,2239.0,-202
17888,2151,2424,0.0,2287.5,-273
17889,2382,2147,1.0,2264.5,235
17890,2129,2392,0.5,2260.5,-263
17891,2448,2619,0.5,2533.5,-171
17892,2630,2568,0.5,2599.0,62
17893,2313,2545,0.0,2429.0,-232
17894,2311,2387,0.5,2349.0,-76
17895,2198,2286,0.0,2242.0,-88
17896,2352,2303,0.5,2327.5,49
17897,2360,2523,0.5,2441.5,-163
17898,2555,2112,1.0,2333.5,443
17899,2395,2500,0.5,2447.5,-105
17900,2534,2079,1.0,2306.5,455
17901,2537,2345,0.5,2441.0,192
17902,2340,2508,0.0,2424.0,-168
17903,2504,2253,1.0,2378.5,251
17904,2282,2487,0.0,2384.5,-205
17905,2210,2266,0.0,2238.0,-56
17906,2185,2330,0.0,2257.5,-145
17907,2204,2637,0.0,2420.5,-433
17908,2368,2461,0.0,2414.5,-93
17909,2170,2432,0.5,2301.0,-262
17910,2330,2257,0.0,2293.5,73
17911,2457,2423,0.5,2440.0,34
17912,2311,2363,0.5,2337.0,-52
17913,2214,2416,0.5,2315.0,-202
17914,2333,1939,1.0,2136.0,394
17915,2244,2216,0.5,2230.0,28
17916,2295,2223,1.0,2259.0,72
17917,2459,2251,1.0,2355.0,208
17918,2834,2752,1.0,2793.0,82
17919,2752,2834,0.5,2793.0,-82
17920,2476,2381,0.5,2428.5,95
17921,2448,2265,1.0,2356.5,183
17922,2468,2273,1.0,2370.5,195
17923,2445,2413,0.5,2429.0,32
17924,2427,2404,0.5,2415.5,23
17925,2381,2404,0.5,2392.5,-23
17926,2413,2427,0.5,2420.0,-14
17927,2273,2445,0.0,2359.0,-172
17928,2265,2468,0.0,2366.5,-203
17929,2476,2448,0.0,2462.0,28
17930,2468,2476,0.5,2472.0,-8
17931,2445,2265,1.0,2355.0,180
17932,2448,2381,1.0,2414.5,67
17933,2404,2413,0.5,2408.5,-9
17934,2427,2273,1.0,2350.0,154
17935,2273,2404,0.0,2338.5,-131
17936,2476,2445,0.5,2460.5,31
17937,2448,2468,0.0,2458.0,-20
17938,2381,2413,0.5,2397.0,-32
17939,2265,2427,0.0,2346.0,-162
17940,2427,2476,0.5,2451.5,-49
17941,2445,2448,1.0,2446.5,-3
17942,2404,2265,1.0,2334.5,139
17943,2468,2381,1.0,2424.5,87
17944,2413,2273,0.5,2343.0,140
17945,2468,2445,0.5,2456.5,23
17946,2448,2427,0.0,2437.5,21
17947,2476,2404,1.0,2440.0,72
17948,2381,2273,1.0,2327.0,108
17949,2265,2413,0.0,2339.0,-148
17950,2273,2265,1.0,2269.0,8
17951,2427,2468,0.0,2447.5,-41
17952,2445,2381,1.0,2413.0,64
17953,2404,2448,1.0,2426.0,-44
17954,2413,2476,0.5,2444.5,-63
17955,2468,2404,0.5,2436.0,64
17956,2476,2273,1.0,2374.5,203
17957,2381,2265,0.5,2323.0,116
17958,2448,2413,0.5,2430.5,35
17959,2445,2427,0.0,2436.0,18
17960,2404,2445,0.0,2424.5,-41
17961,2427,2381,1.0,2404.0,46
17962,2413,2468,1.0,2440.5,-55
17963,2265,2476,0.5,2370.5,-211
17964,2273,2448,1.0,2360.5,-175
17965,2662,2340,1.0,2501.0,322
17966,2410,2468,1.0,2439.0,-58
17967,2511,2590,0.5,2550.5,-79
17968,2416,2222,0.5,2319.0,194
17969,2358,2449,0.0,2403.5,-91
17970,2346,2379,0.5,2362.5,-33
17971,2399,2273,0.5,2336.0,126
17972,2291,2411,1.0,2351.0,-120
17973,2285,2233,0.5,2259.0,52
17974,2301,2312,1.0,2306.5,-11
17975,2191,2013,0.5,2102.0,178
17976,2372,2263,1.0,2317.5,109
17977,2469,2387,0.0,2428.0,82
17978,2288,2369,0.5,2328.5,-81
17979,2474,2336,0.5,2405.0,138
17980,2403,2308,1.0,2355.5,95
17981,2486,2279,1.0,2382.5,207
17982,2428,2288,1.0,2358.0,140
17983,2322,2294,0.5,2308.0,28
17984,2399,2318,0.5,2358.5,81
17985,2346,2396,1.0,2371.0,-50
17986,2422,2348,0.5,2385.0,74
17987,2526,1845,1.0,2185.5,681
17988,2201,2359,0.0,2280.0,-158
17989,2366,1772,1.0,2069.0,594
17990,2341,2405,0.5,2373.0,-64
17991,2253,2339,0.0,2296.0,-86
17992,2347,2286,1.0,2316.5,61
17993,2380,2295,0.0,2337.5,85
17994,2140,1975,0.0,2057.5,165
17995,2180,2147,0.0,2163.5,33
17996,2437,2341,0.0,2389.0,96
17997,2340,2462,0.0,2401.0,-122
17998,2446,2489,0.5,2467.5,-43
17999,2591,2598,0.5,2594.5,-7
18000,2402,2552,0.5,2477.0,-150
18001,2289,2446,0.5,2367.5,-157
18002,2342,2527,0.5,2434.5,-185
18003,2233,2408,0.5,2320.5,-175
18004,2400,2289,1.0,2344.5,111
18005,2501,2408,0.0,2454.5,93
18006,2625,2418,1.0,2521.5,207
18007,2573,2399,1.0,2486.0,174
18008,2511,2545,0.5,2528.0,-34
18009,2450,2358,1.0,2404.0,92
18010,2411,2216,1.0,2313.5,195
18011,2399,2285,1.0,2342.0,114
18012,2312,2324,0.5,2318.0,-12
18013,2374,2379,0.0,2376.5,-5
18014,2214,2373,0.5,2293.5,-159
18015,2236,2191,0.5,2213.5,45
18016,2308,2449,0.5,2378.5,-141
18017,2603,2322,0.5,2462.5,281
18018,2474,2384,0.5,2429.0,90
18019,2410,2397,0.5,2403.5,13
18020,2369,2273,1.0,2321.0,96
18021,2416,2383,0.5,2399.5,33
18022,2288,2233,0.5,2260.5,55
18023,2301,2346,1.0,2323.5,-45
18024,2244,2291,0.5,2267.5,-47
18025,2346,2263,1.0,2304.5,83
18026,1667,1820,1.0,1743.5,-153
18027,2679,2627,1.0,2653.0,52
18028,2720,2735,0.5,2727.5,-15
18029,2861,2698,1.0,2779.5,163
18030,2769,2780,0.5,2774.5,-11
18031,2802,2772,0.0,2787.0,30
18032,2752,2603,1.0,2677.5,149
18033,2781,2663,1.0,2722.0,118
18034,2735,2781,1.0,2758.0,-46
18035,2603,2769,0.0,2686.0,-166
18036,2627,2752,0.0,2689.5,-125
18037,2772,2861,0.5,2816.5,-89
18038,2780,2720,0.5,2750.0,60
18039,2663,2802,0.0,2732.5,-139
18040,2698,2679,1.0,2688.5,19
18041,2769,2627,0.5,2698.0,142
18042,2679,2752,1.0,2715.5,-73
18043,2802,2735,1.0,2768.5,67
18044,2698,2772,0.5,2735.0,-74
18045,2861,2663,1.0,2762.0,198
18046,2781,2780,0.5,2780.5,1
18047,2720,2603,0.0,2661.5,117
18048,2603,2781,0.5,2692.0,-178
18049,2627,2720,0.5,2673.5,-93
18050,2663,2698,0.5,2680.5,-35
18051,2735,2861,0.5,2798.0,-126
18052,2780,2802,0.5,2791.0,-22
18053,2772,2679,1.0,2725.5,93
18054,2752,2769,0.0,2760.5,-17
18055,2720,2752,0.5,2736.0,-32
18056,2772,2663,0.5,2717.5,109
18057,2802,2603,1.0,2702.5,199
18058,2861,2780,1.0,2820.5,81
18059,2679,2769,0.5,2724.0,-90
18060,2698,2735,0.5,2716.5,-37
18061,2781,2627,1.0,2704.0,154
18062,2708,2600,0.5,2654.0,108
18063,2587,2615,0.5,2601.0,-28
18064,2619,2655,0.0,2637.0,-36
18065,2621,2688,1.0,2654.5,-67
18066,2686,2556,0.0,2621.0,130
18067,2581,2572,0.0,2576.5,9
18068,2566,2630,0.5,2598.0,-64
18069,2556,2581,0.0,2568.5,-25
18070,2600,2566,1.0,2583.0,34
18071,2572,2587,1.0,2579.5,-15
18072,2655,2621,0.0,2638.0,34
18073,2615,2708,0.0,2661.5,-93
18074,2630,2619,0.5,2624.5,11
18075,2688,2686,1.0,2687.0,2
18076,2619,2600,0.0,2609.5,19
18077,2556,2688,0.0,2622.0,-132
18078,2566,2615,1.0,2590.5,-49
18079,2708,2572,1.0,2640.0,136
18080,2621,2630,0.5,2625.5,-9
18081,2686,2655,1.0,2670.5,31
18082,2581,2587,0.5,2584.0,-6
18083,2630,2686,0.5,2658.0,-56
18084,2572,2566,0.0,2569.0,6
18085,2587,2708,0.0,2647.5,-121
18086,2600,2621,0.5,2610.5,-21
18087,2688,2581,1.0,2634.5,107
18088,2615,2619,1.0,2617.0,-4
18089,2655,2556,0.0,2605.5,99
18090,2619,2572,1.0,2595.5,47
18091,2556,2630,0.0,2593.0,-74
18092,2621,2615,0.0,2618.0,6
18093,2688,2655,0.5,2671.5,33
18094,2566,2587,1.0,2576.5,-21
18095,2581,2708,1.0,2644.5,-127
18096,2686,2600,1.0,2643.0,86
18097,2508,2572,0.5,2540.0,-64
18098,2321,2516,0.5,2418.5,-195
18099,2521,2450,1.0,2485.5,71
18100,2445,2543,1.0,2494.0,-98
18101,2579,2400,1.0,2489.5,179
18102,2617,2295,1.0,2456.0,322
18103,2402,2492,0.5,2447.0,-90
18104,2543,2579,0.5,2561.0,-36
18105,2492,2521,1.0,2506.5,-29
18106,2400,2617,0.0,2508.5,-217
18107,2572,2402,1.0,2487.0,170
18108,2295,2508,0.0,2401.5,-213
18109,2516,2445,0.0,2480.5,71
18110,2450,2321,0.5,2385.5,129
18111,2402,2521,0.5,2461.5,-119
18112,2508,2400,0.5,2454.0,108
18113,2321,2492,0.5,2406.5,-171
18114,2579,2516,0.5,2547.5,63
18115,2445,2450,1.0,2447.5,-5
18116,2617,2543,0.5,2580.0,74
18117,2572,2295,1.0,2433.5,277
18118,2400,2572,0.5,2486.0,-172
18119,2295,2402,0.5,2348.5,-107
18120,2543,2508,0.5,2525.5,35
18121,2492,2445,0.5,2468.5,47
18122,2516,2617,0.0,2566.5,-101
18123,2450,2579,0.5,2514.5,-129
18124,2521,2321,1.0,2421.0,200
18125,2508,2516,0.5,2512.0,-8
18126,2445,2521,1.0,2483.0,-76
18127,2572,2543,1.0,2557.5,29
18128,2617,2450,0.5,2533.5,167
18129,2402,2321,1.0,2361.5,81
18130,2295,2400,1.0,2347.5,-105
18131,2579,2492,0.5,2535.5,87
18132,2441,2369,0.0,2405.0,72
18133,2809,2872,0.5,2840.5,-63
18134,2740,2793,0.5,2766.5,-53
18135,2757,2764,0.5,2760.5,-7
18136,2747,2810,0.5,2778.5,-63
18137,2809,2740,1.0,2774.5,69
18138,2872,2810,0.5,2841.0,62
18139,2764,2747,0.5,2755.5,17
18140,2793,2757,1.0,2775.0,36
18141,2747,2793,1.0,2770.0,-46
18142,2810,2764,0.5,2787.0,46
18143,2740,2872,0.0,2806.0,-132
18144,2757,2809,0.0,2783.0,-52
18145,2603,2375,1.0,2489.0,228
18146,2827,2255,1.0,2541.0,572
18147,2377,2792,0.0,2584.5,-415
18148,2799,2398,1.0,2598.5,401
18149,2422,2803,0.0,2612.5,-381
18150,2802,2449,1.0,2625.5,353
18151,2455,2797,0.0,2626.0,-342
18152,2781,2454,1.0,2617.5,327
18153,2455,2804,0.5,2629.5,-349
18154,2788,2455,1.0,2621.5,333
18155,2478,2794,0.0,2636.0,-316
18156,2771,2487,1.0,2629.0,284
18157,2508,2780,0.5,2644.0,-272
18158,2777,2519,1.0,2648.0,258
18159,2529,2748,1.0,2638.5,-219
18160,2741,2535,0.5,2638.0,206
18161,2518,2756,0.0,2637.0,-238
18162,2739,2533,1.0,2636.0,206
18163,2534,2750,0.5,2642.0,-216
18164,2745,2540,0.5,2642.5,205
18165,2547,2741,1.0,2644.0,-194
18166,2742,2545,0.5,2643.5,197
18167,2531,2739,0.5,2635.0,-208
18168,2738,2566,0.5,2652.0,172
18169,2539,2720,0.0,2629.5,-181
18170,2734,2565,0.0,2649.5,169
18171,2573,2731,1.0,2652.0,-158
18172,2737,2579,1.0,2658.0,158
18173,2574,2728,0.0,2651.0,-154
18174,2727,2570,0.5,2648.5,157
18175,2571,2728,0.5,2649.5,-157
18176,2716,2574,1.0,2645.0,142
18177,2569,2728,0.5,2648.5,-159
18178,2714,2580,1.0,2647.0,134
18179,2578,2710,0.5,2644.0,-132
18180,2694,2580,1.0,2637.0,114
18181,2593,2698,0.0,2645.5,-105
18182,2708,2567,0.5,2637.5,141
18183,2589,2701,0.5,2645.0,-112
18184,2694,2607,1.0,2650.5,87
18185,2588,2701,0.5,2644.5,-113
18186,2695,2573,1.0,2634.0,122
18187,2594,2695,0.5,2644.5,-101
18188,2702,2614,0.5,2658.0,88
18189,2620,2692,0.0,2656.0,-72
18190,2694,2617,0.5,2655.5,77
18191,2610,2674,0.5,2642.0,-64
18192,2702,2627,0.5,2664.5,75
18193,2621,2682,0.0,2651.5,-61
18194,2699,2619,0.5,2659.0,80
18195,2629,2670,0.5,2649.5,-41
18196,2675,2616,1.0,2645.5,59
18197,2633,2668,0.5,2650.5,-35
18198,2666,2625,0.5,2645.5,41
18199,2634,2670,0.0,2652.0,-36
18200,2662,2649,0.0,2655.5,13
18201,2648,2668,1.0,2658.0,-20
18202,2654,2642,0.5,2648.0,12
18203,2651,2656,1.0,2653.5,-5
18204,2688,2642,0.5,2665.0,46
18205,2644,2670,0.5,2657.0,-26
18206,2645,2650,1.0,2647.5,-5
18207,2646,2657,0.5,2651.5,-11
18208,2649,2633,0.5,2641.0,16
18209,2634,2648,0.0,2641.0,-14
18210,2255,2827,0.0,2541.0,-572
18211,2792,2377,0.5,2584.5,415
18212,2398,2799,0.0,2598.5,-401
18213,2803,2422,0.5,2612.5,381
18214,2449,2802,0.0,2625.5,-353
18215,2797,2455,0.5,2626.0,342
18216,2454,2781,0.0,2617.5,-327
18217,2804,2455,1.0,2629.5,349
18218,2455,2788,0.0,2621.5,-333
18219,2794,2478,0.5,2636.0,316
18220,2487,2771,0.5,2629.0,-284
18221,2780,2508,0.5,2644.0,272
18222,2519,2777,0.5,2648.0,-258
18223,2748,2529,1.0,2638.5,219
18224,2535,2741,0.5,2638.0,-206
18225,2756,2518,1.0,2637.0,238
18226,2533,2739,0.5,2636.0,-206
18227,2750,2534,0.5,2642.0,216
18228,2540,2745,0.0,2642.5,-205
18229,2741,2547,1.0,2644.0,194
18230,2545,2742,0.0,2643.5,-197
18231,2739,2531,1.0,2635.0,208
18232,2566,2738,0.5,2652.0,-172
18233,2720,2539,1.0,2629.5,181
18234,2565,2734,1.0,2649.5,-169
18235,2731,2573,1.0,2652.0,158
18236,2579,2737,0.5,2658.0,-158
18237,2728,2574,0.5,2651.0,154
18238,2570,2727,0.5,2648.5,-157
18239,2728,2571,1.0,2649.5,157
18240,2574,2716,1.0,2645.0,-142
18241,2728,2569,0.5,2648.5,159
18242,2580,2714,0.0,2647.0,-134
18243,2710,2578,0.5,2644.0,132
18244,2580,2694,0.5,2637.0,-114
18245,2698,2593,1.0,2645.5,105
18246,2567,2708,0.5,2637.5,-141
18247,2701,2589,1.0,2645.0,112
18248,2607,2694,0.5,2650.5,-87
18249,2701,2588,0.5,2644.5,113
18250,2573,2695,0.5,2634.0,-122
18251,2695,2594,0.5,2644.5,101
18252,2614,2702,0.0,2658.0,-88
18253,2692,2620,1.0,2656.0,72
18254,2617,2694,1.0,2655.5,-77
18255,2674,2610,0.5,2642.0,64
18256,2627,2702,0.5,2664.5,-75
18257,2682,2621,1.0,2651.5,61
18258,2619,2699,0.5,2659.0,-80
18259,2670,2629,0.5,2649.5,41
18260,2616,2675,0.0,2645.5,-59
18261,2668,2633,1.0,2650.5,35
18262,2625,2666,0.5,2645.5,-41
18263,2670,2634,0.5,2652.0,36
18264,2649,2662,0.5,2655.5,-13
18265,2668,2648,0.5,2658.0,20
18266,2642,2654,0.5,2648.0,-12
18267,2656,2651,0.5,2653.5,5
18268,2642,2688,0.0,2665.0,-46
18269,2670,2644,1.0,2657.0,26
18270,2650,2645,1.0,2647.5,5
18271,2657,2646,0.5,2651.5,11
18272,2633,2649,1.0,2641.0,-16
18273,2648,2634,1.0,2641.0,14
18274,2142,2139,0.5,2140.5,3
18275,2506,2502,0.0,2504.0,4
18276,2565,2362,1.0,2463.5,203
18277,2580,2016,1.0,2298.0,564
18278,2533,2541,1.0,2537.0,-8
18279,2314,2420,1.0,2367.0,-106
18280,2234,2298,0.0,2266.0,-64
18281,2432,2318,1.0,2375.0,114
18282,2357,2248,1.0,2302.5,109
18283,2301,2118,1.0,2209.5,183
18284,2339,2298,1.0,2318.5,41
18285,2420,2323,1.0,2371.5,97
18286,2363,2421,0.0,2392.0,-58
18287,2294,1997,0.0,2145.5,297
18288,2102,2398,0.5,2250.0,-296
18289,2372,2243,0.5,2307.5,129
18290,2186,2449,1.0,2317.5,-263
18291,2211,2264,0.0,2237.5,-53
18292,2235,2312,0.0,2273.5,-77
18293,2152,1972,1.0,2062.0,180
18294,2109,2250,0.0,2179.5,-141
18295,1872,2112,0.0,1992.0,-240
18296,2813,2862,0.5,2837.5,-49
18297,2772,2741,1.0,2756.5,31
18298,2862,2772,0.5,2817.0,90
18299,2741,2813,0.5,2777.0,-72
18300,2741,2862,0.0,2801.5,-121
18301,2813,2772,1.0,2792.5,41
18302,2772,2862,0.5,2817.0,-90
18303,2813,2741,0.5,2777.0,72
18304,2862,2813,1.0,2837.5,49
18305,2741,2772,0.5,2756.5,-31
18306,2699,2719,0.5,2709.0,-20
18307,2619,2680,0.5,2649.5,-61
18308,2531,2683,0.5,2607.0,-152
18309,2598,2657,1.0,2627.5,-59
18310,2655,2490,1.0,2572.5,165
18311,2516,2628,0.5,2572.0,-112
18312,2664,2553,1.0,2608.5,111
18313,2623,2562,0.5,2592.5,61
18314,2511,2396,0.5,2453.5,115
18315,2392,2487,0.5,2439.5,-95
18316,2438,2643,0.0,2540.5,-205
18317,2639,2373,1.0,2506.0,266
18318,2340,2565,0.5,2452.5,-225
18319,2548,2174,1.0,2361.0,374
18320,2529,2338,1.0,2433.5,191
18321,2259,2524,0.0,2391.5,-265
18322,2496,2316,0.0,2406.0,180
18323,2347,2477,0.5,2412.0,-130
18324,2319,2474,0.5,2396.5,-155
18325,2196,2447,0.5,2321.5,-251
18326,2412,2263,1.0,2337.5,149
18327,2680,2655,1.0,2667.5,25
18328,2598,2619,0.5,2608.5,-21
18329,2628,2683,0.5,2655.5,-55
18330,2664,2531,1.0,2597.5,133
18331,2657,2516,0.5,2586.5,141
18332,2643,2511,1.0,2577.0,132
18333,2524,2639,0.5,2581.5,-115
18334,2392,2623,0.5,2507.5,-231
18335,2490,2562,0.5,2526.0,-72
18336,2553,2487,0.5,2520.0,66
18337,2316,2548,0.0,2432.0,-232
18338,2396,2529,1.0,2462.5,-133
18339,2565,2332,1.0,2448.5,233
18340,2477,2340,1.0,2408.5,137
18341,2474,2244,0.5,2359.0,230
18342,2319,2412,0.5,2365.5,-93
18343,2051,2365,0.0,2208.0,-314
18344,2347,2196,1.0,2271.5,151
18345,2285,2496,0.5,2390.5,-211
18346,2447,2283,1.0,2365.0,164
18347,2680,2664,0.5,2672.0,16
18348,2619,2628,1.0,2623.5,-9
18349,2655,2598,0.5,2626.5,57
18350,2683,2396,1.0,2539.5,287
18351,2516,2643,1.0,2579.5,-127
18352,2548,2565,0.5,2556.5,-17
18353,2487,2657,0.5,2572.0,-170
18354,2639,2392,1.0,2515.5,247
18355,2623,2524,0.0,2573.5,99
18356,2562,2477,1.0,2519.5,85
18357,2365,2553,0.0,2459.0,-188
18358,2531,2490,1.0,2510.5,41
18359,2529,2347,1.0,2438.0,182
18360,2511,2338,1.0,2424.5,173
18361,2474,2220,1.0,2347.0,254
18362,2244,2447,1.0,2345.5,-203
18363,2412,2316,1.0,2364.0,96
18364,2496,2319,1.0,2407.5,177
18365,2276,2373,1.0,2324.5,-97
18366,2360,2279,1.0,2319.5,81
18367,2683,2680,0.5,2681.5,3
18368,2516,2619,0.5,2567.5,-103
18369,2598,2664,0.5,2631.0,-66
18370,2548,2655,0.5,2601.5,-107
18371,2553,2639,0.0,2596.0,-86
18372,2524,2562,1.0,2543.0,-38
18373,2396,2531,1.0,2463.5,-135
18374,2657,2511,0.5,2584.0,146
18375,2643,2487,1.0,2565.0,156
18376,2628,2412,0.5,2520.0,216
18377,2565,2244,1.0,2404.5,321
18378,2220,2529,0.0,2374.5,-309
18379,2347,2623,0.0,2485.0,-276
18380,2276,2496,0.0,2386.0,-220
18381,2490,2340,1.0,2415.0,150
18382,2477,2332,1.0,2404.5,145
18383,2219,2392,1.0,2305.5,-173
18384,2174,2365,0.5,2269.5,-191
18385,2360,2196,1.0,2278.0,164
18386,2312,2474,1.0,2393.0,-162
18387,2680,2516,1.0,2598.0,164
18388,2619,2524,0.5,2571.5,95
18389,2664,2683,1.0,2673.5,-19
18390,2639,2598,0.0,2618.5,41
18391,2655,2565,1.0,2610.0,90
18392,2529,2643,0.5,2586.0,-114
18393,2396,2548,0.0,2472.0,-152
18394,2412,2657,0.5,2534.5,-245
18395,2511,2628,0.0,2569.5,-117
18396,2623,2477,0.5,2550.0,146
18397,2562,2219,1.0,2390.5,343
18398,2496,2553,0.0,2524.5,-57
18399,2531,2360,1.0,2445.5,171
18400,2487,2490,0.5,2488.5,-3
18401,2365,2267,0.5,2316.0,98
18402,2174,2324,0.5,2249.0,-150
18403,2244,2312,0.5,2278.0,-68
18404,2286,2220,1.0,2253.0,66
18405,2332,2447,1.0,2389.5,-115
18406,2196,2438,0.0,2317.0,-242
18407,1984,2377,0.5,2180.5,-393
18408,2471,2827,0.5,2649.0,-356
18409,2776,2340,1.0,2558.0,436
18410,2343,2722,0.5,2532.5,-379
18411,2682,2373,0.5,2527.5,309
18412,2760,2452,0.5,2606.0,308
18413,2433,2768,0.0,2600.5,-335
18414,2726,2360,1.0,2543.0,366
18415,2316,2747,0.5,2531.5,-431
18416,2477,2780,0.0,2628.5,-303
18417,2678,2439,1.0,2558.5,239
18418,2322,2649,0.0,2485.5,-327
18419,2629,2308,1.0,2468.5,321
18420,2703,2401,1.0,2552.0,302
18421,2398,2692,0.0,2545.0,-294
18422,2633,2290,0.5,2461.5,343
18423,2206,2594,0.0,2400.0,-388
18424,2498,2727,0.0,2612.5,-229
18425,2612,2441,1.0,2526.5,171
18426,2316,2614,0.0,2465.0,-298
18427,2568,2274,1.0,2421.0,294
18428,2441,2780,0.0,2610.5,-339
18429,2639,2345,1.0,2492.0,294
18430,2382,2642,0.0,2512.0,-260
18431,2604,2292,1.0,2448.0,312
18432,2615,2740,1.0,2677.5,-125
18433,2662,2430,1.0,2546.0,232
18434,2229,2574,0.0,2401.5,-345
18435,2556,2182,1.0,2369.0,374
18436,2661,2473,0.5,2567.0,188
18437,2389,2618,0.0,2503.5,-229
18438,2591,2327,1.0,2459.0,264
18439,2200,2595,0.0,2397.5,-395
18440,2600,2421,1.0,2510.5,179
18441,2437,2579,0.5,2508.0,-142
18442,2565,2154,1.0,2359.5,411
18443,2035,2567,0.0,2301.0,-532
18444,2125,2609,0.0,2367.0,-484
18445,2494,2232,1.0,2363.0,262
18446,2355,2565,0.0,2460.0,-210
18447,2571,2388,1.0,2479.5,183
18448,2649,2346,1.0,2497.5,303
18449,2387,2621,0.0,2504.0,-234
18450,2569,2324,1.0,2446.5,245
18451,2319,2548,0.5,2433.5,-229
18452,2392,2606,0.5,2499.0,-214
18453,2594,2335,1.0,2464.5,259
18454,2321,2551,0.0,2436.0,-230
18455,2576,2297,1.0,2436.5,279
18456,2633,2408,1.0,2520.5,225
18457,2402,2609,0.0,2505.5,-207
18458,2569,2284,1.0,2426.5,285
18459,2157,2502,0.5,2329.5,-345
18460,2464,2649,0.5,2556.5,-185
18461,2589,2358,1.0,2473.5,231
18462,2273,2576,0.0,2424.5,-303
18463,2582,2205,1.0,2393.5,377
18464,2639,2434,1.0,2536.5,205
18465,2310,2590,0.5,2450.0,-280
18466,2581,2283,1.0,2432.0,298
18467,2140,2573,0.0,2356.5,-433
18468,2419,2634,0.0,2526.5,-215
18469,2601,2291,1.0,2446.0,310
18470,2372,2594,0.5,2483.0,-222
18471,2552,2196,1.0,2374.0,356
18472,2578,2422,1.0,2500.0,156
18473,2344,2570,0.0,2457.0,-226
18474,2565,2262,1.0,2413.5,303
18475,2245,2456,0.0,2350.5,-211
18476,2273,2715,0.0,2494.0,-442
18477,2491,2276,0.5,2383.5,215
18478,2400,2463,0.5,2431.5,-63
18479,2477,2271,0.5,2374.0,206
18480,2475,2620,0.0,2547.5,-145
18481,2558,2428,1.0,2493.0,130
18482,2176,2548,0.0,2362.0,-372
18483,2542,2124,1.0,2333.0,418
18484,2655,2218,1.0,2436.5,437
18485,2361,2544,0.5,2452.5,-183
18486,2499,2376,1.0,2437.5,123
18487,2246,2504,0.0,2375.0,-258
18488,2615,2820,0.5,2717.5,-205
18489,2751,2501,0.5,2626.0,250
18490,2547,2721,0.0,2634.0,-174
18491,2699,2552,1.0,2625.5,147
18492,2771,2686,1.0,2728.5,85
18493,2508,2743,0.0,2625.5,-235
18494,2711,2501,1.0,2606.0,210
18495,2463,2668,0.5,2565.5,-205
18496,2662,2703,0.5,2682.5,-41
18497,2695,2558,0.5,2626.5,137
18498,2521,2681,0.5,2601.0,-160
18499,2685,2416,1.0,2550.5,269
18500,2780,2605,1.0,2692.5,175
18501,2582,2660,0.5,2621.0,-78
18502,2621,2459,0.5,2540.0,162
18503,2449,2597,0.5,2523.0,-148
18504,2618,2607,1.0,2612.5,11
18505,2715,2535,1.0,2625.0,180
18506,2525,2589,0.5,2557.0,-64
18507,2590,2477,0.5,2533.5,113
18508,2664,2549,1.0,2606.5,115
18509,2512,2610,0.5,2561.0,-98
18510,2602,2507,0.5,2554.5,95
18511,2494,2583,0.5,2538.5,-89
18512,2580,2590,0.0,2585.0,-10
18513,2479,2505,0.0,2492.0,-26
18514,2580,2489,1.0,2534.5,91
18515,2496,2452,0.5,2474.0,44
18516,2573,2646,0.0,2609.5,-73
18517,2566,2530,0.0,2548.0,36
18518,2502,2535,0.5,2518.5,-33
18519,2509,2428,0.0,2468.5,81
18520,2570,2588,0.0,2579.0,-18
18521,2566,2489,0.5,2527.5,77
18522,2421,2527,0.5,2474.0,-106
18523,2540,2452,0.0,2496.0,88
18524,2619,2567,0.5,2593.0,52
18525,2465,2544,0.5,2504.5,-79
18526,2522,2449,1.0,2485.5,73
18527,2448,2484,0.5,2466.0,-36
18528,2686,2619,1.0,2652.5,67
18529,2468,2620,0.0,2544.0,-152
18530,2431,2486,0.5,2458.5,-55
18531,2358,2408,1.0,2383.0,-50
18532,2514,2564,0.5,2539.0,-50
18533,2508,2482,0.5,2495.0,26
18534,2462,2497,0.5,2479.5,-35
18535,2495,2423,1.0,2459.0,72
18536,2517,2579,0.5,2548.0,-62
18537,2472,2527,0.0,2499.5,-55
18538,2497,2447,0.5,2472.0,50
18539,2402,2472,0.0,2437.0,-70
18540,1964,2376,0.5,2170.0,-412
18541,2264,1905,1.0,2084.5,359
18542,1948,2194,0.5,2071.0,-246
18543,2145,2233,1.0,2189.0,-88
18544,2472,2396,1.0,2434.0,76
18545,2313,2477,0.0,2395.0,-164
18546,2263,2288,1.0,2275.5,-25
18547,2151,2452,0.0,2301.5,-301
18548,2553,2523,1.0,2538.0,30
18549,2481,2464,0.0,2472.5,17
18550,2439,2486,0.5,2462.5,-47
18551,2466,2360,1.0,2413.0,106
18552,2501,2542,1.0,2521.5,-41
18553,2500,2519,0.5,2509.5,-19
18554,2486,2457,1.0,2471.5,29
18555,2380,2444,1.0,2412.0,-64
18556,2543,2550,0.5,2546.5,-7
18557,2331,2492,0.0,2411.5,-161
18558,2382,2248,1.0,2315.0,134
18559,2239,2380,1.0,2309.5,-141
18560,2297,2501,0.0,2399.0,-204
18561,2445,2405,0.5,2425.0,40
18562,2349,2482,0.5,2415.5,-133
18563,2413,2276,1.0,2344.5,137
18564,2511,2765,0.0,2638.0,-254
18565,2742,2465,1.0,2603.5,277
18566,2424,2712,0.5,2568.0,-288
18567,2708,2438,1.0,2573.0,270
18568,2712,2431,1.0,2571.5,281
18569,2427,2689,0.0,2558.0,-262
18570,2677,2396,1.0,2536.5,281
18571,2299,2549,0.5,2424.0,-250
18572,2567,2690,1.0,2628.5,-123
18573,2609,2391,0.5,2500.0,218
18574,2386,2621,0.5,2503.5,-235
18575,2678,2373,1.0,2525.5,305
18576,2629,2636,0.5,2632.5,-7
18577,2370,2482,0.0,2426.0,-112
18578,2666,2346,0.5,2506.0,320
18579,2363,2492,0.5,2427.5,-129
18580,2505,2525,0.5,2515.0,-20
18581,2465,2443,1.0,2454.0,22
18582,2349,2484,0.5,2416.5,-135
18583,2467,2411,0.5,2439.0,56
18584,2345,2471,0.0,2408.0,-126
18585,2389,2256,0.0,2322.5,133
18586,2254,2402,0.0,2328.0,-148
18587,2365,2230,1.0,2297.5,135
18588,2388,2116,1.0,2252.0,272
18589,1888,2315,0.0,2101.5,-427
18590,2192,2244,0.0,2218.0,-52
18591,2285,2249,0.5,2267.0,36
18592,2028,2283,0.5,2155.5,-255
18593,2223,2053,0.5,2138.0,170
18594,2048,2216,0.0,2132.0,-168
18595,2243,2422,1.0,2332.5,-179
18596,2281,2106,0.5,2193.5,175
18597,2096,2126,0.5,2111.0,-30
18598,2013,1912,1.0,1962.5,101
18599,2211,2057,1.0,2134.0,154
18600,2077,2152,0.5,2114.5,-75
18601,1979,2237,0.0,2108.0,-258
18602,1937,1995,1.0,1966.0,-58
18603,2054,2095,0.5,2074.5,-41
18604,2038,1943,1.0,1990.5,95
18605,2034,1940,1.0,1987.0,94
18606,1773,2016,0.0,1894.5,-243
18607,2155,1896,1.0,2025.5,259
18608,1835,2190,0.5,2012.5,-355
18609,2016,1791,1.0,1903.5,225
18610,1723,1820,0.0,1771.5,-97
18611,2140,2412,1.0,2276.0,-272
18612,1840,1847,1.0,1843.5,-7
18613,2125,2175,1.0,2150.0,-50
18614,1712,1991,1.0,1851.5,-279
18615,2303,1986,1.0,2144.5,317
18616,1979,2244,0.0,2111.5,-265
18617,2274,2015,1.0,2144.5,259
18618,2116,2222,0.0,2169.0,-106
18619,2074,2393,0.5,2233.5,-319
18620,2208,2022,0.0,2115.0,186
18621,2041,2160,0.0,2100.5,-119
18622,2237,1959,1.0,2098.0,278
18623,2042,2408,0.0,2225.0,-366
18624,2324,1992,1.0,2158.0,332
18625,1902,2128,0.0,2015.0,-226
18626,2170,1896,1.0,2033.0,274
18627,2126,2418,0.0,2272.0,-292
18628,2261,1879,1.0,2070.0,382
18629,1910,2128,0.0,2019.0,-218
18630,2093,1988,1.0,2040.5,105
18631,2351,2064,0.5,2207.5,287
18632,1988,2203,0.5,2095.5,-215
18633,2108,1908,1.0,2008.0,200
18634,1826,1826,1.0,1826.0,0
18635,1678,2263,0.0,1970.5,-585
18636,2078,1766,1.0,1922.0,312
18637,1965,1999,0.0,1982.0,-34
18638,1860,1985,0.0,1922.5,-125
18639,2206,2018,1.0,2112.0,188
18640,1950,2055,0.0,2002.5,-105
18641,2135,1926,0.5,2030.5,209
18642,1776,2054,0.0,1915.0,-278
18643,2209,2218,1.0,2213.5,-9
18644,1875,2114,0.0,1994.5,-239
18645,2008,1844,1.0,1926.0,164
18646,1618,1868,0.0,1743.0,-250
18647,2085,1988,0.5,2036.5,97
18648,1951,2132,0.0,2041.5,-181
18649,2069,1873,1.0,1971.0,196
18650,1819,2002,0.0,1910.5,-183
18651,2112,2038,1.0,2075.0,74
18652,1993,1785,1.0,1889.0,208
18653,1783,1906,0.0,1844.5,-123
18654,1950,1911,1.0,1930.5,39
18655,2096,2058,1.0,2077.0,38
18656,1902,1935,0.0,1918.5,-33
18657,1992,2012,0.5,2002.0,-20
18658,2067,1790,1.0,1928.5,277
18659,1900,2024,1.0,1962.0,-124
18660,2010,2024,1.0,2017.0,-14
18661,1653,1665,0.0,1659.0,-12
18662,2057,1996,0.0,2026.5,61
18663,2061,2169,0.5,2115.0,-108
18664,1631,1904,0.0,1767.5,-273
18665,1859,1978,0.5,1918.5,-119
18666,2145,1651,1.0,1898.0,494
18667,1793,1993,0.0,1893.0,-200
18668,1797,2024,0.0,1910.5,-227
18669,1751,1955,1.0,1853.0,-204
18670,1850,1863,1.0,1856.5,-13
18671,1844,1910,0.5,1877.0,-66
18672,1775,1846,1.0,1810.5,-71
18673,2138,1863,1.0,2000.5,275
18674,1829,2138,1.0,1983.5,-309
18675,1820,1353,0.0,1586.5,467
18676,2391,1753,1.0,2072.0,638
18677,1823,1882,0.0,1852.5,-59
18678,2244,2196,1.0,2220.0,48
18679,1730,1772,0.0,1751.0,-42
18680,2000,2193,0.0,2096.5,-193
18681,2329,2347,1.0,2338.0,-18
18682,1694,1995,0.0,1844.5,-301
18683,2222,2258,1.0,2240.0,-36
18684,1661,1517,0.0,1589.0,144
18685,2299,2300,1.0,2299.5,-1
18686,1840,1825,0.0,1832.5,15
18687,2252,2275,1.0,2263.5,-23
18688,2419,1405,1.0,1912.0,1014
18689,2000,2095,0.0,2047.5,-95
18690,2158,2301,0.0,2229.5,-143
18691,1877,2106,0.0,1991.5,-229
18692,2215,2203,1.0,2209.0,12
18693,1774,1781,0.0,1777.5,-7
18694,2157,2131,1.0,2144.0,26
18695,2149,1654,1.0,1901.5,495
18696,1716,1771,0.0,1743.5,-55
18697,2207,2319,0.5,2263.0,-112
18698,1766,1828,0.0,1797.0,-62
18699,2276,2292,1.0,2284.0,-16
18700,1805,1674,0.0,1739.5,131
18701,2173,2177,1.0,2175.0,-4
18702,1737,1801,0.0,1769.0,-64
18703,2261,2106,0.5,2183.5,155
18704,1758,1848,0.0,1803.0,-90
18705,2221,2124,1.0,2172.5,97
18706,1661,1680,0.0,1670.5,-19
18707,1827,2175,0.0,2001.0,-348
18708,2171,2061,1.0,2116.0,110
18709,1655,1779,0.0,1717.0,-124
18710,2259,2328,1.0,2293.5,-69
18711,1631,1627,0.0,1629.0,4
18712,2245,2356,0.5,2300.5,-111
18713,1721,1873,0.0,1797.0,-152
18714,2115,2112,1.0,2113.5,3
18715,2206,1595,1.0,1900.5,611
18716,1701,2066,0.0,1883.5,-365
18717,2147,2161,1.0,2154.0,-14
18718,1723,2198,0.0,1960.5,-475
18719,2152,2338,1.0,2245.0,-186
18720,1723,1723,0.5,1723.0,0
18721,2121,2138,1.0,2129.5,-17
18722,2228,1743,1.0,1985.5,485
18723,1627,1779,0.0,1703.0,-152
18724,2163,2185,1.0,2174.0,-22
18725,1587,1627,0.0,1607.0,-40
18726,1803,2143,0.0,1973.0,-340
18727,2170,2236,1.0,2203.0,-66
18728,2054,2127,1.0,2090.5,-73
18729,2262,1695,1.0,1978.5,567
18730,2060,2058,0.0,2059.0,2
18731,2158,2250,1.0,2204.0,-92
18732,1560,2039,0.0,1799.5,-479
18733,2098,2185,1.0,2141.5,-87
18734,1405,1525,0.0,1465.0,-120
18735,2083,2090,0.5,2086.5,-7
18736,2238,1408,1.0,1823.0,830
18737,1662,1680,0.0,1671.0,-18
18738,2121,2171,1.0,2146.0,-50
18739,1880,2047,0.0,1963.5,-167
18740,2158,2188,1.0,2173.0,-30
18741,2059,2144,1.0,2101.5,-85
18742,2111,1992,1.0,2051.5,119
18743,2198,2305,1.0,2251.5,-107
18744,2091,1926,0.0,2008.5,165
18745,2153,2000,1.0,2076.5,153
18746,1765,2231,0.0,1998.0,-466
18747,2291,2154,1.0,2222.5,137
18748,1836,2163,1.0,1999.5,-327
18749,1818,1060,1.0,1439.0,758
18750,1849,1789,0.5,1819.0,60
18751,1760,1677,0.0,1718.5,83
18752,2780,1720,1.0,2250.0,1060
18753,2445,2501,0.0,2473.0,-56
18754,2649,2678,0.5,2663.5,-29
18755,2413,2482,0.0,2447.5,-69
18756,2471,2629,1.0,2550.0,-158
18757,2727,2739,1.0,2733.0,-12
18758,2440,2389,0.5,2414.5,51
18759,2568,2612,1.0,2590.0,-44
18760,2780,2365,0.5,2572.5,415
18761,2776,2827,1.0,2801.5,-51
18762,2642,2639,0.5,2640.5,3
18763,2722,2763,1.0,2742.5,-41
18764,2609,2624,0.0,2616.5,-15
18765,2765,2804,1.0,2784.5,-39
18766,2664,2494,1.0,2579.0,170
18767,2708,2742,1.0,2725.0,-34
18768,2820,2571,0.5,2695.5,249
18769,2570,2578,0.0,2574.0,-8
18770,2699,2721,1.0,2710.0,-22
18771,2456,2565,0.0,2510.5,-109
18772,2620,2676,0.5,2648.0,-56
18773,2672,2712,0.5,2692.0,-40
18774,2548,2558,0.0,2553.0,-10
18775,2677,2689,0.5,2683.0,-12
18776,2715,2543,1.0,2629.0,172
18777,2477,2472,0.0,2474.5,5
18778,2491,2620,1.0,2555.5,-129
18779,2452,2263,0.5,2357.5,189
18780,2573,2463,0.0,2518.0,110
18781,2674,2703,1.0,2688.5,-29
18782,2502,2530,0.5,2516.0,-28
18783,2594,2633,1.0,2613.5,-39
18784,2661,2448,0.5,2554.5,213
18785,2527,2517,0.5,2522.0,10
18786,2618,2639,0.5,2628.5,-21
18787,2472,2497,0.5,2484.5,-25
18788,2553,2595,0.5,2574.0,-42
18789,2600,2689,0.5,2644.5,-89
18790,2439,2464,0.0,2451.5,-25
18791,2567,2565,1.0,2566.0,2
18792,2543,2435,1.0,2489.0,108
18793,2621,2649,1.0,2635.0,-28
18794,2382,2492,0.5,2437.0,-110
18795,2562,2569,1.0,2565.5,-7
18796,2710,2380,0.5,2545.0,330
18797,2623,2606,0.5,2614.5,17
18798,2681,2703,0.5,2692.0,-22
18799,2576,2594,0.0,2585.0,-18
18800,2780,2685,0.5,2732.5,95
18801,2609,2633,0.5,2621.0,-24
18802,2660,2691,1.0,2675.5,-31
18803,2569,2588,0.5,2578.5,-19
18804,2649,2597,1.0,2623.0,52
18805,2610,2664,1.0,2637.0,-54
18806,2576,2589,1.0,2582.5,-13
18807,2568,2602,0.0,2585.0,-34
18808,2580,2582,0.5,2581.0,-2
18809,2581,2639,1.0,2610.0,-58
18810,2580,2591,1.0,2585.5,-11
18811,2564,2573,0.5,2568.5,-9
18812,2634,2452,0.5,2543.0,182
18813,2544,2619,0.5,2581.5,-75
18814,2544,2601,1.0,2572.5,-57
18815,2484,2522,0.5,2503.0,-38
18816,2686,2552,0.5,2619.0,134
18817,2544,2655,0.5,2599.5,-111
18818,2431,2620,0.0,2525.5,-189
18819,2499,2520,0.5,2509.5,-21
18820,2564,2408,0.5,2486.0,156
18821,2768,2760,0.5,2764.0,8
18822,2495,2497,0.0,2496.0,-2
18823,2726,2779,0.5,2752.5,-53
18824,2740,2495,1.0,2617.5,245
18825,2519,2501,1.0,2510.0,18
18826,2557,2662,0.5,2609.5,-105
18827,2443,2486,0.0,2464.5,-43
18828,2629,2574,0.0,2601.5,55
18829,2743,2771,1.0,2757.0,-28
18830,2666,2513,0.5,2589.5,153
18831,2672,2711,1.0,2691.5,-39
18832,2525,2492,0.5,2508.5,33
18833,2525,2618,1.0,2571.5,-93
18834,2484,2465,1.0,2474.5,19
18835,2477,2493,0.5,2485.0,-16
18836,2634,2467,1.0,2550.5,167
18837,2421,2489,0.0,2455.0,-68
18838,2589,2715,0.5,2652.0,-126
18839,2470,2452,0.5,2461.0,18
18840,2588,2590,1.0,2589.0,-2
18841,2391,2567,0.0,2479.0,-176
18842,2527,2566,1.0,2546.5,-39
18843,2373,2386,0.0,2379.5,-13
18844,2690,2540,1.0,2615.0,150
18845,2558,2662,0.5,2610.0,-104
18846,2702,2609,0.5,2655.5,93
18847,2416,2521,0.5,2468.5,-105
18848,2422,2678,0.5,2550.0,-256
18849,2538,2605,1.0,2571.5,-67
18850,2262,2344,1.0,2303.0,-82
18851,2449,2459,1.0,2454.0,-10
18852,2549,2227,1.0,2388.0,322
18853,2428,2475,1.0,2451.5,-47
18854,2507,2523,1.0,2515.0,-16
18855,2096,2124,0.0,2110.0,-28
18856,2590,2494,1.0,2542.0,96
18857,2358,2391,0.0,2374.5,-33
18858,2489,2479,1.0,2484.0,10
18859,2193,2244,0.0,2218.5,-51
18860,2567,2388,1.0,2477.5,179
18861,2329,2347,0.5,2338.0,-18
18862,2449,2476,1.0,2462.5,-27
18863,2222,2258,0.0,2240.0,-36
18864,2300,2448,0.0,2374.0,-148
18865,2468,2619,1.0,2543.5,-151
18866,2275,2299,0.5,2287.0,-24
18867,2275,2358,0.0,2316.5,-83
18868,2400,2267,0.5,2333.5,133
18869,2482,2514,1.0,2498.0,-32
18870,2215,2203,0.0,2209.0,12
18871,2423,2467,0.0,2445.0,-44
18872,2542,2131,1.0,2336.5,411
18873,2276,2328,1.0,2302.0,-52
18874,2457,2500,1.0,2478.5,-43
18875,2173,2177,0.0,2175.0,-4
18876,2370,2380,0.5,2375.0,-10
18877,2171,2061,0.0,2116.0,110
18878,2363,2346,1.0,2354.5,17
18879,2259,2328,1.0,2293.5,-69
18880,2206,2345,0.0,2275.5,-139
18881,2443,2505,1.0,2474.0,-62
18882,2147,2161,0.0,2154.0,-14
18883,2411,2349,1.0,2380.0,62
18884,2305,2198,0.0,2251.5,107
18885,2465,2511,0.5,2488.0,-46
18886,2194,2264,0.0,2229.0,-70
18887,2438,2424,1.0,2431.0,14
18888,2408,2145,1.0,2276.5,263
18889,2313,2396,1.0,2354.5,-83
18890,2128,2324,1.0,2226.0,-196
18891,2259,2288,0.0,2273.5,-29
18892,2228,2161,0.0,2194.5,67
18893,2340,2471,1.0,2405.5,-131
18894,2143,2163,0.5,2153.0,-20
18895,2425,2343,1.0,2384.0,82
18896,2236,2129,0.0,2182.5,107
18897,2276,2273,1.0,2274.5,3
18898,2127,2183,0.5,2155.0,-56
18899,2220,2400,0.0,2310.0,-180
18900,2646,2054,1.0,2350.0,592
18901,2250,2262,0.5,2256.0,-12
18902,2509,2535,1.0,2522.0,-26
18903,2039,2158,0.0,2098.5,-119
18904,2523,2408,1.0,2465.5,115
18905,2158,2188,0.0,2173.0,-30
18906,2486,2451,1.0,2468.5,35
18907,2059,2071,0.0,2065.0,-12
18908,2550,2466,0.5,2508.0,84
18909,2132,2085,0.5,2108.5,47
18910,2239,2331,0.5,2285.0,-92
18911,1924,2002,0.0,1963.0,-78
18912,2139,2237,0.5,2188.0,-98
18913,2547,2501,0.5,2524.0,46
18914,2171,2238,0.0,2204.5,-67
18915,2500,2552,1.0,2526.0,-52
18916,2579,2047,1.0,2313.0,532
18917,2305,2111,0.5,2208.0,194
18918,2402,2447,0.5,2424.5,-45
18919,1926,2198,0.0,2062.0,-272
18920,2452,2381,1.0,2416.5,71
18921,2055,2206,0.5,2130.5,-151
18922,2317,2433,1.0,2375.0,-116
18923,1984,2135,0.0,2059.5,-151
18924,2154,2316,0.0,2235.0,-162
18925,2430,2615,0.5,2522.5,-185
18926,2163,2291,0.5,2227.0,-128
18927,2182,2178,1.0,2180.0,4
18928,2412,1830,1.0,2121.0,582
18929,2315,2388,1.0,2351.5,-73
18930,1847,2140,0.0,1993.5,-293
18931,2244,2192,1.0,2218.0,52
18932,2327,1840,0.0,2083.5,487
18933,2349,2405,0.5,2377.0,-56
18934,2098,2185,0.5,2141.5,-87
18935,2276,2315,1.0,2295.5,-39
18936,2431,2083,0.5,2257.0,348
18937,2283,2285,0.5,2284.0,-2
18938,2396,2427,0.5,2411.5,-31
18939,2216,2223,0.0,2219.5,-7
18940,2057,2299,0.0,2178.0,-242
18941,2321,2335,1.0,2328.0,-14
18942,2165,2237,0.0,2201.0,-72
18943,2134,2297,0.5,2215.5,-163
18944,2216,1937,0.0,2076.5,279
18945,2345,2494,1.0,2419.5,-149
18946,2034,2054,0.5,2044.0,-20
18947,2254,2256,1.0,2255.0,-2
18948,2175,2016,0.0,2095.5,159
18949,2501,2508,0.5,2504.5,-7
18950,1991,2125,0.0,2058.0,-134
18951,2463,2512,1.0,2487.5,-49
18952,2401,1712,1.0,2056.5,689
18953,2319,2149,0.0,2234.0,170
18954,2452,2398,1.0,2425.0,54
18955,2292,2207,0.0,2249.5,85
18956,2473,2290,1.0,2381.5,183
18957,2124,2261,0.5,2192.5,-137
18958,2200,2389,0.5,2294.5,-189
18959,2221,2226,0.5,2223.5,-5
18960,2421,2235,1.0,2328.0,186
18961,2112,2356,0.0,2234.0,-244
18962,2154,2437,0.0,2295.5,-283
18963,2099,2115,1.0,2107.0,-16
18964,2346,2035,0.0,2190.5,311
18965,2152,2338,0.0,2245.0,-186
18966,2319,2387,0.5,2353.0,-68
18967,2121,2138,0.5,2129.5,-17
18968,2408,2229,1.0,2318.5,179
18969,2129,2263,0.0,2196.0,-134
18970,2284,2402,0.0,2343.0,-118
18971,1999,2078,0.5,2038.5,-79
18972,2067,2157,0.0,2112.0,-90
18973,2358,2464,1.0,2411.0,-106
18974,2029,2010,0.0,2019.5,19
18975,2205,2220,0.5,2212.5,-15
18976,2434,1996,1.0,2215.0,438
18977,2190,2155,0.0,2172.5,35
18978,2283,2310,1.0,2296.5,-27
18979,1820,2016,0.0,1918.0,-196
18980,2169,2140,0.0,2154.5,29
18981,2291,2419,1.0,2355.0,-128
18982,1978,2061,0.0,2019.5,-83
18983,2160,2196,0.0,2178.0,-36
18984,2361,1859,1.0,2110.0,502
18985,1846,1850,0.0,1848.0,-4
18986,2246,2376,0.0,2311.0,-130
18987,1863,1775,0.0,1819.0,88
18988,2303,2146,1.0,2224.5,157
18989,1789,1818,0.0,1803.5,-29
18990,2274,2244,1.0,2259.0,30
18991,1677,1849,0.0,1763.0,-172
18992,2418,2222,1.0,2320.0,196
18993,2273,2393,1.0,2333.0,-120
18994,2128,2261,0.5,2194.5,-133
18995,2237,2160,1.0,2198.5,77
18996,2096,2093,0.0,2094.5,3
18997,2439,2477,1.0,2458.0,-38
18998,1992,2012,0.0,2002.0,-20
18999,2248,2322,1.0,2285.0,-74
19000,2091,1890,0.0,1990.5,201
19001,2114,2209,0.0,2161.5,-95
19002,2231,2153,1.0,2192.0,78
19003,2008,2062,0.5,2035.0,-54
19004,2138,1900,0.0,2019.0,238
19005,2441,2498,1.0,2469.5,-57
19006,1753,1829,0.0,1791.0,-76
19007,2239,2316,1.0,2277.5,-77
19008,2116,2441,0.0,2278.5,-325
19009,2382,1888,1.0,2135.0,494
19010,2301,2292,1.0,2296.5,9
19011,1765,2125,0.0,1945.0,-360
19012,1720,2388,0.0,2054.0,-668
19013,2064,2422,0.0,2243.0,-358
19014,2281,1988,1.0,2134.5,293
19015,1908,2126,0.5,2017.0,-218
19016,2126,1826,1.0,1976.0,300
19017,2182,2112,0.5,2147.0,70
19018,1785,2351,0.0,2068.0,-566
19019,2203,1783,1.0,1993.0,420
19020,1911,2108,0.5,2009.5,-197
19021,2038,2243,0.0,2140.5,-205
19022,2106,1993,0.0,2049.5,113
19023,1906,2096,0.0,2001.0,-190
19024,2000,2145,1.0,2072.5,-145
19025,1981,2014,1.0,1997.5,-33
19026,1863,2024,0.0,1943.5,-161
19027,1793,2301,0.0,2047.0,-508
19028,2195,1747,1.0,1971.0,448
19029,1955,2158,0.0,2056.5,-203
19030,2106,1751,1.0,1928.5,355
19031,2095,1723,1.0,1909.0,372
19032,1723,2038,0.0,1880.5,-315
19033,1885,1743,1.0,1814.0,142
19034,1787,1773,0.0,1780.0,14
19035,1525,1608,0.0,1566.5,-83
19036,2053,2028,1.0,2040.5,25
19037,1408,1405,0.5,1406.5,3
19038,1060,2048,0.0,1554.0,-988
19039,2152,2211,1.0,2181.5,-59
19040,1995,1979,1.0,1987.0,16
19041,1986,2074,0.0,2030.0,-88
19042,2022,1979,0.0,2000.5,43
19043,2015,2041,0.0,2028.0,-26
19044,1959,2116,0.5,2037.5,-157
19045,2042,1950,1.0,1996.0,92
19046,1935,1999,0.0,1967.0,-64
19047,1902,1902,0.5,1902.0,0
19048,1790,1896,0.5,1843.0,-106
19049,1250,2126,0.0,1688.0,-876
19050,1879,2138,0.5,2008.5,-259
19051,1353,1988,0.5,1670.5,-635
19052,1896,2218,1.0,2057.0,-322
19053,1875,1835,1.0,1855.0,40
19054,1791,1844,0.0,1817.5,-53
19055,1877,2057,0.0,1967.0,-180
19056,1892,1781,0.5,1836.5,111
19057,1774,1631,1.0,1702.5,143
19058,1651,1654,0.0,1652.5,-3
19059,1827,1760,1.0,1793.5,67
19060,1495,1779,0.0,1637.0,-284
19061,1655,1627,0.0,1641.0,28
19062,2066,1701,0.0,1883.5,365
19063,1779,1793,0.0,1786.0,-14
19064,1627,1627,1.0,1627.0,0
19065,1803,1587,1.0,1695.0,216
19066,1805,1910,0.0,1857.5,-105
19067,1844,1801,1.0,1822.5,43
19068,1737,1819,1.0,1778.0,-82
19069,2018,1441,1.0,1729.5,577
19070,2060,2058,0.0,2059.0,2
19071,1844,1926,0.0,1885.0,-82
19072,1771,1776,1.0,1773.5,-5
19073,2026,1880,0.0,1953.0,146
19074,1766,1828,1.0,1797.0,-62
19075,1848,1553,0.0,1700.5,295
19076,1680,1758,0.0,1719.0,-78
19077,1765,1635,0.5,1700.0,130
19078,1873,1631,1.0,1752.0,242
19079,1595,1721,1.0,1658.0,-126
19080,1882,1964,1.0,1923.0,-82
19081,1986,1823,1.0,1904.5,163
19082,1730,1948,0.0,1839.0,-218
19083,2233,1323,1.0,1778.0,910
19084,2000,1766,1.0,1883.0,234
19085,1965,1995,1.0,1980.0,-30
19086,1694,1985,0.0,1839.5,-291
19087,2031,1517,0.0,1774.0,514
19088,2024,1825,1.0,1924.5,199
19089,1840,1900,0.5,1870.0,-60
19090,1665,1840,0.0,1752.5,-175
19091,1405,1653,0.0,1529.0,-248
19092,1662,1873,1.0,1767.5,-211
19093,1819,1576,1.0,1697.5,243
19094,2715,1710,0.5,2212.5,1005
19095,2678,2780,0.5,2729.0,-102
19096,2491,2620,0.5,2555.5,-129
19097,2629,2646,1.0,2637.5,-17
19098,2703,2463,0.0,2583.0,240
19099,2544,2655,0.0,2599.5,-111
19100,2692,2674,1.0,2683.0,18
19101,2499,2520,0.0,2509.5,-21
19102,2827,2594,1.0,2710.5,233
19103,2743,2771,0.5,2757.0,-28
19104,2763,2776,0.5,2769.5,-13
19105,2672,2711,0.5,2691.5,-39
19106,2662,2722,1.0,2692.0,-60
19107,2589,2649,0.5,2619.0,-60
19108,2574,2557,0.5,2565.5,17
19109,2582,2576,0.5,2579.0,6
19110,2820,2556,1.0,2688.0,264
19111,2672,2712,0.0,2692.0,-40
19112,2721,2751,0.5,2736.0,-30
19113,2677,2689,0.0,2683.0,-12
19114,2804,2699,1.0,2751.5,105
19115,2600,2689,0.0,2644.5,-89
19116,2742,2765,0.5,2753.5,-23
19117,2567,2579,0.0,2573.0,-12
19118,2601,2712,0.0,2656.5,-111
19119,2691,2780,0.5,2735.5,-89
19120,2544,2594,0.5,2569.0,-50
19121,2597,2660,1.0,2628.5,-63
19122,2649,2552,0.0,2600.5,97
19123,2703,2710,0.0,2706.5,-7
19124,2562,2621,0.5,2591.5,-59
19125,2685,2695,1.0,2690.0,-10
19126,2739,2548,0.5,2643.5,191
19127,2768,2760,1.0,2764.0,8
19128,2614,2727,1.0,2670.5,-113
19129,2747,2779,0.0,2763.0,-32
19130,2690,2568,0.5,2629.0,122
19131,2639,2661,0.5,2650.0,-22
19132,2621,2609,0.5,2615.0,12
19133,2591,2618,1.0,2604.5,-27
19134,2639,2702,1.0,2670.5,-63
19135,2527,2517,0.0,2522.0,10
19136,2581,2590,1.0,2585.5,-9
19137,2495,2497,0.5,2496.0,-2
19138,2588,2564,0.5,2576.0,24
19139,2591,2580,1.0,2585.5,11
19140,2527,2566,0.5,2546.5,-39
19141,2580,2505,0.5,2542.5,75
19142,2634,2523,0.0,2578.5,111
19143,2484,2525,0.5,2504.5,-41
19144,2715,2607,0.5,2661.0,108
19145,2443,2467,1.0,2455.0,-24
19146,2636,2590,0.5,2613.0,46
19147,2558,2620,0.5,2589.0,-62
19148,2346,2370,1.0,2358.0,-24
19149,2542,2543,1.0,2542.5,-1
19150,2606,2363,1.0,2484.5,243
19151,2355,2232,0.0,2293.5,123
19152,2594,2623,1.0,2608.5,-29
19153,2405,2388,0.0,2396.5,17
19154,2633,2551,1.0,2592.0,82
19155,2321,2335,0.5,2328.0,-14
19156,2588,2609,1.0,2598.5,-21
19157,2134,2297,0.0,2215.5,-163
19158,2441,2502,0.0,2471.5,-61
19159,2494,2609,1.0,2551.5,-115
19160,2292,2345,0.0,2318.5,-53
19161,2571,2565,1.0,2568.0,6
19162,2471,2301,0.0,2386.0,170
19163,2486,2519,1.0,2502.5,-33
19164,2402,2440,1.0,2421.0,-38
19165,2443,2444,0.5,2443.5,-1
19166,2618,2365,1.0,2491.5,253
19167,2530,2573,0.0,2551.5,-43
19168,2493,2535,1.0,2514.0,-42
19169,2428,2502,0.0,2465.0,-74
19170,2393,2477,0.0,2435.0,-84
19171,2492,2543,1.0,2517.5,-51
19172,2160,2273,0.0,2216.5,-113
19173,2380,2382,1.0,2381.0,-2
19174,2578,2237,0.0,2407.5,341
19175,2544,2619,0.5,2581.5,-75
19176,2565,2570,1.0,2567.5,-5
19177,2484,2522,0.5,2503.0,-38
19178,2646,2456,0.0,2551.0,190
19179,2620,2686,1.0,2653.0,-66
19180,2535,2566,0.5,2550.5,-31
19181,2408,2431,0.0,2419.5,-23
19182,2564,2509,1.0,2536.5,55
19183,2523,2549,1.0,2536.0,-26
19184,2497,2508,1.0,2502.5,-11
19185,2507,2512,1.0,2509.5,-5
19186,2615,2495,0.0,2555.0,120
19187,2639,2780,1.0,2709.5,-141
19188,2229,2430,0.0,2329.5,-201
19189,2604,2624,1.0,2614.0,-20
19190,2605,2178,0.0,2391.5,427
19191,2610,2664,0.5,2637.0,-54
19192,2582,2538,0.5,2560.0,44
19193,2568,2583,0.5,2575.5,-15
19194,2388,2449,0.5,2418.5,-61
19195,2340,2471,0.5,2405.5,-131
19196,2192,2315,0.0,2253.5,-123
19197,2425,2373,1.0,2399.0,52
19198,2542,2244,0.5,2393.0,298
19199,2464,2553,0.5,2508.5,-89
19200,2457,2500,1.0,2478.5,-43
19201,2435,2439,0.5,2437.0,-4
19202,2477,2380,0.5,2428.5,97
19203,2489,2590,1.0,2539.5,-101
19204,2308,2439,0.0,2373.5,-131
19205,2388,2496,1.0,2442.0,-108
19206,2505,2248,0.5,2376.5,257
19207,2441,2498,1.0,2469.5,-57
19208,2349,2443,0.0,2396.0,-94
19209,2274,2316,0.5,2295.0,-42
19210,2686,2411,1.0,2548.5,275
19211,2324,2408,0.5,2366.0,-84
19212,2501,2508,1.0,2504.5,-7
19213,2161,2170,0.0,2165.5,-9
19214,2501,2512,0.5,2506.5,-11
19215,2477,2472,1.0,2474.5,5
19216,2482,2445,0.5,2463.5,37
19217,2452,2263,0.0,2357.5,189
19218,2464,2413,1.0,2438.5,51
19219,2476,2567,1.0,2521.5,-91
19220,2273,2358,0.5,2315.5,-85
19221,2448,2465,1.0,2456.5,-17
19222,2273,2220,1.0,2246.5,53
19223,2451,2523,1.0,2487.0,-72
19224,2400,2276,0.0,2338.0,124
19225,2466,2481,0.5,2473.5,-15
19226,2209,2271,0.5,2240.0,-62
19227,2305,2376,1.0,2340.5,-71
19228,2008,2114,0.0,2061.0,-106
19229,2145,2264,1.0,2204.5,-119
19230,2396,1868,1.0,2132.0,528
19231,1781,1877,0.0,1829.0,-96
19232,2259,2313,1.0,2286.0,-54
19233,1654,1774,0.0,1714.0,-120
19234,2452,2151,0.5,2301.5,301
19235,2248,2550,0.5,2399.0,-302
19236,2360,2433,0.5,2396.5,-73
19237,2237,2239,0.5,2238.0,-2
19238,2615,2317,1.0,2466.0,298
19239,2361,2218,0.5,2289.5,143
19240,2552,2547,1.0,2549.5,5
19241,2146,2376,0.0,2261.0,-230
19242,2619,2500,1.0,2559.5,119
19243,2396,2427,1.0,2411.5,-31
19244,2486,2468,1.0,2477.0,18
19245,2483,2299,0.0,2391.0,184
19246,2514,2358,1.0,2436.0,156
19247,2389,2473,0.5,2431.0,-84
19248,2467,2462,0.5,2464.5,5
19249,2235,2200,1.0,2217.5,35
19250,2511,2423,0.5,2467.0,88
19251,2513,2629,1.0,2571.0,-116
19252,2424,2465,0.0,2444.5,-41
19253,2666,2482,1.0,2574.0,184
19254,2398,2438,1.0,2418.0,-40
19255,2349,2405,0.5,2377.0,-56
19256,2290,2452,0.5,2371.0,-162
19257,2276,2315,1.0,2295.5,-39
19258,2419,2206,0.5,2312.5,213
19259,2244,2303,0.0,2273.5,-59
19260,2372,2291,1.0,2331.5,81
19261,2222,2294,0.5,2258.0,-72
19262,2408,2196,0.5,2302.0,212
19263,2447,2579,0.0,2513.0,-132
19264,2284,2402,0.5,2343.0,-118
19265,2381,2402,0.5,2391.5,-21
19266,2494,2157,1.0,2325.5,337
19267,2310,2434,0.0,2372.0,-124
19268,2254,2345,0.5,2299.5,-91
19269,2283,2283,0.5,2283.0,0
19270,2570,2230,1.0,2400.0,340
19271,2000,2091,0.0,2045.5,-91
19272,2452,2421,1.0,2436.5,31
19273,2231,2153,0.0,2192.0,78
19274,2422,2470,1.0,2446.0,-48
19275,2351,2182,0.0,2266.5,169
19276,2126,2281,1.0,2203.5,-155
19277,1826,2108,1.0,1967.0,-282
19278,2338,2013,1.0,2175.5,325
19279,2391,2567,0.0,2479.0,-176
19280,2121,2152,0.0,2136.5,-31
19281,2373,2386,1.0,2379.5,-13
19282,2419,2024,1.0,2221.5,395
19283,2437,2421,0.5,2429.0,16
19284,2195,2301,0.5,2248.0,-106
19285,2035,2154,0.0,2094.5,-119
19286,2356,2158,0.5,2257.0,198
19287,2324,2346,0.5,2335.0,-22
19288,2112,2245,1.0,2178.5,-133
19289,2229,2319,1.0,2274.0,-90
19290,2243,2099,0.0,2171.0,144
19291,2521,2558,1.0,2539.5,-37
19292,1914,2096,0.0,2005.0,-182
19293,2445,2416,1.0,2430.5,29
19294,2285,1912,0.5,2098.5,373
19295,2319,2149,1.0,2234.0,170
19296,2223,2283,0.5,2253.0,-60
19297,2292,2207,1.0,2249.5,85
19298,2391,2216,1.0,2303.5,175
19299,2261,2418,0.0,2339.5,-157
19300,2196,2358,0.0,2277.0,-162
19301,2051,2128,0.5,2089.5,-77
19302,2129,2193,1.0,2161.0,-64
19303,1789,1818,0.0,1803.5,-29
19304,1999,2078,1.0,2038.5,-79
19305,1677,1849,0.0,1763.0,-172
19306,2132,1860,0.0,1996.0,272
19307,1845,2074,0.5,1959.5,-229
19308,2002,2069,0.0,2035.5,-67
19309,1959,2022,0.0,1990.5,-63
19310,2095,1924,1.0,2009.5,171
19311,2038,2095,1.0,2066.5,-57
19312,1885,1940,0.0,1912.5,-55
19313,2057,2400,0.0,2228.5,-343
19314,2203,2077,0.0,2140.0,126
19315,2237,2131,1.0,2184.0,106
19316,2157,2165,0.5,2161.0,-8
19317,2061,2249,0.0,2155.0,-188
19318,2028,2328,1.0,2178.0,-300
19319,2259,2053,1.0,2156.0,206
19320,2048,2118,0.5,2083.0,-70
19321,2422,2206,1.0,2314.0,216
19322,2161,2262,0.5,2211.5,-101
19323,2245,2147,0.5,2196.0,98
19324,2193,2227,0.0,2210.0,-34
19325,1964,2170,0.5,2067.0,-206
19326,2183,1986,1.0,2084.5,197
19327,1948,2127,0.5,2037.5,-179
19328,2054,2233,0.0,2143.5,-179
19329,2188,2300,1.0,2244.0,-112
19330,2275,2158,0.0,2216.5,117
19331,2144,2267,0.0,2205.5,-123
19332,2252,2071,1.0,2161.5,181
19333,2261,1950,1.0,2105.5,311
19334,1926,2124,0.0,2025.0,-198
19335,2226,1844,1.0,2035.0,382
19336,1776,2175,0.0,1975.5,-399
19337,2138,2169,0.5,2153.5,-31
19338,1978,1829,0.0,1903.5,149
19339,1753,1859,0.0,1806.0,-106
19340,2145,2116,1.0,2130.5,29
19341,1888,1981,0.0,1934.5,-93
19342,1797,1863,0.0,1830.0,-66
19343,2211,2067,0.5,2139.0,144
19344,2024,2152,0.5,2088.0,-128
19345,1979,2029,0.5,2004.0,-50
19346,1996,1831,1.0,1913.5,165
19347,1988,2139,0.0,2063.5,-151
19348,2171,1951,1.0,2061.0,220
19349,1873,2121,0.0,1997.0,-248
19350,2047,1819,1.0,1933.0,228
19351,2111,2024,1.0,2067.5,87
19352,1900,2305,0.5,2102.5,-405
19353,2198,1665,1.0,1931.5,533
19354,1653,1926,0.0,1789.5,-273
19355,1771,2291,0.0,2031.0,-520
19356,2163,1716,1.0,1939.5,447
19357,1828,1830,1.0,1829.0,-2
19358,1836,1766,1.0,1801.0,70
19359,1631,2428,0.0,2029.5,-797
19360,2176,1873,1.0,2024.5,303
19361,1721,2124,0.0,1922.5,-403
19362,2096,1595,1.0,1845.5,501
19363,2328,1956,1.0,2142.0,372
19364,2155,2276,0.5,2215.5,-121
19365,2177,2190,0.5,2183.5,-13
19366,2016,2173,0.5,2094.5,-157
19367,2412,1803,1.0,2107.5,609
19368,1847,2140,0.0,1993.5,-293
19369,2126,1840,0.5,1983.0,286
19370,2185,2327,0.5,2256.0,-142
19371,1988,1879,0.0,1933.5,109
19372,2090,2098,0.0,2094.0,-8
19373,2218,1809,0.0,2013.5,409
19374,2055,2206,0.0,2130.5,-151
19375,1844,1875,0.0,1859.5,-31
19376,1984,2054,1.0,2019.0,-70
19377,1850,1618,1.0,1734.0,232
19378,1775,1846,1.0,1810.5,-71
19379,2347,1863,0.0,2105.0,484
19380,1943,2216,0.0,2079.5,-273
19381,2258,2329,0.5,2293.5,-71
19382,2016,2034,1.0,2025.0,-18
19383,2250,2039,0.0,2144.5,211
19384,1992,1999,0.0,1995.5,-7
19385,2039,2158,0.0,2098.5,-119
19386,1896,1902,1.0,1899.0,-6
19387,2058,1843,0.0,1950.5,215
19388,2185,2228,0.5,2206.5,-43
19389,1992,2012,0.0,2002.0,-20
19390,2143,2163,1.0,2153.0,-20
19391,2175,1890,1.0,2032.5,285
19392,1779,1827,0.0,1803.0,-48
19393,1991,2125,1.0,2058.0,-134
19394,1627,1655,0.0,1641.0,-28
19395,1992,1712,1.0,1852.0,280
19396,1993,2038,1.0,2015.5,-45
19397,2064,1906,1.0,1985.0,158
19398,1965,1678,0.0,1821.5,287
19399,1908,1921,0.5,1914.5,-13
19400,2031,1985,1.0,2008.0,46
19401,1801,1674,0.5,1737.5,127
19402,1793,1737,0.0,1765.0,56
19403,2112,1993,1.0,2052.5,119
19404,1747,1783,1.0,1765.0,-36
19405,1911,1955,1.0,1933.0,-44
19406,1751,1690,1.0,1720.5,61
19407,1910,2000,0.5,1955.0,-90
19408,1995,1844,0.0,1919.5,151
19409,1819,1694,1.0,1756.5,125
19410,1723,2066,0.0,1894.5,-343
19411,1950,1779,1.0,1864.5,171
19412,1627,1935,0.0,1781.0,-308
19413,1902,1627,1.0,1764.5,275
19414,1882,1896,0.0,1889.0,-14
19415,1835,1823,1.0,1829.0,12
19416,1772,1791,0.0,1781.5,-19
19417,2138,1250,1.0,1694.0,888
19418,1820,1353,0.0,1586.5,467
19419,2057,1723,1.0,1890.0,334
19420,1723,1904,0.0,1813.5,-181
19421,1892,1743,0.5,1817.5,149
19422,1608,1631,1.0,1619.5,-23
19423,1525,1560,1.0,1542.5,-35
19424,2058,1408,1.0,1733.0,650
19425,1758,1848,0.0,1803.0,-90
19426,1635,1680,0.5,1657.5,-45
19427,1661,1060,1.0,1360.5,601
19428,1840,1840,1.0,1840.0,0
19429,1495,1760,0.0,1627.5,-265
19430,1576,1662,0.0,1619.0,-86
19431,1986,1765,1.0,1875.5,221
19432,2015,1979,1.0,1997.0,36
19433,2780,2116,0.0,2448.0,664
19434,2751,2820,1.0,2785.5,-69
19435,2660,2691,1.0,2675.5,-31
19436,2699,2721,0.5,2710.0,-22
19437,2780,2597,1.0,2688.5,183
19438,2727,2739,1.0,2733.0,-12
19439,2649,2678,0.0,2663.5,-29
19440,2614,2612,1.0,2613.0,2
19441,2804,2629,0.5,2716.5,175
19442,2662,2740,1.0,2701.0,-78
19443,2742,2765,0.0,2753.5,-23
19444,2556,2574,0.5,2565.0,-18
19445,2827,2712,1.0,2769.5,115
19446,2674,2703,0.5,2688.5,-29
19447,2763,2776,0.5,2769.5,-13
19448,2633,2692,1.0,2662.5,-59
19449,2710,2722,1.0,2716.0,-12
19450,2590,2639,1.0,2614.5,-49
19451,2695,2703,1.0,2699.0,-8
19452,2573,2581,0.5,2577.0,-8
19453,2639,2681,0.0,2660.0,-42
19454,2591,2580,0.5,2585.5,11
19455,2591,2618,1.0,2604.5,-27
19456,2580,2505,0.0,2542.5,75
19457,2525,2595,0.0,2560.0,-70
19458,2642,2780,1.0,2711.0,-138
19459,2484,2465,0.5,2474.5,19
19460,2604,2624,1.0,2614.0,-20
19461,2771,2443,1.0,2607.0,328
19462,2468,2619,0.5,2543.5,-151
19463,2668,2743,1.0,2705.5,-75
19464,2275,2358,0.0,2316.5,-83
19465,2655,2672,0.5,2663.5,-17
19466,2609,2633,0.5,2621.0,-24
19467,2520,2544,0.0,2532.0,-24
19468,2502,2569,0.5,2535.5,-67
19469,2501,2504,0.5,2502.5,-3
19470,2620,2715,0.5,2667.5,-95
19471,2486,2519,0.5,2502.5,-33
19472,2463,2491,0.5,2477.0,-28
19473,2689,2443,1.0,2566.0,246
19474,2623,2606,1.0,2614.5,17
19475,2579,2600,1.0,2589.5,-21
19476,2551,2594,0.0,2572.5,-43
19477,2649,2567,1.0,2608.0,82
19478,2500,2542,0.0,2521.0,-42
19479,2582,2576,0.5,2579.0,6
19480,2380,2457,0.0,2418.5,-77
19481,2686,2515,0.5,2600.5,171
19482,2569,2621,0.0,2595.0,-52
19483,2431,2620,0.0,2525.5,-189
19484,2548,2562,0.0,2555.0,-14
19485,2590,2408,1.0,2499.0,182
19486,2594,2634,0.5,2614.0,-40
19487,2489,2479,0.5,2484.0,10
19488,2552,2544,0.5,2548.0,8
19489,2498,2496,0.0,2497.0,2
19490,2525,2535,0.5,2530.0,-10
19491,2316,2441,0.0,2378.5,-125
19492,2477,2493,1.0,2485.0,-16
19493,2760,2274,1.0,2517.0,486
19494,2664,2609,0.5,2636.5,55
19495,2779,2768,1.0,2773.5,11
19496,2571,2565,0.5,2568.0,6
19497,2471,2726,1.0,2598.5,-255
19498,2291,2419,0.5,2355.0,-128
19499,2373,2343,0.0,2358.0,30
19500,2196,2372,0.0,2284.0,-176
19501,2712,2425,1.0,2568.5,287
19502,2501,2615,0.5,2558.0,-114
19503,2689,2672,1.0,2680.5,17
19504,2500,2552,0.5,2526.0,-52
19505,2543,2549,1.0,2546.0,-6
19506,2256,2345,0.0,2300.5,-89
19507,2382,2492,1.0,2437.0,-110
19508,2230,2254,0.0,2242.0,-24
19509,2567,2380,1.0,2473.5,187
19510,2513,2629,0.5,2571.0,-116
19511,2449,2476,0.0,2462.5,-27
19512,2666,2482,0.5,2574.0,184
19513,2664,2448,0.5,2556.0,216
19514,2508,2686,0.0,2597.0,-178
19515,2602,2610,1.0,2606.0,-8
19516,2463,2512,0.5,2487.5,-49
19517,2523,2583,1.0,2553.0,-60
19518,2402,2408,0.5,2405.0,-6
19519,2481,2451,0.5,2466.0,30
19520,2157,2284,0.0,2220.5,-127
19521,2619,2486,1.0,2552.5,133
19522,2566,2588,0.0,2577.0,-22
19523,2484,2544,0.5,2514.0,-60
19524,2523,2527,0.5,2525.0,-4
19525,2514,2456,0.5,2485.0,58
19526,2609,2690,0.5,2649.5,-81
19527,2462,2482,0.0,2472.0,-20
19528,2678,2702,1.0,2690.0,-24
19529,2620,2467,0.5,2543.5,153
19530,2607,2634,1.0,2620.5,-27
19531,2548,2558,0.5,2553.0,-10
19532,2589,2715,1.0,2652.0,-126
19533,2550,2542,0.5,2546.0,8
19534,2523,2549,1.0,2536.0,-26
19535,2248,2331,0.5,2289.5,-83
19536,2494,2512,1.0,2503.0,-18
19537,2297,2239,0.0,2268.0,58
19538,2433,2452,0.5,2442.5,-19
19539,2315,2405,0.5,2360.0,-90
19540,2316,2360,1.0,2338.0,-44
19541,2570,2276,0.5,2423.0,294
19542,2508,2564,1.0,2536.0,-56
19543,2421,2489,0.0,2455.0,-68
19544,2495,2497,0.5,2496.0,-2
19545,2517,2452,0.5,2484.5,65
19546,2398,2401,0.0,2399.5,-3
19547,2495,2527,0.5,2511.0,-32
19548,2290,2452,0.5,2371.0,-162
19549,2501,2472,0.5,2486.5,29
19550,2570,2578,0.5,2574.0,-8
19551,2482,2445,0.5,2463.5,37
19552,2456,2565,0.0,2510.5,-109
19553,2472,2413,1.0,2442.5,59
19554,2281,2422,0.0,2351.5,-141
19555,2263,2477,1.0,2370.0,-214
19556,2126,2126,1.0,2126.0,0
19557,2473,2273,0.0,2373.0,200
19558,2370,2636,0.0,2503.0,-266
19559,2200,2389,0.0,2294.5,-189
19560,2345,2346,1.0,2345.5,-1
19561,2662,2235,1.0,2448.5,427
19562,2195,2301,0.0,2248.0,-106
19563,2416,2558,1.0,2487.0,-142
19564,2106,2158,0.0,2132.0,-52
19565,2376,2445,1.0,2410.5,-69
19566,2274,2303,0.0,2288.5,-29
19567,2264,2305,1.0,2284.5,-41
19568,2222,2294,1.0,2258.0,-72
19569,2396,2194,1.0,2295.0,202
19570,2389,2471,1.0,2430.0,-82
19571,2288,2313,0.0,2300.5,-25
19572,2365,2402,1.0,2383.5,-37
19573,2605,2259,0.5,2432.0,346
19574,2430,2615,0.0,2522.5,-185
19575,2582,2538,0.5,2560.0,44
19576,2182,2229,0.5,2205.5,-47
19577,2553,2459,0.5,2506.0,94
19578,2276,2328,1.0,2302.0,-52
19579,2435,2464,1.0,2449.5,-29
19580,2106,2177,1.0,2141.5,-71
19581,2125,2360,0.0,2242.5,-235
19582,2535,2566,1.0,2550.5,-31
19583,2355,2232,0.0,2293.5,123
19584,2408,2509,1.0,2458.5,-101
19585,2408,2388,1.0,2398.0,20
19586,2358,2464,1.0,2411.0,-106
19587,2128,2324,0.0,2226.0,-196
19588,2205,2273,1.0,2239.0,-68
19589,2218,2161,0.5,2189.5,57
19590,2472,2579,0.5,2525.5,-107
19591,2376,2361,0.0,2368.5,15
19592,2381,2447,1.0,2414.0,-66
19593,2338,2146,1.0,2242.0,192
19594,2315,2388,1.0,2351.5,-73
19595,2138,2152,0.0,2145.0,-14
19596,2244,2192,0.0,2218.0,52
19597,2154,2121,0.0,2137.5,33
19598,2276,2273,0.5,2274.5,3
19599,2163,2291,0.0,2227.0,-128
19600,2220,2271,1.0,2245.5,-51
19601,2505,1836,1.0,2170.5,669
19602,2345,2441,0.5,2393.0,-96
19603,2349,2443,1.0,2396.0,-94
19604,2292,2382,0.0,2337.0,-90
19605,2511,2411,0.5,2461.0,100
19606,2000,2095,0.0,2047.5,-95
19607,2438,2424,1.0,2431.0,14
19608,2573,2313,0.5,2443.0,260
19609,2129,2263,0.0,2196.0,-134
19610,2448,2530,0.0,2489.0,-82
19611,1860,2078,0.0,1969.0,-218
19612,2335,2428,0.5,2381.5,-93
19613,1787,2249,0.0,2018.0,-462
19614,2297,2321,0.5,2309.0,-24
19615,2048,2028,0.0,2038.0,20
19616,2149,2134,0.0,2141.5,15
19617,2387,2346,1.0,2366.5,41
19618,2207,2319,0.5,2263.0,-112
19619,2229,2324,0.5,2276.5,-95
19620,2042,2292,0.0,2167.0,-250
19621,2024,1981,0.5,2002.5,43
19622,1992,1999,0.0,1995.5,-7
19623,1863,1797,0.5,1830.0,66
19624,2067,1902,0.0,1984.5,165
19625,2344,2422,1.0,2383.0,-78
19626,2029,2010,0.0,2019.5,19
19627,2227,2245,1.0,2236.0,-18
19628,2567,1996,0.0,2281.5,571
19629,2054,2216,0.0,2135.0,-162
19630,2373,2386,1.0,2379.5,-13
19631,2034,1943,0.0,1988.5,91
19632,2434,2360,1.0,2397.0,74
19633,2185,2228,0.0,2206.5,-43
19634,2283,2310,1.0,2296.5,-27
19635,2143,2163,0.5,2153.0,-20
19636,2431,2283,1.0,2357.0,148
19637,2000,2091,0.0,2045.5,-91
19638,2299,2427,1.0,2363.0,-128
19639,2231,2153,0.5,2192.0,78
19640,2111,2483,0.0,2297.0,-372
19641,2237,2077,0.5,2157.0,160
19642,2198,2305,0.0,2251.5,-107
19643,1937,2165,1.0,2051.0,-228
19644,2139,1926,0.5,2032.5,213
19645,2140,2412,0.0,2276.0,-272
19646,2171,2238,1.0,2204.5,-67
19647,1840,1847,0.0,1843.5,-7
19648,2206,2121,0.5,2163.5,85
19649,2124,2261,0.0,2192.5,-137
19650,2054,2135,0.0,2094.5,-81
19651,2221,2226,1.0,2223.5,-5
19652,2273,1984,1.0,2128.5,289
19653,1846,1850,0.0,1848.0,-4
19654,2160,2208,1.0,2184.0,-48
19655,1863,1775,0.0,1819.0,88
19656,2475,2237,0.5,2356.0,238
19657,2245,2356,0.5,2300.5,-111
19658,2176,2428,0.5,2302.0,-252
19659,2115,2112,1.0,2113.5,3
19660,2391,2096,0.0,2243.5,295
19661,2439,2477,0.5,2458.0,-38
19662,2244,2358,1.0,2301.0,-114
19663,2308,2322,1.0,2315.0,-14
19664,2074,2193,1.0,2133.5,-119
19665,2125,2175,0.5,2150.0,-50
19666,2041,2022,0.5,2031.5,19
19667,1854,1991,0.5,1922.5,-137
19668,2421,1959,1.0,2190.0,462
19669,1829,2138,0.5,1983.5,-309
19670,2154,2437,1.0,2295.5,-283
19671,2299,2035,1.0,2167.0,264
19672,1844,1910,0.0,1877.0,-66
19673,2267,2275,1.0,2271.0,-8
19674,2182,2252,1.0,2217.0,-70
19675,1879,2126,0.0,2002.5,-247
19676,2108,2203,1.0,2155.5,-95
19677,1809,1910,0.0,1859.5,-101
19678,2236,1826,1.0,2031.0,410
19679,2127,2170,1.0,2148.5,-43
19680,2327,2054,1.0,2190.5,273
19681,2106,2243,0.5,2174.5,-137
19682,2090,2098,0.5,2094.0,-8
19683,1914,2096,0.5,2005.0,-182
19684,1992,2083,1.0,2037.5,-91
19685,1905,1986,1.0,1945.5,-81
19686,2233,1948,1.0,2090.5,285
19687,2188,2064,0.0,2126.0,124
19688,1988,2158,0.5,2073.0,-170
19689,2144,1921,1.0,2032.5,223
19690,1826,2059,0.0,1942.5,-233
19691,2058,2285,0.0,2171.5,-227
19692,2283,2060,1.0,2171.5,223
19693,2216,2223,1.0,2219.5,-7
19694,2095,2024,0.0,2059.5,71
19695,1900,1940,0.0,1920.0,-40
19696,1885,1665,1.0,1775.0,220
19697,1653,1773,0.0,1713.0,-120
19698,2218,2085,0.5,2151.5,133
19699,2069,1875,0.5,1972.0,194
19700,1844,2002,0.0,1923.0,-158
19701,1924,1780,0.5,1852.0,144
19702,2169,1978,1.0,2073.5,191
19703,1859,1648,0.0,1753.5,211
19704,2261,1661,1.0,1961.0,600
19705,1825,2128,0.5,1976.5,-303
19706,2093,1840,1.0,1966.5,253
19707,1840,2051,1.0,1945.5,-211
19708,2400,1803,1.0,2101.5,597
19709,2131,2215,1.0,2173.0,-84
19710,2061,2157,1.0,2109.0,-96
19711,1560,1608,0.0,1584.0,-48
19712,2259,2171,1.0,2215.0,88
19713,1408,1525,1.0,1466.5,-117
19714,2152,2211,1.0,2181.5,-59
19715,1793,1979,1.0,1886.0,-186
19716,2038,1988,0.5,2013.0,50
19717,1951,1993,0.0,1972.0,-42
19718,1906,1819,1.0,1862.5,87
19719,2209,1771,1.0,1990.0,438
19720,1716,2114,0.0,1915.0,-398
19721,2062,1828,1.0,1945.0,234
19722,1766,2008,0.0,1887.0,-242
19723,1674,1896,0.0,1785.0,-222
19724,1835,1805,0.0,1820.0,30
19725,1737,1441,1.0,1589.0,296
19726,2329,1631,1.0,1980.0,698
19727,1873,2258,0.0,2065.5,-385
19728,2222,1721,1.0,1971.5,501
19729,1591,2039,0.0,1815.0,-448
19730,1993,1950,0.5,1971.5,43
19731,1935,1793,1.0,1864.0,142
19732,1747,1790,1.0,1768.5,-43
19733,2116,1751,0.0,1933.5,365
19734,1785,2112,0.5,1948.5,-327
19735,1911,1783,1.0,1847.0,128
19736,2262,2058,1.0,2160.0,204
19737,2096,2250,1.0,2173.0,-154
19738,2158,2012,1.0,2085.0,146
19739,1890,2039,0.5,1964.5,-149
19740,2018,1986,1.0,2002.0,32
19741,1979,1950,0.0,1964.5,29
19742,1844,2015,0.0,1929.5,-171
19743,2116,1776,1.0,1946.0,340
19744,1956,1827,0.5,1891.5,129
19745,1779,2155,0.0,1967.0,-376
19746,2016,1655,0.0,1835.5,361
19747,1627,1820,0.0,1723.5,-193
19748,1765,2057,0.0,1911.0,-292
19749,1720,1892,0.0,1806.0,-172
19750,1818,2206,0.0,2012.0,-388
19751,2161,1849,1.0,2005.0,312
19752,1677,2147,0.0,1912.0,-470
19753,2193,1756,1.0,1974.5,437
19754,1766,1877,0.5,1821.5,-111
19755,1781,1965,0.0,1873.0,-184
19756,1985,1774,1.0,1879.5,211
19757,1654,2031,0.0,1842.5,-377
19758,1662,1701,0.5,1681.5,-39
19759,1760,1576,1.0,1668.0,184
19760,1995,2000,1.0,1997.5,-5
19761,1779,1517,1.0,1648.0,262
19762,2138,1250,1.0,1694.0,888
19763,1627,1627,1.0,1627.0,0
19764,1820,1353,1.0,1586.5,467
19765,1848,1587,1.0,1717.5,261
19766,1823,1882,1.0,1852.5,-59
19767,1680,1758,1.0,1719.0,-78
19768,1730,1772,0.0,1751.0,-42
19769,1723,1635,1.0,1679.0,88
19770,1743,1723,1.0,1733.0,20
19771,1880,1765,0.0,1822.5,115
19772,2820,2026,1.0,2423.0,794
19773,2662,2740,0.5,2701.0,-78
19774,2721,2751,1.0,2736.0,-30
19775,2574,2557,0.5,2565.5,17
19776,2739,2699,1.0,2719.0,40
19777,2703,2710,0.5,2706.5,-7
19778,2612,2727,0.5,2669.5,-115
19779,2685,2695,0.5,2690.0,-10
19780,2703,2568,0.5,2635.5,135
19781,2618,2661,0.5,2639.5,-43
19782,2692,2674,0.0,2683.0,18
19783,2595,2591,0.0,2593.0,4
19784,2543,2633,0.0,2588.0,-90
19785,2776,2827,1.0,2801.5,-51
19786,2382,2492,0.5,2437.0,-110
19787,2682,2763,1.0,2722.5,-81
19788,2649,2380,0.5,2514.5,269
19789,2765,2804,0.5,2784.5,-39
19790,2576,2589,0.0,2582.5,-13
19791,2708,2712,0.5,2710.0,-4
19792,2768,2582,0.5,2675.0,186
19793,2743,2771,0.5,2757.0,-28
19794,2726,2779,0.5,2752.5,-53
19795,2668,2711,0.5,2689.5,-43
19796,2712,2747,0.5,2729.5,-35
19797,2678,2780,0.5,2729.0,-102
19798,2689,2672,0.5,2680.5,17
19799,2646,2649,0.5,2647.5,-3
19800,2780,2677,1.0,2728.5,103
19801,2340,2471,0.0,2405.5,-131
19802,2642,2639,0.5,2640.5,3
19803,2425,2343,1.0,2384.0,82
19804,2618,2624,0.0,2621.0,-6
19805,2600,2689,1.0,2644.5,-89
19806,2525,2535,0.5,2530.0,-10
19807,2567,2579,0.5,2573.0,-12
19808,2633,2493,0.0,2563.0,140
19809,2610,2664,0.5,2637.0,-54
19810,2588,2609,0.5,2598.5,-21
19811,2583,2602,0.5,2592.5,-19
19812,2590,2569,0.5,2579.5,21
19813,2691,2780,1.0,2735.5,-89
19814,2496,2479,0.0,2487.5,17
19815,2597,2621,1.0,2609.0,-24
19816,2523,2388,0.0,2455.5,135
19817,2620,2686,0.0,2653.0,-66
19818,2486,2481,0.5,2483.5,5
19819,2408,2431,1.0,2419.5,-23
19820,2639,2466,1.0,2552.5,173
19821,2544,2619,0.5,2581.5,-75
19822,2573,2590,0.5,2581.5,-17
19823,2456,2522,0.5,2489.0,-66
19824,2564,2564,0.5,2564.0,0
19825,2620,2715,1.0,2667.5,-95
19826,2497,2508,1.0,2502.5,-11
19827,2463,2491,0.5,2477.0,-28
19828,2472,2495,0.5,2483.5,-23
19829,2519,2501,1.0,2510.0,18
19830,2263,2477,1.0,2370.0,-214
19831,2444,2486,0.5,2465.0,-42
19832,2591,2452,0.5,2521.5,139
19833,2476,2567,0.5,2521.5,-91
19834,2580,2505,0.5,2542.5,75
19835,2448,2465,0.5,2456.5,-17
19836,2549,2452,0.5,2500.5,97
19837,2609,2690,0.5,2649.5,-81
19838,2507,2523,0.0,2515.0,-16
19839,2678,2621,1.0,2649.5,57
19840,2629,2494,0.0,2561.5,135
19841,2607,2634,0.0,2620.5,-27
19842,2482,2513,0.5,2497.5,-31
19843,2589,2715,0.5,2652.0,-126
19844,2636,2666,0.0,2651.0,-30
19845,2527,2517,1.0,2522.0,10
19846,2346,2370,0.0,2358.0,-24
19847,2472,2495,0.5,2483.5,-23
19848,2433,2363,1.0,2398.0,70
19849,2445,2501,1.0,2473.0,-56
19850,2317,2360,0.0,2338.5,-43
19851,2318,2482,1.0,2400.0,-164
19852,2662,2316,0.5,2489.0,346
19853,2465,2525,0.5,2495.0,-60
19854,2521,2558,1.0,2539.5,-37
19855,2467,2484,1.0,2475.5,-17
19856,2649,2445,1.0,2547.0,204
19857,2441,2498,0.0,2469.5,-57
19858,2569,2621,1.0,2595.0,-52
19859,2239,2316,0.0,2277.5,-77
19860,2567,2562,0.5,2564.5,5
19861,2601,2634,0.5,2617.5,-33
19862,2386,2391,0.0,2388.5,-5
19863,2552,2544,1.0,2548.0,8
19864,2606,2373,0.0,2489.5,233
19865,2500,2542,0.0,2521.0,-42
19866,2551,2623,0.5,2587.0,-72
19867,2380,2457,0.5,2418.5,-77
19868,2471,2576,1.0,2523.5,-105
19869,2321,2335,0.5,2328.0,-14
19870,2402,2440,0.5,2421.0,-38
19871,2134,2297,1.0,2215.5,-163
19872,2655,2365,1.0,2510.0,290
19873,2439,2477,0.0,2458.0,-38
19874,2499,2544,0.0,2521.5,-45
19875,2248,2308,0.0,2278.0,-60
19876,2573,2504,0.0,2538.5,69
19877,2538,2605,0.5,2571.5,-67
19878,2502,2530,1.0,2516.0,-28
19879,2449,2582,1.0,2515.5,-133
19880,2615,2428,1.0,2521.5,187
19881,2256,2494,1.0,2375.0,-238
19882,2547,2501,1.0,2524.0,46
19883,2230,2254,0.0,2242.0,-24
19884,2646,2500,1.0,2573.0,146
19885,2427,2431,0.0,2429.0,-4
19886,2509,2566,0.0,2537.5,-57
19887,2483,2396,1.0,2439.5,87
19888,2273,2408,1.0,2340.5,-135
19889,1981,2145,0.5,2063.0,-164
19890,2271,2400,0.0,2335.5,-129
19891,1797,2024,0.0,1910.5,-227
19892,2346,2220,0.5,2283.0,126
19893,2443,2505,1.0,2474.0,-62
19894,2324,2387,0.0,2355.5,-63
19895,2411,2349,0.5,2380.0,62
19896,2609,2319,0.0,2464.0,290
19897,2468,2619,1.0,2543.5,-151
19898,2664,2494,1.0,2579.0,170
19899,2358,2486,0.0,2422.0,-128
19900,2074,2565,0.0,2319.5,-491
19901,2465,2511,1.0,2488.0,-46
19902,2041,1845,0.0,1943.0,196
19903,2313,2438,1.0,2375.5,-125
19904,2579,1959,0.0,2269.0,620
19905,2305,2376,0.5,2340.5,-71
19906,2402,2472,0.5,2437.0,-70
19907,2145,2264,0.0,2204.5,-119
19908,2042,2381,1.0,2211.5,-339
19909,2288,2313,1.0,2300.5,-25
19910,1992,1999,0.0,1995.5,-7
19911,2151,2259,0.0,2205.0,-108
19912,2328,1896,0.5,2112.0,432
19913,2358,2464,0.5,2411.0,-106
19914,2173,2276,0.0,2224.5,-103
19915,2220,2273,0.0,2246.5,-53
19916,2686,2106,1.0,2396.0,580
19917,2402,2408,0.5,2405.0,-6
19918,2512,2501,0.0,2506.5,11
19919,2157,2284,0.0,2220.5,-127
19920,2261,2463,0.0,2362.0,-202
19921,2310,2434,1.0,2372.0,-124
19922,2221,2226,0.5,2223.5,-5
19923,2140,2283,0.0,2211.5,-143
19924,2419,2175,0.0,2297.0,244
19925,2273,2393,1.0,2333.0,-120
19926,2372,2291,1.0,2331.5,81
19927,2237,2208,0.5,2222.5,29
19928,2356,2160,0.0,2258.0,196
19929,2344,2422,0.0,2383.0,-78
19930,2115,2245,0.0,2180.0,-130
19931,2245,2262,1.0,2253.5,-17
19932,2077,2099,1.0,2088.0,-22
19933,2238,2139,0.5,2188.5,99
19934,2165,2237,0.0,2201.0,-72
19935,2121,2171,0.0,2146.0,-50
19936,2578,1937,1.0,2257.5,641
19937,2405,2297,1.0,2351.0,108
19938,2565,2570,1.0,2567.5,-5
19939,2315,2349,0.5,2332.0,-34
19940,2422,2456,0.5,2439.0,-34
19941,2527,2566,1.0,2546.5,-39
19942,2126,2126,0.0,2126.0,0
19943,2523,2540,1.0,2531.5,-17
19944,2550,2013,1.0,2281.5,537
19945,2548,2620,1.0,2584.0,-72
19946,2239,2248,0.0,2243.5,-9
19947,2542,2543,1.0,2542.5,-1
19948,2401,2237,0.0,2319.0,164
19949,2389,2473,0.5,2431.0,-84
19950,2452,2398,0.0,2425.0,54
19951,2235,2200,0.5,2217.5,35
19952,2182,2206,0.5,2194.0,-24
19953,2489,2570,1.0,2529.5,-81
19954,2203,2351,0.0,2277.0,-148
19955,2470,2421,0.5,2445.5,49
19956,2388,2108,1.0,2248.0,280
19957,2158,2188,1.0,2173.0,-30
19958,2244,2315,1.0,2279.5,-71
19959,2059,2144,0.5,2101.5,-85
19960,2327,2174,0.0,2250.5,153
19961,2482,2514,0.5,2498.0,-32
19962,2098,2185,0.0,2141.5,-87
19963,2423,2462,1.0,2442.5,-39
19964,1964,2090,0.0,2027.0,-126
19965,2380,2437,1.0,2408.5,-57
19966,1948,1986,1.0,1967.0,-38
19967,2035,2154,0.0,2094.5,-119
19968,2300,2233,1.0,2266.5,67
19969,2152,2338,0.5,2245.0,-186
19970,2267,2299,0.0,2283.0,-32
19971,2024,2138,0.0,2081.0,-114
19972,2419,2252,1.0,2335.5,167
19973,2170,2236,0.0,2203.0,-66
19974,2195,2301,0.0,2248.0,-106
19975,2127,2183,0.5,2155.0,-56
19976,2057,2158,0.0,2107.5,-101
19977,2464,2553,1.0,2508.5,-89
19978,1631,1904,0.0,1767.5,-273
19979,2435,2439,1.0,2437.0,-4
19980,2285,1651,0.0,1968.0,634
19981,2358,2391,0.0,2374.5,-33
19982,2223,2283,1.0,2253.0,-60
19983,2244,2196,1.0,2220.0,48
19984,2412,2216,0.5,2314.0,196
19985,2229,2615,1.0,2422.0,-386
19986,1840,1847,0.0,1843.5,-7
19987,2182,2178,1.0,2180.0,4
19988,2263,2154,1.0,2208.5,109
19989,2291,2129,1.0,2210.0,162
19990,2078,2163,0.5,2120.5,-85
19991,1830,1999,1.0,1914.5,-169
19992,2418,2262,1.0,2340.0,156
19993,2250,2261,1.0,2255.5,-11
19994,2128,2158,1.0,2143.0,-30
19995,2039,2093,1.0,2066.0,-54
19996,2408,2067,1.0,2237.5,341
19997,2024,2324,0.0,2174.0,-300
19998,2128,2029,1.0,2078.5,99
19999,1996,2170,0.0,2083.0,-174
20000,2244,2441,1.0,2342.5,-197
20001,2345,2274,0.0,2309.5,71
20002,2294,2382,1.0,2338.0,-88
20003,2301,2222,1.0,2261.5,79
20004,2169,2400,0.0,2284.5,-231
20005,2203,2061,1.0,2132.0,142
20006,1859,2215,0.0,2037.0,-356
20007,2157,1648,1.0,1902.5,509
20008,2249,2085,1.0,2167.0,164
20009,2132,2028,0.5,2080.0,104
20010,2053,2002,0.5,2027.5,51
20011,1924,2048,0.0,1986.0,-124
20012,2206,2138,0.0,2172.0,68
20013,1829,2055,0.0,1942.0,-226
20014,2135,1753,1.0,1944.0,382
20015,1896,2054,0.0,1975.0,-158
20016,2014,2095,0.0,2054.5,-81
20017,2125,1835,1.0,1980.0,290
20018,2171,2061,1.0,2116.0,110
20019,2355,2232,0.0,2293.5,123
20020,2259,2328,1.0,2293.5,-69
20021,2228,2405,0.5,2316.5,-177
20022,2428,2475,1.0,2451.5,-47
20023,2143,2185,0.0,2164.0,-42
20024,2124,2176,1.0,2150.0,-52
20025,2216,2129,0.0,2172.5,87
20026,2361,2218,1.0,2289.5,143
20027,1943,2054,0.0,1998.5,-111
20028,2146,2246,0.5,2196.0,-100
20029,2155,2016,1.0,2085.5,139
20030,1940,2038,0.0,1989.0,-98
20031,2016,2190,1.0,2103.0,-174
20032,1773,1885,0.5,1829.0,-112
20033,2000,1820,0.0,1910.0,180
20034,2305,2111,1.0,2208.0,194
20035,2231,2153,1.0,2192.0,78
20036,1926,2198,1.0,2062.0,-272
20037,2112,1900,1.0,2006.0,212
20038,2062,2209,1.0,2135.5,-147
20039,1911,1785,0.5,1848.0,126
20040,1868,2008,1.0,1938.0,-140
20041,2175,1690,0.5,1932.5,485
20042,1993,2038,1.0,2015.5,-45
20043,1854,1991,1.0,1922.5,-137
20044,2149,1712,0.0,1930.5,437
20045,2152,2211,0.0,2181.5,-59
20046,2207,2319,0.5,2263.0,-112
20047,1995,1979,0.0,1987.0,16
20048,2206,2292,1.0,2249.0,-86
20049,1793,1993,0.0,1893.0,-200
20050,2147,2161,1.0,2154.0,-14
20051,1955,1747,0.0,1851.0,208
20052,1850,2198,0.0,2024.0,-348
20053,2329,2347,1.0,2338.0,-18
20054,1775,1846,0.5,1810.5,-71
20055,2222,2258,1.0,2240.0,-36
20056,1988,2064,1.0,2026.0,-76
20057,1576,1662,0.0,1619.0,-86
20058,1908,1921,1.0,1914.5,-13
20059,2243,1992,0.0,2117.5,251
20060,2096,2106,0.0,2101.0,-10
20061,1904,1914,0.5,1909.0,-10
20062,2018,1766,1.0,1892.0,252
20063,1965,1950,0.0,1957.5,15
20064,1926,1985,0.0,1955.5,-59
20065,2031,1844,0.5,1937.5,187
20066,1723,1986,0.0,1854.5,-263
20067,1979,2015,0.0,1997.0,-36
20068,1910,2126,1.0,2018.0,-216
20069,1910,1844,0.0,1877.0,66
20070,1819,1988,0.0,1903.5,-169
20071,1779,2218,0.0,1998.5,-439
20072,1875,1627,0.0,1751.0,248
20073,1627,1844,0.0,1735.5,-217
20074,1780,1587,1.0,1683.5,193
20075,1950,1674,1.0,1812.0,276
20076,1805,1935,0.5,1870.0,-130
20077,1902,1801,0.0,1851.5,101
20078,1803,1723,1.0,1763.0,80
20079,1903,1723,1.0,1813.0,180
20080,1827,1608,1.0,1717.5,219
20081,1560,1779,0.0,1669.5,-219
20082,1655,1525,1.0,1590.0,130
20083,1408,1655,1.0,1531.5,-247
20084,1760,1631,1.0,1695.5,129
20085,1873,1495,0.0,1684.0,378
20086,1595,1721,0.0,1658.0,-126
20087,2058,2060,0.0,2059.0,-2
20088,2012,2096,1.0,2054.0,-84
20089,2024,1890,1.0,1957.0,134
20090,1789,1818,0.0,1803.5,-29
20091,1665,1900,0.5,1782.5,-235
20092,1756,1677,0.0,1716.5,79
20093,1877,1653,0.5,1765.0,224
20094,1951,1988,1.0,1969.5,-37
20095,1774,1781,0.5,1777.5,-7
20096,1710,1873,1.0,1791.5,-163
20097,1848,1654,0.0,1751.0,194
20098,1828,1716,1.0,1772.0,112
20099,1680,1758,0.0,1719.0,-78
20100,1553,1766,0.0,1659.5,-213
20101,1661,1635,0.5,1648.0,26
20102,2026,1880,0.0,1953.0,146
20103,1840,1825,0.5,1832.5,15
20104,1995,1405,1.0,1700.0,590
20105,1888,2116,0.0,2002.0,-228
20106,1517,1694,1.0,1605.5,-177
20107,2138,1765,1.0,1951.5,373
20108,1820,1353,0.0,1586.5,467
20109,1765,1720,0.0,1742.5,45
20110,1701,2066,0.5,1883.5,-365
20111,1060,1882,0.0,1471.0,-822
20112,1772,1730,0.0,1751.0,42
20113,2739,2820,0.5,2779.5,-81
20114,2751,2727,0.5,2739.0,24
20115,2614,2721,0.5,2667.5,-107
20116,2676,2568,0.5,2622.0,108
20117,2689,2827,0.5,2758.0,-138
20118,2776,2600,1.0,2688.0,176
20119,2579,2763,0.5,2671.0,-184
20120,2722,2565,1.0,2643.5,157
20121,2710,2765,0.5,2737.5,-55
20122,2742,2703,0.5,2722.5,39
20123,2681,2712,0.5,2696.5,-31
20124,2708,2685,0.5,2696.5,23
20125,2661,2780,0.5,2720.5,-119
20126,2639,2639,0.5,2639.0,0
20127,2618,2642,0.5,2630.0,-24
20128,2624,2591,0.5,2607.5,33
20129,2740,2703,1.0,2721.5,37
20130,2674,2662,1.0,2668.0,12
20131,2557,2692,1.0,2624.5,-135
20132,2594,2556,1.0,2575.0,38
20133,2664,2780,0.5,2722.0,-116
20134,2691,2610,1.0,2650.5,81
20135,2602,2660,0.5,2631.0,-58
20136,2621,2568,1.0,2594.5,53
20137,2771,2686,0.5,2728.5,85
20138,2620,2743,0.0,2681.5,-123
20139,2711,2431,0.0,2571.0,280
20140,2408,2672,0.0,2540.0,-264
20141,2690,2780,0.0,2735.0,-90
20142,2678,2609,0.5,2643.5,69
20143,2702,2649,0.5,2675.5,53
20144,2629,2678,1.0,2653.5,-49
20145,2501,2639,0.5,2570.0,-138
20146,2590,2445,1.0,2517.5,145
20147,2482,2581,0.0,2531.5,-99
20148,2564,2318,1.0,2441.0,246
20149,2517,2760,0.5,2638.5,-243
20150,2779,2527,1.0,2653.0,252
20151,2497,2726,0.5,2611.5,-229
20152,2747,2495,0.0,2621.0,252
20153,2649,2712,0.5,2680.5,-63
20154,2672,2621,1.0,2646.5,51
20155,2569,2677,0.5,2623.0,-108
20156,2549,2562,0.5,2555.5,-13
20157,2434,2649,0.0,2541.5,-215
20158,2589,2310,0.0,2449.5,279
20159,2283,2582,0.0,2432.5,-299
20160,2515,2283,1.0,2399.0,232
20161,2422,2609,0.0,2515.5,-187
20162,2588,2344,1.0,2466.0,244
20163,2262,2569,1.0,2415.5,-307
20164,2502,2245,1.0,2373.5,257
20165,2715,2629,1.0,2672.0,86
20166,2513,2620,0.0,2566.5,-107
20167,2491,2482,1.0,2486.5,9
20168,2666,2463,0.0,2564.5,203
20169,2465,2655,0.0,2560.0,-190
20170,2544,2484,1.0,2514.0,60
20171,2467,2520,0.5,2493.5,-53
20172,2504,2443,1.0,2473.5,61
20173,2273,2618,0.0,2445.5,-345
20174,2535,2276,1.0,2405.5,259
20175,2400,2525,0.0,2462.5,-125
20176,2477,2271,1.0,2374.0,206
20177,2471,2591,0.5,2531.0,-120
20178,2505,2343,0.5,2424.0,162
20179,2373,2580,0.0,2476.5,-207
20180,2452,2425,1.0,2438.5,27
20181,2686,2543,1.0,2614.5,143
20182,2492,2508,0.5,2500.0,-16
20183,2501,2382,0.0,2441.5,119
20184,2380,2463,0.0,2421.5,-83
20185,2634,2501,1.0,2567.5,133
20186,2519,2601,0.5,2560.0,-82
20187,2594,2486,0.5,2540.0,108
20188,2444,2552,0.5,2498.0,-108
20189,2501,2057,0.0,2279.0,444
20190,2077,2547,0.0,2312.0,-470
20191,2552,2165,1.0,2358.5,387
20192,1937,2500,0.5,2218.5,-563
20193,2567,2393,0.5,2480.0,174
20194,2273,2476,0.0,2374.5,-203
20195,2449,2208,1.0,2328.5,241
20196,2160,2448,0.0,2304.0,-288
20197,2605,2523,1.0,2564.0,82
20198,2451,2538,0.5,2494.5,-87
20199,2582,2481,1.0,2531.5,101
20200,2486,2449,0.0,2467.5,37
20201,2634,2590,1.0,2612.0,44
20202,2489,2715,0.0,2602.0,-226
20203,2589,2496,1.0,2542.5,93
20204,2388,2590,0.0,2489.0,-202
20205,2511,2508,0.5,2509.5,3
20206,2497,2465,0.5,2481.0,32
20207,2424,2495,1.0,2459.5,-71
20208,2495,2438,0.5,2466.5,57
20209,2505,2472,0.0,2488.5,33
20210,2477,2443,0.5,2460.0,34
20211,2349,2263,1.0,2306.0,86
20212,2452,2411,0.5,2431.5,41
20213,2464,2662,0.0,2563.0,-198
20214,2521,2273,1.0,2397.0,248
20215,2220,2416,0.5,2318.0,-196
20216,2445,2205,1.0,2325.0,240
20217,2335,2578,0.0,2456.5,-243
20218,2570,2321,1.0,2445.5,249
20219,2297,2565,0.0,2431.0,-268
20220,2456,2134,0.0,2295.0,322
20221,2388,2389,0.5,2388.5,-1
20222,2440,2315,1.0,2377.5,125
20223,2192,2402,0.0,2297.0,-210
20224,2365,2244,0.5,2304.5,121
20225,2619,2609,0.5,2614.0,10
20226,2664,2544,1.0,2604.0,120
20227,2522,2565,1.0,2543.5,-43
20228,2571,2484,0.0,2527.5,87
20229,2623,2300,1.0,2461.5,323
20230,2299,2594,0.0,2446.5,-295
20231,2551,2275,1.0,2413.0,276
20232,2267,2576,0.0,2421.5,-309
20233,2588,2431,0.5,2509.5,157
20234,2396,2566,1.0,2481.0,-170
20235,2527,2299,0.0,2413.0,228
20236,2483,2540,0.0,2511.5,-57
20237,2419,2452,0.5,2435.5,-33
20238,2433,2301,0.5,2367.0,132
20239,2195,2317,0.0,2256.0,-122
20240,2316,2158,1.0,2237.0,158
20241,2619,2646,0.0,2632.5,-27
20242,2566,2468,0.0,2517.0,98
20243,2358,2535,1.0,2446.5,-177
20244,2509,2275,1.0,2392.0,234
20245,2376,2482,0.0,2429.0,-106
20246,2462,2305,1.0,2383.5,157
20247,2264,2467,0.0,2365.5,-203
20248,2423,2194,1.0,2308.5,229
20249,2396,2018,1.0,2207.0,378
20250,1950,2288,0.0,2119.0,-338
20251,2259,1926,1.0,2092.5,333
20252,1776,2151,0.0,1963.5,-375
20253,2542,2620,0.5,2581.0,-78
20254,2558,2500,0.0,2529.0,58
20255,2457,2548,0.5,2502.5,-91
20256,2543,2380,0.5,2461.5,163
20257,2473,2523,0.5,2498.0,-50
20258,2512,2327,1.0,2419.5,185
20259,2200,2507,0.0,2353.5,-307
20260,2494,2235,1.0,2364.5,259
20261,2579,2328,1.0,2453.5,251
20262,2276,2472,0.0,2374.0,-196
20263,2447,2177,1.0,2312.0,270
20264,2106,2402,0.0,2254.0,-296
20265,2570,2636,0.5,2603.0,-66
20266,2346,2489,0.0,2417.5,-143
20267,2452,2363,0.0,2407.5,89
20268,2345,2470,0.0,2407.5,-125
20269,2553,2391,1.0,2472.0,162
20270,2386,2464,1.0,2425.0,-78
20271,2439,2373,0.5,2406.0,66
20272,2360,2435,0.0,2397.5,-75
20273,2615,2530,1.0,2572.5,85
20274,2502,2229,1.0,2365.5,273
20275,2178,2448,0.0,2313.0,-270
20276,2428,2182,0.5,2305.0,246
20277,2111,2419,0.5,2265.0,-308
20278,2372,2305,0.5,2338.5,67
20279,2198,2196,0.5,2197.0,2
20280,2160,1926,1.0,2043.0,234
20281,2154,2261,1.0,2207.5,-107
20282,2124,2291,0.0,2207.5,-167
20283,1830,2221,1.0,2025.5,-391
20284,2175,1836,0.0,2005.5,339
20285,2218,2400,1.0,2309.0,-182
20286,2215,2361,0.0,2288.0,-146
20287,2376,2131,0.5,2253.5,245
20288,2157,2246,1.0,2201.5,-89
20289,2095,2346,0.5,2220.5,-251
20290,2387,2000,1.0,2193.5,387
20291,2319,2324,1.0,2321.5,-5
20292,2494,2421,0.5,2457.5,73
20293,2380,2345,1.0,2362.5,35
20294,2256,2154,1.0,2205.0,102
20295,2035,2254,0.0,2144.5,-219
20296,2408,2139,1.0,2273.5,269
20297,2238,2402,1.0,2320.0,-164
20298,2284,2171,0.0,2227.5,113
20299,2047,2157,0.5,2102.0,-110
20300,2356,2408,1.0,2382.0,-52
20301,2324,2245,1.0,2284.5,79
20302,2115,2170,1.0,2142.5,-55
20303,2161,2099,1.0,2130.0,62
20304,2145,2149,0.5,2147.0,-4
20305,2319,1981,1.0,2150.0,338
20306,2024,2207,0.5,2115.5,-183
20307,2292,1863,1.0,2077.5,429
20308,2209,2249,0.5,2229.0,-40
20309,1787,2062,0.0,1924.5,-275
20310,2008,2028,1.0,2018.0,-20
20311,2053,1868,1.0,1960.5,185
20312,2171,2155,0.0,2163.0,16
20313,2190,2328,0.0,2259.0,-138
20314,2259,2016,1.0,2137.5,243
20315,1820,2118,1.0,1969.0,-298
20316,2498,2303,0.5,2400.5,195
20317,2244,2441,0.0,2342.5,-197
20318,2316,2274,1.0,2295.0,42
20319,2294,2274,0.0,2284.0,20
20320,2347,2206,0.5,2276.5,141
20321,2055,2329,0.0,2192.0,-274
20322,2258,2135,0.0,2196.5,123
20323,2054,2222,0.0,2138.0,-168
20324,2206,1964,1.0,2085.0,242
20325,1986,2147,1.0,2066.5,-161
20326,2193,1905,1.0,2049.0,288
20327,2233,2198,0.0,2215.5,35
20328,2477,2475,1.0,2476.0,2
20329,2428,2439,1.0,2433.5,-11
20330,2322,2176,1.0,2249.0,146
20331,2124,2308,0.0,2216.0,-184
20332,2401,1845,1.0,2123.0,556
20333,2022,2452,0.0,2237.0,-430
20334,2290,2041,1.0,2165.5,249
20335,1959,2206,0.0,2082.5,-247
20336,2188,2550,0.0,2369.0,-362
20337,2331,2158,0.5,2244.5,173
20338,2144,2248,1.0,2196.0,-104
20339,2237,2071,0.0,2154.0,166
20340,1992,2281,0.0,2136.5,-289
20341,2126,2126,0.0,2126.0,0
20342,2013,1904,1.0,1958.5,109
20343,2297,2391,0.0,2344.0,-94
20344,2358,2349,1.0,2353.5,9
20345,2315,2244,1.0,2279.5,71
20346,2193,2276,1.0,2234.5,-83
20347,2236,2152,0.0,2194.0,84
20348,2138,2170,0.5,2154.0,-32
20349,2183,2121,0.0,2152.0,62
20350,2024,2054,1.0,2039.0,-30
20351,2262,2285,0.0,2273.5,-23
20352,2283,2250,0.5,2266.5,33
20353,2158,2223,1.0,2190.5,-65
20354,2246,2039,1.0,2142.5,207
20355,2064,2418,0.5,2241.0,-354
20356,2261,1988,0.0,2124.5,273
20357,1921,2128,0.0,2024.5,-207
20358,2051,1908,0.0,1979.5,143
20359,2038,2182,0.5,2110.0,-144
20360,2351,1993,1.0,2172.0,358
20361,1906,2203,0.0,2054.5,-297
20362,2175,2327,1.0,2251.0,-152
20363,2185,2125,0.5,2155.0,60
20364,1991,2090,0.5,2040.5,-99
20365,2083,1854,1.0,1968.5,229
20366,1986,2042,1.0,2014.0,-56
20367,1992,1979,0.0,1985.5,13
20368,2015,1902,1.0,1958.5,113
20369,1896,2116,0.0,2006.0,-220
20370,2263,2412,1.0,2337.5,-149
20371,1847,2078,0.0,1962.5,-231
20372,1999,1840,1.0,1919.5,159
20373,2085,1860,0.0,1972.5,225
20374,1900,2024,0.0,1962.0,-124
20375,2069,2132,1.0,2100.5,-63
20376,1653,1665,0.0,1659.0,-12
20377,2211,2002,1.0,2106.5,209
20378,1875,2218,1.0,2046.5,-343
20379,1995,2152,0.5,2073.5,-157
20380,1780,1844,0.5,1812.0,-64
20381,2095,1831,1.0,1963.0,264
20382,1844,1910,0.0,1877.0,-66
20383,1885,2038,0.0,1961.5,-153
20384,1988,1773,1.0,1880.5,215
20385,1835,1896,1.0,1865.5,-61
20386,1819,1873,0.0,1846.0,-54
20387,1771,1710,0.0,1740.5,61
20388,1785,2112,1.0,1948.5,-327
20389,1828,1716,0.5,1772.0,112
20390,1911,1783,1.0,1847.0,128
20391,2441,1766,1.0,2103.5,675
20392,2292,2382,1.0,2337.0,-90
20393,2126,2301,0.0,2213.5,-175
20394,2061,2169,0.0,2115.0,-108
20395,1988,1879,1.0,1933.5,109
20396,1648,1859,0.5,1753.5,-211
20397,2216,1809,1.0,2012.5,407
20398,2185,2228,1.0,2206.5,-43
20399,1943,2054,0.0,1998.5,-111
20400,2129,2143,0.5,2136.0,-14
20401,2024,2034,0.5,2029.0,-10
20402,1846,1850,1.0,1848.0,-4
20403,2029,2010,0.0,2019.5,19
20404,1863,1775,0.0,1819.0,88
20405,2138,1996,0.5,2067.0,142
20406,1892,2057,1.0,1974.5,-165
20407,1753,1829,1.0,1791.0,-76
20408,1651,1631,0.5,1641.0,20
20409,2091,2125,1.0,2108.0,-34
20410,2355,2000,0.5,2177.5,355
20411,2231,2388,0.5,2309.5,-157
20412,2405,1900,1.0,2152.5,505
20413,1779,1827,1.0,1803.0,-48
20414,1793,1655,0.0,1724.0,138
20415,1805,1760,1.0,1782.5,45
20416,1495,1801,0.0,1648.0,-306
20417,1737,1441,1.0,1589.0,296
20418,1993,2000,0.0,1996.5,-7
20419,1694,1747,0.5,1720.5,-53
20420,1955,1517,1.0,1736.0,438
20421,1765,1751,0.0,1758.0,14
20422,1965,1766,0.0,1865.5,199
20423,1720,1985,0.5,1852.5,-265
20424,1723,2243,0.5,1983.0,-520
20425,2106,1914,0.0,2010.0,192
20426,2066,1825,1.0,1945.5,241
20427,1840,1701,1.0,1770.5,139
20428,1405,1840,1.0,1622.5,-435
20429,2096,2058,1.0,2077.0,38
20430,1576,1662,0.0,1619.0,-86
20431,1890,2012,0.5,1951.0,-122
20432,1880,2058,1.0,1969.0,-178
20433,2060,2026,1.0,2043.0,34
20434,1823,1950,0.0,1886.5,-127
20435,1935,1772,1.0,1853.5,163
20436,1730,1902,0.0,1816.0,-172
20437,1608,1323,1.0,1465.5,285
20438,1781,1877,0.5,1829.0,-96
20439,1405,1560,0.0,1482.5,-155
20440,1654,1774,0.0,1714.0,-120
20441,1789,1408,0.0,1598.5,381
20442,1758,1848,1.0,1803.0,-90
20443,1677,1849,0.0,1763.0,-172
20444,1635,1661,0.5,1648.0,-26
20445,1723,1756,0.5,1739.5,-33
20446,1627,1779,0.0,1703.0,-152
20447,1743,1723,1.0,1733.0,20
20448,1587,1627,0.0,1607.0,-40
20449,1631,1873,0.0,1752.0,-242
20450,1721,1595,0.0,1658.0,126
20451,2116,1250,1.0,1683.0,866
20452,2138,1888,1.0,2013.0,250
20453,1820,1353,1.0,1586.5,467
20454,2139,1765,0.5,1952.0,374
20455,2451,2555,0.5,2503.0,-104
20456,2075,2098,0.0,2086.5,-23
20457,2405,2403,0.5,2404.0,2
20458,2500,1950,1.0,2225.0,550
20459,2044,2137,0.0,2090.5,-93
20460,2374,2400,1.0,2387.0,-26
20461,2023,2033,0.0,2028.0,-10
20462,2513,2338,0.0,2425.5,175
20463,2081,2313,0.0,2197.0,-232
20464,2355,2348,0.5,2351.5,7
20465,1911,1931,0.5,1921.0,-20
20466,2438,2274,1.0,2356.0,164
20467,2058,2220,0.0,2139.0,-162
20468,2355,2358,1.0,2356.5,-3
20469,1809,1998,0.0,1903.5,-189
20470,2423,2320,1.0,2371.5,103
20471,2106,2057,1.0,2081.5,49
20472,2258,2321,0.5,2289.5,-63
20473,1966,2026,0.0,1996.0,-60
20474,2283,2260,0.5,2271.5,23
20475,2317,2391,1.0,2354.0,-74
20476,2004,1986,0.0,1995.0,18
20477,2255,2325,1.0,2290.0,-70
20478,2404,1731,1.0,2067.5,673
20479,2022,2152,0.5,2087.0,-130
20480,2235,2329,1.0,2282.0,-94
20481,1909,1974,1.0,1941.5,-65
20482,2211,2192,0.0,2201.5,19
20483,2345,2367,0.0,2356.0,-22
20484,1945,1981,0.0,1963.0,-36
20485,2275,2339,1.0,2307.0,-64
20486,2377,1900,1.0,2138.5,477
20487,1960,2130,0.0,2045.0,-170
20488,2123,2149,0.0,2136.0,-26
20489,1921,1946,0.0,1933.5,-25
20490,2368,2367,1.0,2367.5,1
20491,1948,2010,0.0,1979.0,-62
20492,2244,2347,1.0,2295.5,-103
20493,1334,1919,0.0,1626.5,-585
20494,2082,2161,0.0,2121.5,-79
20495,2374,2394,1.0,2384.0,-20
20496,1961,2052,0.0,2006.5,-91
20497,1933,2328,1.0,2130.5,-395
20498,2008,1806,0.0,1907.0,202
20499,2243,2281,1.0,2262.0,-38
20500,1924,2068,0.0,1996.0,-144
20501,2239,2294,1.0,2266.5,-55
20502,2348,1890,1.0,2119.0,458
20503,2056,2056,0.0,2056.0,0
20504,2339,2261,0.0,2300.0,78
20505,1901,1862,0.0,1881.5,39
20506,2054,2170,0.0,2112.0,-116
20507,2345,2447,1.0,2396.0,-102
20508,1943,2005,0.0,1974.0,-62
20509,2108,2096,1.0,2102.0,12
20510,2402,1869,0.0,2135.5,533
20511,1923,2345,0.0,2134.0,-422
20512,2161,2308,1.0,2234.5,-147
20513,1655,1924,0.0,1789.5,-269
20514,2176,2112,0.0,2144.0,64
20515,2295,2303,1.0,2299.0,-8
20516,1898,2113,0.5,2005.5,-215
20517,2276,2248,1.0,2262.0,28
20518,2252,1651,1.0,1951.5,601
20519,2013,2053,0.0,2033.0,-40
20520,2260,2393,1.0,2326.5,-133
20521,1788,1771,0.0,1779.5,17
20522,2029,2149,0.0,2089.0,-120
20523,2254,2431,0.5,2342.5,-177
20524,1926,1961,0.0,1943.5,-35
20525,2135,2261,1.0,2198.0,-126
20526,2369,1874,0.5,2121.5,495
20527,2535,2559,0.5,2547.0,-24
20528,2265,2202,0.5,2233.5,63
20529,2469,2528,0.0,2498.5,-59
20530,2464,2167,0.5,2315.5,297
20531,2191,2248,0.0,2219.5,-57
20532,2468,2446,1.0,2457.0,22
20533,2298,2227,0.5,2262.5,71
20534,2391,2351,0.5,2371.0,40
20535,2482,2474,0.0,2478.0,8
20536,2039,2151,0.0,2095.0,-112
20537,2125,2263,0.5,2194.0,-138
20538,2384,2222,0.5,2303.0,162
20539,2204,2267,0.0,2235.5,-63
20540,2289,2331,1.0,2310.0,-42
20541,2146,2113,0.5,2129.5,33
20542,2195,2205,1.0,2200.0,-10
20543,2267,2421,1.0,2344.0,-154
20544,2175,2170,0.0,2172.5,5
20545,2168,2321,1.0,2244.5,-153
20546,2320,2118,0.5,2219.0,202
20547,2290,2288,1.0,2289.0,2
20548,2102,2158,0.5,2130.0,-56
20549,2198,2268,1.0,2233.0,-70
20550,2259,2113,1.0,2186.0,146
20551,2218,2268,0.5,2243.0,-50
20552,2224,2330,0.5,2277.0,-106
20553,2081,2123,1.0,2102.0,-42
20554,2287,2134,1.0,2210.5,153
20555,2254,2299,0.5,2276.5,-45
20556,2113,2157,0.0,2135.0,-44
20557,2116,2185,1.0,2150.5,-69
20558,2404,2102,1.0,2253.0,302
20559,2167,2254,0.5,2210.5,-87
20560,2167,2188,1.0,2177.5,-21
20561,2009,2114,1.0,2061.5,-105
20562,2225,2114,0.5,2169.5,111
20563,2124,2266,0.0,2195.0,-142
20564,2134,2207,0.5,2170.5,-73
20565,2051,2156,0.0,2103.5,-105
20566,2244,2128,1.0,2186.0,116
20567,2037,2035,0.5,2036.0,2
20568,2152,2227,1.0,2189.5,-75
20569,1710,2031,0.0,1870.5,-321
20570,2475,1968,1.0,2221.5,507
20571,2181,2184,0.0,2182.5,-3
20572,2469,2482,1.0,2475.5,-13
20573,2059,2136,0.0,2097.5,-77
20574,1872,1966,1.0,1919.0,-94
20575,1671,1467,0.0,1569.0,204
20576,1725,1801,1.0,1763.0,-76
20577,2214,2350,0.0,2282.0,-136
20578,2249,1984,1.0,2116.5,265
20579,1799,2215,0.0,2007.0,-416
20580,2186,1772,1.0,1979.0,414
20581,2157,2480,0.0,2318.5,-323
20582,2390,2143,1.0,2266.5,247
20583,2137,2389,0.0,2263.0,-252
20584,2237,2101,0.0,2169.0,136
20585,2446,2159,0.5,2302.5,287
20586,1954,2407,0.0,2180.5,-453
20587,2347,2034,1.0,2190.5,313
20588,1750,2305,0.0,2027.5,-555
20589,2188,2431,0.0,2309.5,-243
20590,2423,2143,1.0,2283.0,280
20591,1849,2361,0.0,2105.0,-512
20592,2268,1635,1.0,1951.5,633
20593,2313,2157,0.0,2235.0,156
20594,2136,2288,0.0,2212.0,-152
20595,2258,2129,1.0,2193.5,129
20596,2020,2151,0.5,2085.5,-131
20597,2126,2462,0.0,2294.0,-336
20598,2278,2079,1.0,2178.5,199
20599,2110,2172,0.0,2141.0,-62
20600,1980,2013,1.0,1996.5,-33
20601,2255,2050,1.0,2152.5,205
20602,2030,2174,0.5,2102.0,-144
20603,2063,1727,0.5,1895.0,336
20604,1793,2037,1.0,1915.0,-244
20605,1953,2082,0.5,2017.5,-129
20606,1720,1853,0.5,1786.5,-133
20607,1924,1683,1.0,1803.5,241
20608,1274,1813,0.0,1543.5,-539
20609,1840,1888,0.0,1864.0,-48
20610,1626,1719,1.0,1672.5,-93
20611,1608,1996,0.0,1802.0,-388
20612,1922,1446,1.0,1684.0,476
20613,1929,1821,1.0,1875.0,108
20614,1668,1833,0.0,1750.5,-165
20615,1809,1660,0.5,1734.5,149
20616,1442,1633,0.0,1537.5,-191
20617,1884,1945,0.5,1914.5,-61
20618,1713,1505,1.0,1609.0,208
20619,1583,1655,0.0,1619.0,-72
20620,1605,1601,1.0,1603.0,4
20621,1745,1718,0.5,1731.5,27
20622,1577,1702,0.0,1639.5,-125
20623,1619,1626,0.0,1622.5,-7
20624,1528,1419,1.0,1473.5,109
20625,1666,1546,0.0,1606.0,120
20626,1378,1755,0.5,1566.5,-377
20627,1492,1585,0.0,1538.5,-93
20628,1575,1402,1.0,1488.5,173
20629,1673,1943,0.5,1808.0,-270
20630,1925,1598,1.0,1761.5,327
20631,1475,1926,0.0,1700.5,-451
20632,1907,1499,1.0,1703.0,408
20633,1414,2090,0.0,1752.0,-676
20634,2038,1584,1.0,1811.0,454
20635,1537,1840,0.0,1688.5,-303
20636,1685,1704,1.0,1694.5,-19
20637,2064,1752,1.0,1908.0,312
20638,1451,2020,0.0,1735.5,-569
20639,1751,1379,1.0,1565.0,372
20640,1425,1687,0.0,1556.0,-262
20641,2024,1667,1.0,1845.5,357
20642,1620,1877,1.0,1748.5,-257
20643,1770,1495,1.0,1632.5,275
20644,1340,1594,0.0,1467.0,-254
20645,1726,1503,1.0,1614.5,223
20646,1502,1708,0.0,1605.0,-206
20647,1795,1479,1.0,1637.0,316
20648,1518,1797,0.0,1657.5,-279
20649,1483,1788,0.0,1635.5,-305
20650,1683,1544,1.0,1613.5,139
20651,1508,1735,0.0,1621.5,-227
20652,1414,1365,1.0,1389.5,49
20653,1568,1909,0.0,1738.5,-341
20654,1774,1471,1.0,1622.5,303
20655,1407,1490,0.5,1448.5,-83
20656,1494,1322,1.0,1408.0,172
20657,1400,1607,0.0,1503.5,-207
20658,1505,1595,1.0,1550.0,-90
20659,1451,1509,0.0,1480.0,-58
20660,1734,1432,1.0,1583.0,302
20661,1863,1346,1.0,1604.5,517
20662,1476,1712,0.0,1594.0,-236
20663,1446,1559,1.0,1502.5,-113
20664,1105,1388,0.0,1246.5,-283
20665,1637,1482,1.0,1559.5,155
20666,1412,1581,1.0,1496.5,-169
20667,1581,1206,0.5,1393.5,375
20668,1306,1415,0.0,1360.5,-109
20669,1070,1456,0.0,1263.0,-386
20670,1053,1117,1.0,1085.0,-64
20671,2271,1439,1.0,1855.0,832
20672,1334,1872,0.0,1603.0,-538
20673,1812,1468,1.0,1640.0,344
20674,1246,1526,0.0,1386.0,-280
20675,1518,1932,0.0,1725.0,-414
20676,1899,1174,1.0,1536.5,725
20677,1350,1790,0.0,1570.0,-440
20678,1727,1267,1.0,1497.0,460
20679,1902,1739,0.5,1820.5,163
20680,1365,1881,0.0,1623.0,-516
20681,1871,1123,1.0,1497.0,748
20682,1034,1853,0.0,1443.5,-819
20683,1712,1676,1.0,1694.0,36
20684,1458,1062,0.0,1260.0,396
20685,1979,1926,1.0,1952.5,53
20686,1372,1374,0.0,1373.0,-2
20687,1727,1960,1.0,1843.5,-233
20688,1239,1362,0.0,1300.5,-123
20689,1791,1716,1.0,1753.5,75
20690,1933,1326,1.0,1629.5,607
20691,1284,1707,0.0,1495.5,-423
20692,1733,1222,1.0,1477.5,511
20693,1182,1664,0.5,1423.0,-482
20694,1437,1810,0.0,1623.5,-373
20695,1748,1263,1.0,1505.5,485
20696,1138,1755,0.0,1446.5,-617
20697,1962,1452,1.0,1707.0,510
20698,1712,1736,1.0,1724.0,-24
20699,1397,1727,0.0,1562.0,-330
20700,1785,1813,1.0,1799.0,-28
20701,1655,1764,1.0,1709.5,-109
20702,1822,1702,1.0,1762.0,120
20703,1698,1755,1.0,1726.5,-57
20704,1772,1308,0.5,1540.0,464
20705,1702,1778,1.0,1740.0,-76
20706,1831,1713,1.0,1772.0,118
20707,1604,1848,1.0,1726.0,-244
20708,1797,1893,1.0,1845.0,-96
20709,1689,1531,1.0,1610.0,158
20710,1803,1729,0.0,1766.0,74
20711,1725,1556,0.0,1640.5,169
20712,1859,1701,1.0,1780.0,158
20713,1617,1643,1.0,1630.0,-26
20714,1779,1719,0.0,1749.0,60
20715,1611,1777,0.0,1694.0,-166
20716,1670,1817,0.0,1743.5,-147
20717,2159,1623,1.0,1891.0,536
20718,1510,1704,1.0,1607.0,-194
20719,2348,2557,0.0,2452.5,-209
20720,2500,2261,1.0,2380.5,239
20721,2339,2374,1.0,2356.5,-35
20722,2338,2241,0.0,2289.5,97
20723,2402,2438,1.0,2420.0,-36
20724,2358,2253,1.0,2305.5,105
20725,2308,2326,0.0,2317.0,-18
20726,2355,2161,1.0,2258.0,194
20727,2462,2368,0.5,2415.0,94
20728,2347,2278,1.0,2312.5,69
20729,2172,2323,0.0,2247.5,-151
20730,2161,1980,1.0,2070.5,181
20731,2394,2555,0.5,2474.5,-161
20732,2533,2374,1.0,2453.5,159
20733,2328,2403,0.5,2365.5,-75
20734,2405,2157,1.0,2281.0,248
20735,2415,2561,0.0,2488.0,-146
20736,2464,2281,1.0,2372.5,183
20737,2243,2446,0.0,2344.5,-203
20738,2468,2294,0.5,2381.0,174
20739,2447,2424,1.0,2435.5,23
20740,2407,2345,0.5,2376.0,62
20741,2287,2347,0.5,2317.0,-60
20742,2305,2096,1.0,2200.5,209
20743,2252,2409,0.0,2330.5,-157
20744,2384,2393,0.5,2388.5,-9
20745,2260,2331,0.0,2295.5,-71
20746,2289,2194,1.0,2241.5,95
20747,2350,2423,0.5,2386.5,-73
20748,2370,2249,0.5,2309.5,121
20749,2219,2321,0.0,2270.0,-102
20750,2260,2215,0.0,2237.5,45
20751,2391,2404,1.0,2397.5,-13
20752,2329,2317,0.5,2323.0,12
20753,2325,2362,0.0,2343.5,-37
20754,2235,2301,0.5,2268.0,-66
20755,2303,2267,0.5,2285.0,36
20756,2321,2295,0.5,2308.0,26
20757,2231,2294,0.0,2262.5,-63
20758,2168,2276,0.5,2222.0,-108
20759,2288,2431,0.0,2359.5,-143
20760,2254,2290,0.5,2272.0,-36
20761,2268,2261,0.0,2264.5,7
20762,2135,2198,1.0,2166.5,-63
20763,2480,2509,0.5,2494.5,-29
20764,2482,2414,1.0,2448.0,68
20765,2390,2469,0.5,2429.5,-79
20766,2404,2389,0.5,2396.5,15
20767,2431,2225,0.5,2328.0,206
20768,2207,2423,0.0,2315.0,-216
20769,2311,2144,0.0,2227.5,167
20770,2128,2268,0.0,2198.0,-140
20771,2299,2367,0.5,2333.0,-68
20772,2345,2254,0.0,2299.5,91
20773,2185,2275,1.0,2230.0,-90
20774,2260,2116,1.0,2188.0,144
20775,2422,2404,0.5,2413.0,18
20776,2188,2149,0.0,2168.5,39
20777,2123,2167,0.5,2145.0,-44
20778,2040,2367,0.5,2203.5,-327
20779,2369,2244,1.0,2306.5,125
20780,2227,2202,0.5,2214.5,25
20781,2265,2152,1.0,2208.5,113
20782,1968,2167,0.5,2067.5,-199
20783,2513,2375,0.5,2444.0,138
20784,2313,2348,0.5,2330.5,-35
20785,2355,2288,1.0,2321.5,67
20786,2258,2370,1.0,2314.0,-112
20787,2259,2391,0.5,2325.0,-132
20788,2151,2224,0.5,2187.5,-73
20789,2134,2222,1.0,2178.0,-88
20790,2034,2112,0.5,2073.0,-78
20791,2268,2474,0.5,2371.0,-206
20792,2482,2218,0.5,2350.0,264
20793,2081,2394,0.0,2237.5,-313
20794,2263,2064,0.0,2163.5,199
20795,2313,2255,1.0,2284.0,58
20796,2174,1931,0.5,2052.5,243
20797,1911,2110,1.0,2010.5,-199
20798,2063,1876,0.0,1969.5,187
20799,2137,2287,0.0,2212.0,-150
20800,2157,2033,0.5,2095.0,124
20801,2023,2113,0.5,2068.0,-90
20802,2080,1956,1.0,2018.0,124
20803,2220,2254,0.0,2237.0,-34
20804,2167,2058,1.0,2112.5,109
20805,1998,2009,0.0,2003.5,-11
20806,2118,1894,0.5,2006.0,224
20807,2035,2157,0.0,2096.0,-122
20808,2136,2037,0.0,2086.5,99
20809,2031,2020,0.0,2025.5,11
20810,1946,1935,0.5,1940.5,11
20811,2044,2098,0.5,2071.0,-54
20812,2075,2010,1.0,2042.5,65
20813,1948,1950,0.0,1949.0,-2
20814,1909,1919,1.0,1914.0,-10
20815,2057,2082,0.0,2069.5,-25
20816,2052,2106,1.0,2079.0,-54
20817,2026,1961,0.5,1993.5,65
20818,1763,1856,0.5,1809.5,-93
20819,2152,2068,1.0,2110.0,84
20820,1870,2022,0.5,1946.0,-152
20821,1974,1924,1.0,1949.0,50
20822,1890,1909,0.0,1899.5,-19
20823,2559,2054,1.0,2306.5,505
20824,2005,2535,0.0,2270.0,-530
20825,2528,1943,1.0,2235.5,585
20826,1866,2462,0.0,2164.0,-596
20827,2053,2248,0.0,2150.5,-195
20828,2191,2013,1.0,2102.0,178
20829,1940,2298,0.5,2119.0,-358
20830,2188,1788,1.0,1988.0,400
20831,1943,2195,0.5,2069.0,-252
20832,2170,1869,1.0,2019.5,301
20833,1925,2175,0.0,2050.0,-250
20834,2118,1926,1.0,2022.0,192
20835,2271,2320,1.0,2295.5,-49
20836,2158,1872,0.5,2015.0,286
20837,1724,2102,0.0,1913.0,-378
20838,2113,1526,1.0,1819.5,587
20839,1966,2211,0.5,2088.5,-245
20840,1981,1872,0.5,1926.5,109
20841,1801,1945,0.0,1873.0,-144
20842,1724,1725,0.5,1724.5,-1
20843,2267,2214,1.0,2240.5,53
20844,1984,2172,0.0,2078.0,-188
20845,2113,1772,1.0,1942.5,341
20846,1357,2146,0.0,1751.5,-789
20847,2266,1942,1.0,2104.0,324
20848,1899,2124,0.0,2011.5,-225
20849,2156,1790,1.0,1973.0,366
20850,1727,2051,0.5,1889.0,-324
20851,1953,2157,0.0,2055.0,-204
20852,2143,1853,1.0,1998.0,290
20853,1924,2137,0.0,2030.5,-213
20854,2060,1813,1.0,1936.5,247
20855,2130,1647,1.0,1888.5,483
20856,1712,1960,0.0,1836.0,-248
20857,1946,1926,0.5,1936.0,20
20858,1979,1862,1.0,1920.5,117
20859,2056,1960,0.5,2008.0,96
20860,1727,2056,0.0,1891.5,-329
20861,1862,1716,1.0,1789.0,146
20862,1655,1854,0.0,1754.5,-199
20863,2345,1810,1.0,2077.5,535
20864,1748,1923,0.5,1835.5,-175
20865,1924,1815,0.0,1869.5,109
20866,1755,1488,0.0,1621.5,267
20867,1888,1813,0.5,1850.5,75
20868,1785,1996,1.0,1890.5,-211
20869,1922,1764,0.5,1843.0,158
20870,1655,1718,1.0,1686.5,-63
20871,1909,1929,0.5,1919.0,-20
20872,1833,1774,0.5,1803.5,59
20873,1460,1785,1.0,1622.5,-325
20874,1633,1494,0.0,1563.5,139
20875,1945,2024,0.0,1984.5,-79
20876,1877,1713,1.0,1795.0,164
20877,1655,1770,0.0,1712.5,-115
20878,1572,1605,1.0,1588.5,-33
20879,1546,1779,0.0,1662.5,-233
20880,1719,1378,0.0,1548.5,341
20881,1585,1611,0.5,1598.0,-26
20882,1777,1575,0.0,1676.0,202
20883,2159,1739,1.0,1949.0,420
20884,1822,1954,0.5,1888.0,-132
20885,2034,1755,1.0,1894.5,279
20886,1698,1750,0.0,1724.0,-52
20887,1831,2283,0.0,2057.0,-452
20888,2004,1848,0.0,1926.0,156
20889,1705,1819,0.5,1762.0,-114
20890,1731,1515,1.0,1623.0,216
20891,1893,2113,0.0,2003.0,-220
20892,1898,1797,1.0,1847.5,101
20893,1408,1651,1.0,1529.5,-243
20894,1600,1689,0.5,1644.5,-89
20895,1803,2029,0.0,1916.0,-226
20896,1961,1729,0.0,1845.0,232
20897,1725,1926,0.5,1825.5,-201
20898,1760,1652,0.5,1706.0,108
20899,2090,1693,1.0,1891.5,397
20900,1701,2038,0.0,1869.5,-337
20901,1840,1859,1.0,1849.5,-19
20902,1617,1685,0.0,1651.0,-68
20903,1726,1881,0.5,1803.5,-155
20904,1871,1708,0.0,1789.5,163
20905,1795,1853,1.0,1824.0,-58
20906,1830,1797,1.0,1813.5,33
20907,1788,1933,0.5,1860.5,-145
20908,1780,1683,1.0,1731.5,97
20909,1559,1707,0.0,1633.0,-148
20910,1733,1414,1.0,1573.5,319
20911,1767,1778,0.0,1772.5,-11
20912,1702,1607,1.0,1654.5,95
20913,1509,1713,0.5,1611.0,-204
20914,1741,1734,1.0,1737.5,7
20915,1962,1863,0.0,1912.5,99
20916,1712,1712,0.5,1712.0,0
20917,1727,1582,0.0,1654.5,145
20918,1446,1598,0.0,1522.0,-152
20919,1637,2188,0.0,1912.5,-551
20920,2143,1581,1.0,1862.0,562
20921,1415,1849,0.0,1632.0,-434
20922,1635,1512,1.0,1573.5,123
20923,2159,2064,0.5,2111.5,95
20924,2020,1704,1.0,1862.0,316
20925,1510,1751,0.0,1630.5,-241
20926,1687,1397,1.0,1542.0,290
20927,2184,1817,1.0,2000.5,367
20928,1708,2181,0.0,1944.5,-473
20929,2136,1623,1.0,1879.5,513
20930,2126,1947,1.0,2036.5,179
20931,2013,2110,1.0,2061.5,-97
20932,1718,2009,1.0,1863.5,-291
20933,1070,1577,0.0,1323.5,-507
20934,1626,1117,1.0,1371.5,509
20935,1053,1528,1.0,1290.5,-475
20936,2050,2079,0.0,2064.5,-29
20937,1456,1727,0.0,1591.5,-271
20938,1793,1671,0.0,1732.0,122
20939,1745,1702,0.0,1723.5,43
20940,1573,1619,0.0,1596.0,-46
20941,1503,1482,0.5,1492.5,21
20942,1502,1502,0.5,1502.0,0
20943,1479,1412,0.0,1445.5,67
20944,1206,1518,0.0,1362.0,-312
20945,1667,1483,1.0,1575.0,184
20946,1544,1620,0.0,1582.0,-76
20947,1378,1408,1.0,1393.0,-30
20948,1365,1340,1.0,1352.5,25
20949,1595,1451,0.0,1523.0,144
20950,1346,1475,1.0,1410.5,-129
20951,1559,1105,0.0,1332.0,454
20952,1468,1439,1.0,1453.5,29
20953,1241,1246,1.0,1243.5,-5
20954,1518,1174,0.0,1346.0,344
20955,1668,1034,1.0,1351.0,634
20956,1458,1660,0.0,1559.0,-202
20957,1540,1374,0.5,1457.0,166
20958,1173,1442,0.0,1307.5,-269
20959,1372,1666,0.0,1519.0,-294
20960,1755,1239,1.0,1497.0,516
20961,1053,1492,0.0,1272.5,-439
20962,1263,1673,1.0,1468.0,-410
20963,1598,1138,1.0,1368.0,460
20964,1499,1481,1.0,1490.0,18
20965,1568,1397,1.0,1482.5,171
20966,1446,1471,1.0,1458.5,-25
20967,1739,1407,1.0,1573.0,332
20968,1123,1365,1.0,1244.0,-242
20969,1284,1326,1.0,1305.0,-42
20970,1217,1182,0.5,1199.5,35
20971,2082,1752,0.0,1917.0,330
20972,1451,1720,1.0,1585.5,-269
20973,1683,1545,1.0,1614.0,138
20974,1425,1274,0.0,1349.5,151
20975,1505,1884,1.0,1694.5,-379
20976,1671,1357,1.0,1514.0,314
20977,1601,1840,0.0,1720.5,-239
20978,1719,1608,0.0,1663.5,111
20979,1446,1414,0.0,1430.0,32
20980,1584,1537,0.0,1560.5,47
20981,2561,2369,1.0,2465.0,192
20982,2202,2464,0.0,2333.0,-262
20983,2446,2265,0.5,2355.5,181
20984,2124,2468,0.5,2296.0,-344
20985,2421,2409,0.0,2415.0,12
20986,2384,2267,1.0,2325.5,117
20987,2321,2331,1.0,2326.0,-10
20988,2289,2294,0.5,2291.5,-5
20989,2431,2422,0.5,2426.5,9
20990,2377,2254,1.0,2315.5,123
20991,2261,2149,0.0,2205.0,112
20992,2367,2135,1.0,2251.0,232
20993,2368,2509,0.0,2438.5,-141
20994,2475,2347,0.5,2411.0,128
20995,2323,2482,0.0,2402.5,-159
20996,2404,2244,0.5,2324.0,160
20997,2438,2431,0.0,2434.5,7
20998,2423,2358,1.0,2390.5,65
20999,2326,2361,1.0,2343.5,-35
21000,2268,2355,0.5,2311.5,-87
21001,2555,2299,1.0,2427.0,256
21002,2254,2533,0.0,2393.5,-279
21003,2451,2185,1.0,2318.0,266
21004,2148,2405,0.0,2276.5,-257
21005,2423,2391,1.0,2407.0,32
21006,2325,2370,1.0,2347.5,-45
21007,2321,2301,0.0,2311.0,20
21008,2255,2258,0.5,2256.5,-3
21009,2557,2446,0.5,2501.5,111
21010,2424,2500,0.0,2462.0,-76
21011,2400,2347,1.0,2373.5,53
21012,2305,2374,0.5,2339.5,-69
21013,2447,2261,0.5,2354.0,186
21014,2339,2345,0.5,2342.0,-6
21015,2287,2241,0.5,2264.0,46
21016,2170,2108,0.0,2139.0,62
21017,2313,2259,0.5,2286.0,54
21018,2330,2081,0.5,2205.5,249
21019,1911,2224,0.0,2067.5,-313
21020,2112,1876,1.0,1994.0,236
21021,2404,2350,0.0,2377.0,54
21022,2249,2329,1.0,2289.0,-80
21023,2362,2215,0.5,2288.5,147
21024,2186,2192,0.0,2189.0,-6
21025,2375,2559,0.5,2467.0,-184
21026,2528,2313,1.0,2420.5,215
21027,2288,2469,0.5,2378.5,-181
21028,2462,2258,1.0,2360.0,204
21029,2064,2295,0.0,2179.5,-231
21030,2248,2020,1.0,2134.0,228
21031,1751,2231,0.0,1991.0,-480
21032,2276,1687,1.0,1981.5,589
21033,2404,2139,0.5,2271.5,265
21034,2098,2167,0.5,2132.5,-69
21035,2114,2075,1.0,2094.5,39
21036,1950,2040,0.5,1995.0,-90
21037,2394,2079,0.5,2236.5,315
21038,2110,2374,0.0,2242.0,-264
21039,2328,2013,0.5,2170.5,315
21040,2009,1933,0.0,1971.0,76
21041,2480,2267,0.5,2373.5,213
21042,2204,2390,0.0,2297.0,-186
21043,2389,2172,0.5,2280.5,217
21044,2146,2237,1.0,2191.5,-91
21045,2474,2157,1.0,2315.5,317
21046,2137,2482,0.0,2309.5,-345
21047,2394,2101,1.0,2247.5,293
21048,2060,2125,0.0,2092.5,-65
21049,2367,2184,0.0,2275.5,183
21050,2136,2345,0.0,2240.5,-209
21051,2339,2059,1.0,2199.0,280
21052,1947,2260,0.0,2103.5,-313
21053,2207,1649,1.0,1928.0,558
21054,1726,2144,0.0,1935.0,-418
21055,2134,1795,1.0,1964.5,339
21056,1797,2128,0.0,1962.5,-331
21057,1678,2513,0.0,2095.5,-835
21058,2348,1785,1.0,2066.5,563
21059,1764,2355,1.0,2059.5,-591
21060,2274,1655,1.0,1964.5,619
21061,2254,2462,0.0,2358.0,-208
21062,2278,2167,1.0,2222.5,111
21063,2009,2172,0.0,2090.5,-163
21064,1840,2118,1.0,1979.0,-278
21065,1772,2402,0.0,2087.0,-630
21066,2253,1702,1.0,1977.5,551
21067,1713,2308,0.0,2010.5,-595
21068,2112,1741,1.0,1926.5,371
21069,1909,2218,0.0,2063.5,-309
21070,2123,1490,1.0,1806.5,633
21071,1460,2081,0.0,1770.5,-621
21072,2064,1494,1.0,1779.0,570
21073,2287,2288,0.5,2287.5,-1
21074,2290,2157,1.0,2223.5,133
21075,2113,2268,1.0,2190.5,-155
21076,2060,2102,0.0,2081.0,-42
21077,2320,2152,1.0,2236.0,168
21078,2022,2158,0.0,2090.0,-136
21079,2102,1974,0.5,2038.0,128
21080,1909,2113,0.0,2011.0,-204
21081,2248,2345,0.0,2296.5,-97
21082,1923,2191,0.5,2057.0,-268
21083,2227,1655,1.0,1941.0,572
21084,1488,2188,0.0,1838.0,-700
21085,2195,2024,1.0,2109.5,171
21086,1877,2170,0.0,2023.5,-293
21087,2175,1770,1.0,1972.5,405
21088,1572,2118,0.0,1845.0,-546
21089,2244,2082,1.0,2163.0,162
21090,2052,2227,0.0,2139.5,-175
21091,1968,1961,1.0,1964.5,7
21092,1806,1805,0.0,1805.5,1
21093,2157,1718,1.0,1937.5,439
21094,1626,2129,0.0,1877.5,-503
21095,2020,1528,1.0,1774.0,492
21096,1577,1946,0.0,1761.5,-369
21097,2056,2113,0.5,2084.5,-57
21098,1898,2056,1.0,1977.0,-158
21099,1862,1651,0.0,1756.5,211
21100,1600,1901,0.5,1750.5,-301
21101,1666,1872,0.5,1769.0,-206
21102,1801,1755,1.0,1778.0,46
21103,1492,1725,0.0,1608.5,-233
21104,1353,1318,0.0,1335.5,35
21105,2214,1893,1.0,2053.5,321
21106,1408,1799,1.0,1603.5,-391
21107,1772,1531,0.5,1651.5,241
21108,1689,1357,1.0,1523.0,332
21109,2211,2415,0.0,2313.0,-204
21110,2281,1981,0.5,2131.0,300
21111,1945,2243,0.0,2094.0,-298
21112,2239,1900,1.0,2069.5,339
21113,2130,2393,0.0,2261.5,-263
21114,2260,1960,1.0,2110.0,300
21115,1946,2194,0.5,2070.0,-248
21116,2149,1921,0.5,2035.0,228
21117,1933,2090,1.0,2011.5,-157
21118,2038,1780,1.0,1909.0,258
21119,1707,1840,0.0,1773.5,-133
21120,1685,1664,0.5,1674.5,21
21121,2283,2266,0.5,2274.5,17
21122,2124,1986,0.0,2055.0,138
21123,2004,2156,0.0,2080.0,-152
21124,2026,1731,1.0,1878.5,295
21125,2188,1546,0.5,1867.0,642
21126,1378,2143,0.0,1760.5,-765
21127,1849,1585,1.0,1717.0,264
21128,1575,1635,0.0,1605.0,-60
21129,1863,2159,0.0,2011.0,-296
21130,1954,1582,1.0,1768.0,372
21131,1446,2034,0.0,1740.0,-588
21132,1750,1388,1.0,1569.0,362
21133,2391,1729,1.0,2060.0,662
21134,1725,2151,0.0,1938.0,-426
21135,2039,1652,1.0,1845.5,387
21136,1556,2034,0.0,1795.0,-478
21137,2030,2029,0.5,2029.5,1
21138,1961,1727,1.0,1844.0,234
21139,1793,1874,0.0,1833.5,-81
21140,1760,1671,0.5,1715.5,89
21141,2255,2057,1.0,2156.0,198
21142,2026,2174,0.5,2100.0,-148
21143,2110,1856,1.0,1983.0,254
21144,1966,2037,1.0,2001.5,-71
21145,1739,1745,1.0,1742.0,-6
21146,1702,1702,1.0,1702.0,0
21147,1822,1573,1.0,1697.5,249
21148,1419,1698,0.0,1558.5,-279
21149,1929,1568,1.0,1748.5,361
21150,1471,1809,0.0,1640.0,-338
21151,1785,1446,1.0,1615.5,339
21152,1407,1633,0.0,1520.0,-226
21153,1713,1888,0.5,1800.5,-175
21154,1626,1655,0.0,1640.5,-29
21155,1605,1996,0.0,1800.5,-391
21156,1922,1533,1.0,1727.5,389
21157,2035,2159,0.0,2097.0,-124
21158,1704,2037,1.0,1870.5,-333
21159,1935,1510,1.0,1722.5,425
21160,1397,1710,0.0,1553.5,-313
21161,1779,1872,0.5,1825.5,-93
21162,1812,1719,0.0,1765.5,93
21163,1777,1724,0.5,1750.5,53
21164,1526,1593,1.0,1559.5,-67
21165,1647,1739,1.0,1693.0,-92
21166,1365,1676,0.0,1520.5,-311
21167,1712,1123,1.0,1417.5,589
21168,1810,1979,1.0,1894.5,-169
21169,1815,1748,1.0,1781.5,67
21170,2054,1765,1.0,1909.5,289
21171,1848,1831,1.0,1839.5,17
21172,1869,2005,1.0,1937.0,-136
21173,1705,1604,0.0,1654.5,101
21174,1693,1866,1.0,1779.5,-173
21175,1881,1902,0.0,1891.5,-21
21176,1643,1701,1.0,1672.0,-58
21177,1830,1871,0.0,1850.5,-41
21178,1439,1617,0.0,1528.0,-178
21179,1736,1962,1.0,1849.0,-226
21180,1246,1334,0.0,1290.0,-88
21181,1598,1727,1.0,1662.5,-129
21182,1821,1241,1.0,1531.0,580
21183,1505,1767,0.0,1636.0,-262
21184,1660,1668,0.0,1664.0,-8
21185,1734,1509,1.0,1621.5,225
21186,2137,1442,0.0,1789.5,695
21187,1853,1953,0.5,1903.0,-100
21188,2033,2044,1.0,2038.5,-11
21189,1813,1924,1.0,1868.5,-111
21190,1840,1956,1.0,1898.0,-116
21191,1735,1683,0.5,1709.0,52
21192,1608,1719,1.0,1663.5,-111
21193,1414,1559,0.5,1486.5,-145
21194,1817,1535,0.5,1676.0,282
21195,1869,1943,1.0,1906.0,-74
21196,1623,1670,0.0,1646.5,-47
21197,1907,1925,0.5,1916.0,-18
21198,1667,2044,0.5,1855.5,-377
21199,2010,1620,0.5,1815.0,390
21200,1495,1948,0.0,1721.5,-453
21201,1919,1378,1.0,1648.5,541
21202,1414,2220,0.0,1817.0,-806
21203,1998,1537,0.0,1767.5,461
21204,1704,1894,0.0,1799.0,-190
21205,1809,1411,1.0,1610.0,398
21206,1942,1884,0.5,1913.0,58
21207,1505,1932,0.0,1718.5,-427
21208,1790,1583,1.0,1686.5,207
21209,1601,1727,0.0,1664.0,-126
21210,1960,1637,1.0,1798.5,323
21211,1581,1716,0.0,1648.5,-135
21212,1791,1415,0.0,1603.0,376
21213,1512,1655,1.0,1583.5,-143
21214,2008,1174,1.0,1591.0,834
21215,1350,2068,0.0,1709.0,-718
21216,1870,1267,1.0,1568.5,603
21217,1306,1890,0.0,1598.0,-584
21218,1326,2013,0.0,1669.5,-687
21219,1771,1284,1.0,1527.5,487
21220,1222,1940,0.0,1581.0,-718
21221,1788,1137,1.0,1462.5,651
21222,1482,1502,0.5,1492.0,-20
21223,1206,1551,0.0,1378.5,-345
21224,1720,2082,1.0,1901.0,-362
21225,1117,1070,0.0,1093.5,47
21226,1274,1274,0.5,1274.0,0
21227,2079,1053,1.0,1566.0,1026
21228,1595,1456,1.0,1525.5,139
21229,1432,1451,1.0,1441.5,-19
21230,1452,1475,1.0,1463.5,-23
21231,1476,1559,0.0,1517.5,-83
21232,1105,1437,0.0,1271.0,-332
21233,1263,1673,0.0,1468.0,-410
21234,1475,1481,0.0,1478.0,-6
21235,1752,1503,1.0,1627.5,249
21236,1502,1451,1.0,1476.5,51
21237,1379,1518,0.0,1448.5,-139
21238,1364,1545,0.0,1454.5,-181
21239,1467,1671,0.0,1569.0,-204
21240,1483,1372,1.0,1427.5,111
21241,1362,1508,0.5,1435.0,-146
21242,1408,1239,0.0,1323.5,169
21243,1053,1365,0.0,1209.0,-312
21244,1458,1062,1.0,1260.0,396
21245,1173,1374,1.0,1273.5,-201
21246,2409,2561,0.5,2485.0,-152
21247,2464,2384,0.0,2424.0,80
21248,2331,2446,0.5,2388.5,-115
21249,2468,2289,1.0,2378.5,179
21250,2431,2422,1.0,2426.5,9
21251,2377,2423,0.0,2400.0,-46
21252,2311,2123,0.5,2217.0,188
21253,2367,2268,0.0,2317.5,99
21254,2509,2555,0.5,2532.0,-46
21255,2533,2475,0.5,2504.0,58
21256,2482,2451,0.0,2466.5,31
21257,2403,2469,0.0,2436.0,-66
21258,2350,2557,0.0,2453.5,-207
21259,2500,2249,0.5,2374.5,251
21260,2219,2400,0.0,2309.5,-181
21261,2374,2215,1.0,2294.5,159
21262,2391,2447,1.0,2419.0,-56
21263,2345,2317,0.5,2331.0,28
21264,2325,2287,1.0,2306.0,38
21265,2096,2301,0.0,2198.5,-205
21266,2303,2259,1.0,2281.0,44
21267,2330,2295,0.5,2312.5,35
21268,2248,2134,0.5,2191.0,114
21269,2112,2231,0.5,2171.5,-119
21270,2252,2358,0.5,2305.0,-106
21271,2326,2393,1.0,2359.5,-67
21272,2260,2355,0.5,2307.5,-95
21273,2320,2149,1.0,2234.5,171
21274,2090,2225,0.5,2157.5,-135
21275,2144,2038,1.0,2091.0,106
21276,1840,2134,0.5,1987.0,-294
21277,2128,1685,1.0,1906.5,443
21278,2431,2368,1.0,2399.5,63
21279,2347,2261,0.5,2304.0,86
21280,2135,2323,1.0,2229.0,-188
21281,2244,2101,1.0,2172.5,143
21282,2159,2421,0.5,2290.0,-262
21283,2321,1954,1.0,2137.5,367
21284,2034,2294,0.0,2164.0,-260
21285,2168,1750,1.0,1959.0,418
21286,2268,2266,1.0,2267.0,2
21287,2156,2218,0.5,2187.0,-62
21288,2123,2051,0.5,2087.0,72
21289,2026,2064,0.5,2045.0,-38
21290,2369,2157,1.0,2263.0,212
21291,2136,2265,0.5,2200.5,-129
21292,2167,2129,1.0,2148.0,38
21293,2020,2124,0.0,2072.0,-104
21294,2248,2394,0.5,2321.0,-146
21295,2374,2227,1.0,2300.5,147
21296,2298,2328,0.5,2313.0,-30
21297,1933,2188,0.5,2060.5,-255
21298,2559,2513,1.0,2536.0,46
21299,2348,2535,0.0,2441.5,-187
21300,2528,2355,1.0,2441.5,173
21301,2370,2462,0.5,2416.0,-92
21302,2402,2287,1.0,2344.5,115
21303,2157,2253,0.0,2205.0,-96
21304,2161,2113,0.0,2137.0,48
21305,2080,2112,1.0,2096.0,-32
21306,2474,2404,1.0,2439.0,70
21307,2188,2482,1.0,2335.0,-294
21308,2394,2167,1.0,2280.5,227
21309,2114,2263,0.0,2188.5,-149
21310,2113,2345,0.5,2229.0,-232
21311,2339,1898,0.5,2118.5,441
21312,1651,2275,0.0,1963.0,-624
21313,2260,1600,1.0,1930.0,660
21314,2462,2195,1.0,2328.5,267
21315,2170,2278,0.5,2224.0,-108
21316,2172,2175,1.0,2173.5,-3
21317,2118,1840,1.0,1979.0,278
21318,2415,2320,0.5,2367.5,95
21319,2158,2243,0.0,2200.5,-85
21320,2294,2102,1.0,2198.0,192
21321,2113,2239,0.0,2176.0,-126
21322,2188,2244,1.0,2216.0,-56
21323,2227,2143,0.0,2185.0,84
21324,1849,2152,0.5,2000.5,-303
21325,1968,1635,1.0,1801.5,333
21326,2299,2391,0.0,2345.0,-92
21327,2151,2254,1.0,2202.5,-103
21328,2185,2039,1.0,2112.0,146
21329,2222,2148,1.0,2185.0,74
21330,2446,2267,1.0,2356.5,179
21331,2172,2424,0.0,2298.0,-252
21332,2407,2113,0.0,2260.0,294
21333,2146,2305,1.0,2225.5,-159
21334,2348,2480,0.5,2414.0,-132
21335,2414,2339,0.0,2376.5,75
21336,2241,2390,0.0,2315.5,-149
21337,2237,2170,0.0,2203.5,67
21338,2255,2404,0.0,2329.5,-149
21339,2362,2174,1.0,2268.0,188
21340,2110,2235,0.0,2172.5,-125
21341,2192,2063,1.0,2127.5,129
21342,2029,2313,0.0,2171.0,-284
21343,2081,1961,0.5,2021.0,120
21344,1926,1931,0.0,1928.5,-5
21345,1876,1874,0.5,1875.0,2
21346,2375,2423,0.0,2399.0,-48
21347,2370,2313,0.5,2341.5,57
21348,2258,2258,1.0,2258.0,0
21349,2260,2151,1.0,2205.5,109
21350,2098,1942,1.0,2020.0,156
21351,1932,2075,0.0,2003.5,-143
21352,1950,1899,0.5,1924.5,51
21353,1727,1909,0.0,1818.0,-182
21354,2288,1546,1.0,1917.0,742
21355,1378,2290,0.0,1834.0,-912
21356,2198,1585,1.0,1891.5,613
21357,1575,2060,0.0,1817.5,-485
21358,2345,1739,1.0,2042.0,606
21359,1822,1923,1.0,1872.5,-101
21360,1924,1755,1.0,1839.5,169
21361,1698,1655,0.5,1676.5,43
21362,1888,1909,0.5,1898.5,-21
21363,1774,1996,0.5,1885.0,-222
21364,1922,1490,0.0,1706.0,432
21365,1494,1718,0.5,1606.0,-224
21366,1966,2056,0.0,2011.0,-90
21367,2056,1801,0.0,1928.5,255
21368,1725,1862,0.5,1793.5,-137
21369,1854,1353,1.0,1603.5,501
21370,1502,1984,0.0,1743.0,-482
21371,1799,1479,1.0,1639.0,320
21372,1518,1772,0.0,1645.0,-254
21373,1357,1364,1.0,1360.5,-7
21374,2022,2064,0.5,2043.0,-42
21375,2020,1974,0.0,1997.0,46
21376,1909,1751,0.5,1830.0,158
21377,1687,1838,0.0,1762.5,-151
21378,2054,2130,1.0,2092.0,-76
21379,1946,1943,0.0,1944.5,3
21380,1869,1921,1.0,1895.0,-52
21381,1862,1866,0.0,1864.0,-4
21382,2044,2254,0.5,2149.0,-210
21383,2167,1948,1.0,2057.5,219
21384,1919,2114,0.5,2016.5,-195
21385,2118,1334,0.5,1726.0,784
21386,1813,1929,0.5,1871.0,-116
21387,1833,1785,0.5,1809.0,48
21388,1764,1809,1.0,1786.5,-45
21389,1785,1655,1.0,1720.0,130
21390,2157,1943,1.0,2050.0,214
21391,1869,2143,0.5,2006.0,-274
21392,2101,1925,1.0,2013.0,176
21393,1926,2060,1.0,1993.0,-134
21394,2082,2283,0.0,2182.5,-201
21395,1986,2052,0.5,2019.0,-66
21396,1806,2004,0.0,1905.0,-198
21397,1819,1763,1.0,1791.0,56
21398,1712,2211,0.0,1961.5,-499
21399,1945,1582,1.0,1763.5,363
21400,1446,1900,0.0,1673.0,-454
21401,1724,1388,1.0,1556.0,336
21402,1693,1810,0.5,1751.5,-117
21403,1748,1701,0.0,1724.5,47
21404,1859,1815,0.5,1837.0,44
21405,1765,1643,0.5,1704.0,122
21406,1933,1840,1.0,1886.5,93
21407,1719,1780,0.0,1749.5,-61
21408,1733,1608,0.5,1670.5,125
21409,1446,1664,0.0,1555.0,-218
21410,1962,1953,0.0,1957.5,9
21411,1853,1736,0.5,1794.5,117
21412,1712,1924,0.0,1818.0,-212
21413,1813,1598,1.0,1705.5,215
21414,1893,1676,1.0,1784.5,217
21415,1712,1797,1.0,1754.5,-85
21416,1408,1926,0.0,1667.0,-518
21417,1979,1689,1.0,1834.0,290
21418,2220,2126,1.0,2173.0,94
21419,2079,2058,1.0,2068.5,21
21420,1894,2013,0.5,1953.5,-119
21421,2009,1809,0.0,1909.0,200
21422,2024,2184,0.0,2104.0,-160
21423,2181,1877,1.0,2029.0,304
21424,1770,2136,0.0,1953.0,-366
21425,2059,1594,1.0,1826.5,465
21426,2053,1772,1.0,1912.5,281
21427,1778,2013,0.0,1895.5,-235
21428,1771,1702,1.0,1736.5,69
21429,1741,1940,0.5,1840.5,-199
21430,1649,2008,0.0,1828.5,-359
21431,2068,1708,0.0,1888.0,360
21432,1795,1870,0.0,1832.5,-75
21433,1924,1797,0.0,1860.5,127
21434,1718,2035,0.5,1876.5,-317
21435,2031,1577,1.0,1804.0,454
21436,1626,1935,0.5,1780.5,-309
21437,1710,1577,1.0,1643.5,133
21438,1673,2050,0.0,1861.5,-377
21439,2030,1598,1.0,1814.0,432
21440,1475,1793,0.0,1634.0,-318
21441,1671,1481,1.0,1576.0,190
21442,1607,1803,0.0,1705.0,-196
21443,1729,1505,1.0,1617.0,224
21444,1509,1652,0.0,1580.5,-143
21445,1556,1734,0.0,1645.0,-178
21446,2271,1821,1.0,2046.0,450
21447,1668,1812,0.5,1740.0,-144
21448,1724,1660,1.0,1692.0,64
21449,1540,1526,1.0,1533.0,14
21450,1437,1779,0.0,1608.0,-342
21451,1719,1263,1.0,1491.0,456
21452,1777,1611,1.0,1694.0,166
21453,2082,1637,1.0,1859.5,445
21454,1581,1720,0.0,1650.5,-139
21455,1683,1581,1.0,1632.0,102
21456,1415,1274,1.0,1344.5,141
21457,2159,1452,1.0,1805.5,707
21458,1510,1704,0.0,1607.0,-194
21459,1482,1397,0.0,1439.5,85
21460,1716,1727,1.0,1721.5,-11
21461,1412,1502,0.0,1457.0,-90
21462,1655,1791,1.0,1723.0,-136
21463,1400,1306,0.0,1353.0,94
21464,2106,2057,1.0,2081.5,49
21465,1595,1856,1.0,1725.5,-261
21466,1966,1432,1.0,1699.0,534
21467,1739,1745,1.0,1742.0,-6
21468,1702,1365,1.0,1533.5,337
21469,1123,1619,0.0,1371.0,-496
21470,1034,2044,0.0,1539.0,-1010
21471,2033,1062,1.0,1547.5,971
21472,1374,2023,0.0,1698.5,-649
21473,1956,1173,1.0,1564.5,783
21474,1308,1945,0.0,1626.5,-637
21475,1713,1655,0.0,1684.0,58
21476,1533,1831,0.0,1682.0,-298
21477,1551,1604,0.0,1577.5,-53
21478,1884,1666,0.5,1775.0,218
21479,1492,1505,0.0,1498.5,-13
21480,1583,1402,1.0,1492.5,181
21481,1318,1601,0.5,1459.5,-283
21482,1788,1735,0.0,1761.5,53
21483,1559,1217,1.0,1388.0,342
21484,1284,1414,0.0,1349.0,-130
21485,1620,1667,1.0,1643.5,-47
21486,1182,1222,1.0,1202.0,-40
21487,1340,1378,0.0,1359.0,-38
21488,1902,1137,0.0,1519.5,765
21489,1379,1752,1.0,1565.5,-373
21490,1853,1881,0.5,1867.0,-28
21491,1425,1545,0.0,1485.0,-120
21492,1708,1817,1.0,1762.5,-109
21493,1467,1670,0.0,1568.5,-203
21494,1544,1483,1.0,1513.5,61
21495,1365,1508,1.0,1436.5,-143
21496,1518,1584,1.0,1551.0,-66
21497,1537,1350,1.0,1443.5,187
21498,1267,1704,0.0,1485.5,-437
21499,1411,1306,0.0,1358.5,105
21500,1568,1334,1.0,1451.0,234
21501,1468,1471,1.0,1469.5,-3
21502,1446,1246,1.0,1346.0,200
21503,1241,1322,0.0,1281.5,-81
21504,2079,1355,1.0,1717.0,724
21505,1117,1070,1.0,1093.5,47
21506,1346,1053,1.0,1199.5,293
21507,1476,1475,1.0,1475.5,1
21508,1372,1397,1.0,1384.5,-25
21509,1239,1362,1.0,1300.5,-123
21510,2557,1053,1.0,1805.0,1504
21511,2423,2431,1.0,2427.0,-8
21512,2400,2500,1.0,2450.0,-100
21513,2268,2361,1.0,2314.5,-93
21514,2555,2374,0.5,2464.5,181
21515,2464,2561,0.0,2512.5,-97
21516,2451,2533,0.0,2492.0,-82
21517,2468,2446,0.5,2457.0,22
21518,2559,2403,0.5,2481.0,156
21519,2384,2409,1.0,2396.5,-25
21520,2528,2535,0.5,2531.5,-7
21521,2205,2331,1.0,2268.0,-126
21522,2438,2469,0.5,2453.5,-31
21523,2218,2268,0.5,2243.0,-50
21524,2355,2326,0.5,2340.5,29
21525,2064,2081,0.0,2072.5,-17
21526,2421,2320,1.0,2370.5,101
21527,2281,2415,0.0,2348.0,-134
21528,2321,2267,0.0,2294.0,54
21529,2239,2294,0.0,2266.5,-55
21530,2509,2294,0.5,2401.5,215
21531,2317,2391,0.0,2354.0,-74
21532,2469,2475,0.5,2472.0,-6
21533,2301,2325,0.5,2313.0,-24
21534,2462,2404,1.0,2433.0,58
21535,2482,2474,1.0,2478.0,8
21536,2172,2278,0.0,2225.0,-106
21537,2263,2394,0.0,2328.5,-131
21538,2225,1980,0.0,2102.5,245
21539,2202,2369,0.5,2285.5,-167
21540,2144,2207,0.5,2175.5,-63
21541,2124,2265,0.5,2194.5,-141
21542,2303,2134,0.0,2218.5,169
21543,2254,2431,0.5,2342.5,-177
21544,2231,2295,0.0,2263.0,-64
21545,2135,2261,0.5,2198.0,-126
21546,2422,2276,1.0,2349.0,146
21547,2374,2394,0.5,2384.0,-20
21548,2149,2377,0.0,2263.0,-228
21549,2157,2328,1.0,2242.5,-171
21550,2367,2367,0.5,2367.0,0
21551,2188,2300,0.5,2244.0,-112
21552,2275,2345,1.0,2310.0,-70
21553,1849,2143,0.0,1996.0,-294
21554,2259,2260,0.0,2259.5,-1
21555,2261,2348,1.0,2304.5,-87
21556,2224,2330,0.5,2277.0,-106
21557,2241,2339,0.0,2290.0,-98
21558,2391,2112,0.5,2251.5,279
21559,2345,2447,0.5,2396.0,-102
21560,2222,2151,1.0,2186.5,71
21561,2108,2287,0.0,2197.5,-179
21562,2350,2034,0.0,2192.0,316
21563,2253,2402,0.5,2327.5,-149
21564,2219,2249,1.0,2234.0,-30
21565,2161,2308,0.0,2234.5,-147
21566,2404,2186,0.5,2295.0,218
21567,2113,2287,1.0,2200.0,-174
21568,2362,2329,0.5,2345.5,33
21569,2080,2102,1.0,2091.0,-22
21570,2423,2235,1.0,2329.0,188
21571,2081,2313,0.0,2197.0,-232
21572,2321,2370,1.0,2345.5,-49
21573,1911,1931,0.5,1921.0,-20
21574,2368,2260,1.0,2314.0,108
21575,2013,2053,0.0,2033.0,-40
21576,2244,2347,1.0,2295.5,-103
21577,1788,1940,0.0,1864.0,-152
21578,2157,2161,0.0,2159.0,-4
21579,2191,2248,1.0,2219.5,-57
21580,2137,2143,1.0,2140.0,-6
21581,2298,2227,0.0,2262.5,71
21582,2446,2101,1.0,2273.5,345
21583,2098,2139,0.0,2118.5,-41
21584,2407,2424,1.0,2415.5,-17
21585,1909,1950,0.0,1929.5,-41
21586,2244,2347,1.0,2295.5,-103
21587,1780,1933,0.0,1856.5,-153
21588,1968,2227,1.0,2097.5,-259
21589,1664,1733,0.0,1698.5,-69
21590,2513,1805,1.0,2159.0,708
21591,2393,2252,1.0,2322.5,141
21592,2355,2348,0.5,2351.5,7
21593,2194,2260,1.0,2227.0,-66
21594,2195,2274,0.0,2234.5,-79
21595,2038,2090,0.0,2064.0,-52
21596,2170,2230,1.0,2200.0,-60
21597,1685,1840,1.0,1762.5,-155
21598,2184,2175,0.5,2179.5,9
21599,2188,2404,0.0,2296.0,-216
21600,2059,2181,0.5,2120.0,-122
21601,2040,2114,0.5,2077.0,-74
21602,2266,1947,0.5,2106.5,319
21603,1923,2345,0.0,2134.0,-422
21604,2156,2124,0.5,2140.0,32
21605,1655,1924,0.0,1789.5,-269
21606,2254,2026,0.5,2140.0,228
21607,2290,2288,0.5,2289.0,2
21608,2114,2167,0.5,2140.5,-53
21609,2198,2268,0.5,2233.0,-70
21610,2267,2009,0.5,2138.0,258
21611,2158,2320,0.0,2239.0,-162
21612,2113,2204,0.5,2158.5,-91
21613,2113,2102,1.0,2107.5,11
21614,2299,2146,1.0,2222.5,153
21615,1945,1981,0.0,1963.0,-36
21616,2185,2254,1.0,2219.5,-69
21617,1724,1900,0.0,1812.0,-176
21618,2152,2116,0.5,2134.0,36
21619,1701,1693,1.0,1697.0,8
21620,1909,2022,1.0,1965.5,-113
21621,1617,1859,0.5,1738.0,-242
21622,2056,1838,0.0,1947.0,218
21623,1774,1909,0.0,1841.5,-135
21624,1862,2056,1.0,1959.0,-194
21625,1494,1460,0.5,1477.0,34
21626,2157,1854,0.0,2005.5,303
21627,2113,2176,0.0,2144.5,-63
21628,2129,2136,1.0,2132.5,-7
21629,1651,1898,0.5,1774.5,-247
21630,1544,2020,1.0,1782.0,-476
21631,1801,1966,1.0,1883.5,-165
21632,1408,1508,0.0,1458.0,-100
21633,1353,1725,0.0,1539.0,-372
21634,1546,1365,0.0,1455.5,181
21635,1984,2214,1.0,2099.0,-230
21636,1585,1378,1.0,1481.5,207
21637,1357,1799,0.0,1578.0,-442
21638,1953,1575,0.5,1764.0,378
21639,1986,2283,1.0,2134.5,-297
21640,1924,1853,1.0,1888.5,71
21641,1731,2004,0.0,1867.5,-273
21642,2369,1813,0.0,2091.0,556
21643,2005,2054,1.0,2029.5,-49
21644,1954,2159,1.0,2056.5,-205
21645,1869,1943,0.0,1906.0,-74
21646,1647,1750,0.0,1698.5,-103
21647,2058,2220,0.0,2139.0,-162
21648,1926,1712,1.0,1819.0,214
21649,1809,1998,0.0,1903.5,-189
21650,2414,1979,1.0,2196.5,435
21651,1813,1678,1.0,1745.5,135
21652,2389,2390,1.0,2389.5,-1
21653,1764,1785,0.0,1774.5,-21
21654,1803,2237,0.0,2020.0,-434
21655,2313,2375,1.0,2344.0,-62
21656,1725,1729,0.0,1727.0,-4
21657,2151,2288,1.0,2219.5,-137
21658,1929,1652,0.5,1790.5,277
21659,1872,2271,0.0,2071.5,-399
21660,1809,1833,1.0,1821.0,-24
21661,1526,1724,0.0,1625.0,-198
21662,1779,1785,0.0,1782.0,-6
21663,1727,2030,1.0,1878.5,-303
21664,1611,1719,0.0,1665.0,-108
21665,1671,1793,1.0,1732.0,-122
21666,1961,1777,1.0,1869.0,184
21667,1708,1726,0.0,1717.0,-18
21668,1874,1926,1.0,1900.0,-52
21669,1797,1795,0.0,1796.0,2
21670,2035,1760,0.5,1897.5,275
21671,1720,2082,0.0,1901.0,-362
21672,2031,2037,1.0,2034.0,-6
21673,1274,1683,0.0,1478.5,-409
21674,1960,1710,0.5,1835.0,250
21675,2110,2255,1.0,2182.5,-145
21676,1716,1727,0.5,1721.5,-11
21677,2037,2063,1.0,2050.0,-26
21678,2068,1791,0.0,1929.5,277
21679,1704,2159,0.0,1931.5,-455
21680,1924,1870,1.0,1897.0,54
21681,1397,1510,0.0,1453.5,-113
21682,2024,1890,1.0,1957.0,134
21683,1626,1888,0.5,1757.0,-262
21684,1594,1770,0.0,1682.0,-176
21685,1922,1996,1.0,1959.0,-74
21686,2057,1572,1.0,1814.5,485
21687,1702,1739,0.0,1720.5,-37
21688,2026,2106,0.5,2066.0,-80
21689,1755,1822,0.5,1788.5,-67
21690,1810,1966,0.0,1888.0,-156
21691,1797,1893,0.0,1845.0,-96
21692,1755,1815,1.0,1785.0,-60
21693,1531,1408,1.0,1469.5,123
21694,2126,1765,1.0,1945.5,361
21695,1960,2130,0.0,2045.0,-170
21696,2110,2079,0.5,2094.5,31
21697,1862,1921,0.0,1891.5,-59
21698,1943,2013,1.0,1978.0,-70
21699,1712,1863,0.0,1787.5,-151
21700,1926,1869,1.0,1897.5,57
21701,1446,1582,0.0,1514.0,-136
21702,2044,1907,1.0,1975.5,137
21703,1471,1568,0.0,1519.5,-97
21704,1948,2010,0.0,1979.0,-62
21705,1322,1407,0.5,1364.5,-85
21706,2064,1919,0.5,1991.5,145
21707,1505,1884,0.0,1694.5,-379
21708,1751,2020,0.0,1885.5,-269
21709,1601,1583,0.0,1592.0,18
21710,1772,1687,1.0,1729.5,85
21711,1683,1788,0.5,1735.5,-105
21712,1713,1778,0.5,1745.5,-65
21713,1559,1735,0.0,1647.0,-176
21714,1840,1741,0.0,1790.5,99
21715,1713,1945,1.0,1829.0,-232
21716,1535,1719,0.5,1627.0,-184
21717,1605,1655,0.5,1630.0,-50
21718,1942,1446,0.5,1694.0,496
21719,2044,2137,0.0,2090.5,-93
21720,1899,1932,1.0,1915.5,-33
21721,2023,2033,0.5,2028.0,-10
21722,1745,1727,0.0,1736.0,18
21723,1961,2052,1.0,2006.5,-91
21724,1573,1702,0.0,1637.5,-129
21725,1763,1806,1.0,1784.5,-43
21726,1831,1619,0.0,1725.0,212
21727,1670,1817,0.0,1743.5,-147
21728,1604,1848,0.5,1726.0,-244
21729,1718,1705,1.0,1711.5,13
21730,1712,1736,0.5,1724.0,-24
21731,1626,1577,0.5,1601.5,49
21732,1598,1727,0.0,1662.5,-129
21733,1752,1577,1.0,1664.5,175
21734,1607,1767,1.0,1687.0,-160
21735,1379,1451,0.0,1415.0,-72
21736,1734,1509,0.0,1621.5,225
21737,1667,1545,1.0,1606.0,122
21738,1502,1482,0.0,1492.0,20
21739,1495,1620,1.0,1557.5,-125
21740,1306,1412,1.0,1359.0,-106
21741,1581,1378,0.0,1479.5,203
21742,1456,2079,0.0,1767.5,-623
21743,1415,1581,1.0,1498.0,-166
21744,1584,1512,0.0,1548.0,72
21745,1595,1400,0.0,1497.5,195
21746,1704,1537,1.0,1620.5,167
21747,1432,1451,1.0,1441.5,-19
21748,1452,1411,0.5,1431.5,41
21749,1117,1070,0.0,1093.5,47
21750,1442,1053,0.5,1247.5,389
21751,1821,1673,1.0,1747.0,148
21752,1598,1668,0.5,1633.0,-70
21753,1540,1481,1.0,1510.5,59
21754,1499,1442,1.0,1470.5,57
21755,1437,1326,0.0,1381.5,111
21756,1222,1263,0.0,1242.5,-41
21757,1137,1182,1.0,1159.5,-45
21758,1475,1518,0.0,1496.5,-43
21759,1174,1476,1.0,1325.0,-302
21760,1559,1267,0.0,1413.0,292
21761,1306,1105,1.0,1205.5,201
21762,1755,1666,1.0,1710.5,89
21763,1318,1402,1.0,1360.0,-84
21764,1902,1308,0.0,1605.0,594
21765,1853,1871,1.0,1862.0,-18
21766,1365,1739,1.0,1552.0,-374
21767,1217,1123,1.0,1170.0,94
21768,1503,1502,0.0,1502.5,1
21769,1479,1518,0.0,1498.5,-39
21770,1362,1372,0.0,1367.0,-10
21771,1467,1239,0.0,1353.0,228
21772,1053,1671,0.0,1362.0,-618
21773,1439,1062,1.0,1250.5,377
21774,1458,1334,0.0,1396.0,124
21775,1468,1374,1.0,1421.0,94
21776,1173,1246,1.0,1209.5,-73
21777,2409,1397,1.0,1903.0,1012
21778,2423,2431,0.5,2427.0,-8
21779,2331,2384,1.0,2357.5,-53
21780,2268,2311,1.0,2289.5,-43
21781,2561,2289,1.0,2425.0,272
21782,2345,2367,0.5,2356.0,-22
21783,2468,2446,1.0,2457.0,22
21784,2275,2339,0.5,2307.0,-64
21785,2431,2351,0.5,2391.0,80
21786,2533,2555,1.0,2544.0,-22
21787,2261,2254,0.5,2257.5,7
21788,2405,2403,0.5,2404.0,2
21789,2421,2135,0.5,2278.0,286
21790,2358,2438,0.5,2398.0,-80
21791,2321,2267,0.5,2294.0,54
21792,2320,2326,0.5,2323.0,-6
21793,2394,2294,0.0,2344.0,100
21794,2202,2369,0.0,2285.5,-167
21795,2328,2374,1.0,2351.0,-46
21796,2167,2265,0.5,2216.0,-98
21797,2557,1933,0.5,2245.0,624
21798,2475,2509,0.5,2492.0,-34
21799,2400,2500,0.5,2450.0,-100
21800,2469,2482,0.5,2475.5,-13
21801,2287,2338,0.5,2312.5,-51
21802,2317,2391,1.0,2354.0,-74
21803,2102,2113,0.5,2107.5,-11
21804,2255,2325,1.0,2290.0,-70
21805,2474,2080,1.0,2277.0,394
21806,2249,2350,0.0,2299.5,-101
21807,2394,2482,0.5,2438.0,-88
21808,2215,2219,0.0,2217.0,-4
21809,2391,2125,0.5,2258.0,266
21810,2278,2462,0.5,2370.0,-184
21811,2222,2151,1.0,2186.5,71
21812,1980,2172,1.0,2076.0,-192
21813,2261,2034,0.0,2147.5,227
21814,2370,2423,1.0,2396.5,-53
21815,2241,2339,0.5,2290.0,-98
21816,2258,2321,1.0,2289.5,-63
21817,1647,2170,0.0,1908.5,-523
21818,2347,2368,1.0,2357.5,-21
21819,1712,1676,0.5,1694.0,36
21820,2161,2323,0.5,2242.0,-162
21821,2157,1926,1.0,2041.5,231
21822,2207,2225,1.0,2216.0,-18
21823,2129,2136,0.5,2132.5,-7
21824,2128,2144,0.5,2136.0,-16
21825,2422,1946,1.0,2184.0,476
21826,2227,2244,0.5,2235.5,-17
21827,2149,2377,1.0,2263.0,-228
21828,1805,1968,0.0,1886.5,-163
21829,2252,2123,0.0,2187.5,129
21830,2535,2559,1.0,2547.0,-24
21831,2260,2393,1.0,2326.5,-133
21832,2462,2528,1.0,2495.0,-66
21833,2415,2194,0.5,2304.5,221
21834,2181,2184,0.5,2182.5,-3
21835,2243,2281,0.5,2262.0,-38
21836,1947,2059,0.0,2003.0,-112
21837,2268,2294,0.0,2281.0,-26
21838,2056,2056,1.0,2056.0,0
21839,2081,2123,1.0,2102.0,-42
21840,1854,1862,0.0,1858.0,-8
21841,2300,2064,0.5,2182.0,236
21842,2295,2303,1.0,2299.0,-8
21843,2143,2188,0.5,2165.5,-45
21844,2276,2248,1.0,2262.0,28
21845,1953,1635,0.0,1794.0,318
21846,2424,2446,1.0,2435.0,-22
21847,1813,1853,0.0,1833.0,-40
21848,2347,2407,1.0,2377.0,-60
21849,2266,1573,1.0,1919.5,693
21850,2254,2299,1.0,2276.5,-45
21851,2051,2124,0.0,2087.5,-73
21852,2116,2185,0.0,2150.5,-69
21853,2447,2026,0.5,2236.5,421
21854,2253,2402,0.0,2327.5,-149
21855,2287,2345,0.5,2316.0,-58
21856,2112,2308,1.0,2210.0,-196
21857,1693,2096,0.0,1894.5,-403
21858,2414,2480,1.0,2447.0,-66
21859,1643,1859,0.0,1751.0,-216
21860,2237,2389,1.0,2313.0,-152
21861,2330,1617,0.5,1973.5,713
21862,2329,2404,0.5,2366.5,-75
21863,2134,2224,0.0,2179.0,-90
21864,2192,2362,1.0,2277.0,-170
21865,2313,2112,1.0,2212.5,201
21866,2204,2267,0.0,2235.5,-63
21867,1931,2081,1.0,2006.0,-150
21868,2113,2172,0.0,2142.5,-59
21869,2191,1911,0.5,2051.0,280
21870,2068,2008,1.0,2038.0,60
21871,2298,2227,1.0,2262.5,71
21872,1924,1870,0.5,1897.0,54
21873,2375,2188,1.0,2281.5,187
21874,2230,2195,1.0,2212.5,35
21875,2288,2313,0.5,2300.5,-25
21876,2118,2170,0.0,2144.0,-52
21877,2288,2258,1.0,2273.0,30
21878,2137,2157,0.0,2147.0,-20
21879,2198,2268,0.5,2233.0,-70
21880,2060,2101,0.0,2080.5,-41
21881,2254,2060,1.0,2157.0,194
21882,1974,2152,0.5,2063.0,-178
21883,2009,2114,1.0,2061.5,-105
21884,1838,1909,0.5,1873.5,-71
21885,2090,2118,1.0,2104.0,-28
21886,1833,1929,0.0,1881.0,-96
21887,1840,2038,1.0,1939.0,-198
21888,1785,1809,0.0,1797.0,-24
21889,2050,1685,0.5,1867.5,365
21890,2037,2035,0.0,2036.0,2
21891,1727,2030,0.0,1878.5,-303
21892,1710,1935,0.0,1822.5,-225
21893,2054,1793,0.5,1923.5,261
21894,1961,2029,0.0,1995.0,-68
21895,1943,2005,1.0,1974.0,-62
21896,1760,1874,0.0,1817.0,-114
21897,1966,1866,1.0,1916.0,100
21898,1174,1518,1.0,1346.0,-344
21899,1801,1872,1.0,1836.5,-71
21900,1267,1350,0.0,1308.5,-83
21901,2214,1725,0.0,1969.5,489
21902,1620,1667,0.5,1643.5,-47
21903,1772,1984,0.0,1878.0,-212
21904,1340,1495,0.0,1417.5,-155
21905,2320,1357,1.0,1838.5,963
21906,1954,2369,1.0,2161.5,-415
21907,2113,2102,0.5,2107.5,11
21908,1750,2034,1.0,1892.0,-284
21909,2255,1907,0.5,2081.0,348
21910,2079,2126,0.5,2102.5,-47
21911,2110,2174,1.0,2142.0,-64
21912,2013,2110,0.5,2061.5,-97
21913,2188,2063,1.0,2125.5,125
21914,1702,1772,0.0,1737.0,-70
21915,2114,2167,1.0,2140.5,-53
21916,1741,1713,0.0,1727.0,28
21917,1981,2040,1.0,2010.5,-59
21918,2098,2139,1.0,2118.5,-41
21919,1900,1945,0.0,1922.5,-45
21920,1950,2075,1.0,2012.5,-125
21921,2283,1724,1.0,2003.5,559
21922,1707,1780,0.0,1743.5,-73
21923,1819,1986,0.0,1902.5,-167
21924,1664,1733,0.0,1698.5,-69
21925,2513,1731,1.0,2122.0,782
21926,2010,2044,0.0,2027.0,-34
21927,2355,2348,1.0,2351.5,7
21928,1334,1919,0.0,1626.5,-585
21929,1909,2274,0.0,2091.5,-365
21930,2113,2176,1.0,2144.5,-63
21931,1490,1774,0.5,1632.0,-284
21932,1651,1898,0.0,1774.5,-247
21933,2053,1460,0.5,1756.5,593
21934,2106,2057,1.0,2081.5,49
21935,1771,2013,0.5,1892.0,-242
21936,1966,2026,0.0,1996.0,-60
21937,2058,1788,1.0,1923.0,270
21938,1626,1888,0.0,1757.0,-262
21939,1894,1998,0.5,1946.0,-104
21940,1922,1996,1.0,1959.0,-74
21941,1945,1809,0.5,1877.0,136
21942,2020,2064,1.0,2042.0,-44
21943,1655,1713,0.5,1684.0,-58
21944,1687,1751,1.0,1719.0,-64
21945,2345,1605,1.0,1975.0,740
21946,1626,1718,0.0,1672.0,-92
21947,1655,1924,1.0,1789.5,-269
21948,1577,1528,1.0,1552.5,49
21949,2082,1488,0.5,1785.0,594
21950,1869,1943,0.5,1906.0,-74
21951,1961,2052,0.0,2006.5,-91
21952,1907,1926,1.0,1916.5,-19
21953,1831,1763,0.0,1797.0,68
21954,1899,1932,0.0,1915.5,-33
21955,1604,1848,0.5,1726.0,-244
21956,1727,1790,1.0,1758.5,-63
21957,1748,1705,0.0,1726.5,43
21958,1668,1821,0.0,1744.5,-153
21959,1755,1815,0.5,1785.0,-60
21960,1540,1660,0.5,1600.0,-120
21961,1678,1765,0.5,1721.5,-87
21962,1378,1546,0.0,1462.0,-168
21963,1785,1813,1.0,1799.0,-28
21964,1575,1585,1.0,1580.0,-10
21965,1797,1764,1.0,1780.5,33
21966,1544,1483,1.0,1513.5,61
21967,1531,1408,0.0,1469.5,123
21968,1365,1508,0.0,1436.5,-143
21969,2271,1689,0.5,1980.0,582
21970,1726,1649,0.0,1687.5,77
21971,1812,1872,1.0,1842.0,-60
21972,1795,1708,1.0,1751.5,87
21973,2082,1724,1.0,1903.0,358
21974,1729,1803,0.5,1766.0,-74
21975,1683,1720,1.0,1701.5,-37
21976,1652,1725,1.0,1688.5,-73
21977,2159,1274,1.0,1716.5,885
21978,1581,1637,0.0,1609.0,-56
21979,1510,1704,1.0,1607.0,-194
21980,1512,1415,0.5,1463.5,97
21981,1960,1397,1.0,1678.5,563
21982,1611,1719,0.0,1665.0,-108
21983,1791,1727,0.5,1759.0,64
21984,1593,1777,1.0,1685.0,-184
21985,2044,1655,0.5,1849.5,389
21986,1451,1752,0.0,1601.5,-301
21987,2023,2033,1.0,2028.0,-10
21988,1425,1379,0.0,1402.0,46
21989,2130,1956,1.0,2043.0,174
21990,1582,1863,0.0,1722.5,-281
21991,1946,1960,1.0,1953.0,-14
21992,1388,1446,0.5,1417.0,-58
21993,1439,1862,0.0,1650.5,-423
21994,1770,1877,1.0,1823.5,-107
21995,1468,1334,0.0,1401.0,134
21996,1572,1594,1.0,1583.0,-22
21997,1962,1241,1.0,1601.5,721
21998,1263,1437,0.5,1350.0,-174
21999,1727,1712,0.5,1719.5,15
22000,1683,1598,1.0,1640.5,85
22001,1584,1414,0.5,1499.0,170
22002,1559,1735,0.0,1647.0,-176
22003,1704,1537,1.0,1620.5,167
22004,1767,1414,1.0,1590.5,353
22005,1479,1503,0.0,1491.0,-24
22006,1505,1607,0.0,1556.0,-102
22007,1364,1518,0.5,1441.0,-154
22008,1745,1509,1.0,1627.0,236
22009,1619,1702,1.0,1660.5,-83
22010,1708,1419,0.5,1563.5,289
22011,1505,1884,0.0,1694.5,-379
22012,1623,1670,1.0,1646.5,-47
22013,1601,1357,0.0,1479.0,244
22014,1739,1840,0.0,1789.5,-101
22015,1608,1702,0.0,1655.0,-94
22016,1755,1535,0.0,1645.0,220
22017,1446,1698,0.5,1572.0,-252
22018,1666,1568,1.0,1617.0,98
22019,1446,1755,0.0,1600.5,-309
22020,1402,1407,1.0,1404.5,-5
22021,1322,1318,0.0,1320.0,4
22022,1451,1053,1.0,1252.0,398
22023,1442,1432,0.0,1437.0,10
22024,1326,1881,1.0,1603.5,-555
22025,1871,1284,1.0,1577.5,587
22026,1182,1853,0.0,1517.5,-671
22027,1830,1137,1.0,1483.5,693
22028,1456,2079,0.0,1767.5,-623
22029,1467,1412,0.0,1439.5,55
22030,1206,1671,0.0,1438.5,-465
22031,1598,1306,1.0,1452.0,292
22032,1481,1475,1.0,1478.0,6
22033,1397,1499,0.5,1448.0,-102
22034,1365,1739,1.0,1552.0,-374
22035,1239,1372,0.5,1305.5,-133
22036,1475,1346,0.5,1410.5,129
22037,1034,1559,0.0,1296.5,-525
22038,1374,1062,1.0,1218.0,312
22039,2126,2263,0.0,2194.5,-137
22040,2761,2724,0.5,2742.5,37
22041,2809,2737,0.0,2773.0,72
22042,2749,2800,0.5,2774.5,-51
22043,2703,2775,0.5,2739.0,-72
22044,2742,2707,1.0,2724.5,35
22045,2735,2739,1.0,2737.0,-4
22046,2728,2736,0.5,2732.0,-8
22047,2694,2654,0.0,2674.0,40
22048,2638,2666,0.0,2652.0,-28
22049,2737,2761,0.5,2749.0,-24
22050,2724,2749,1.0,2736.5,-25
22051,2800,2742,0.5,2771.0,58
22052,2654,2735,1.0,2694.5,-81
22053,2775,2809,0.5,2792.0,-34
22054,2736,2703,0.5,2719.5,33
22055,2666,2728,0.5,2697.0,-62
22056,2739,2638,1.0,2688.5,101
22057,2707,2694,0.5,2700.5,13
22058,2724,2654,0.5,2689.0,70
22059,2761,2800,0.5,2780.5,-39
22060,2735,2737,1.0,2736.0,-2
22061,2742,2809,1.0,2775.5,-67
22062,2728,2739,0.5,2733.5,-11
22063,2703,2707,0.5,2705.0,-4
22064,2666,2775,0.0,2720.5,-109
22065,2694,2736,0.0,2715.0,-42
22066,2638,2749,0.5,2693.5,-111
22067,2742,2724,0.5,2733.0,18
22068,2775,2761,0.5,2768.0,14
22069,2800,2735,0.5,2767.5,65
22070,2654,2736,0.5,2695.0,-82
22071,2737,2703,0.5,2720.0,34
22072,2707,2728,0.5,2717.5,-21
22073,2749,2666,1.0,2707.5,83
22074,2739,2694,0.5,2716.5,45
22075,2809,2638,1.0,2723.5,171
22076,2041,1886,0.5,1963.5,155
22077,2842,2753,0.5,2797.5,89
22078,2801,2779,1.0,2790.0,22
22079,2526,2741,0.0,2633.5,-215
22080,2526,2842,0.5,2684.0,-316
22081,2801,2753,0.5,2777.0,48
22082,2741,2779,0.5,2760.0,-38
22083,2842,2801,0.5,2821.5,41
22084,2753,2741,0.5,2747.0,12
22085,2779,2526,1.0,2652.5,253
22086,2741,2842,0.5,2791.5,-101
22087,2526,2801,0.0,2663.5,-275
22088,2753,2779,0.0,2766.0,-26
22089,2801,2741,1.0,2771.0,60
22090,2842,2779,0.5,2810.5,63
22091,2526,2753,0.0,2639.5,-227
22092,2779,2801,0.5,2790.0,-22
22093,2753,2842,0.5,2797.5,-89
22094,2741,2526,0.5,2633.5,215
22095,2706,2296,1.0,2501.0,410
22096,2305,2652,0.0,2478.5,-347
22097,2642,2301,1.0,2471.5,341
22098,2295,2638,0.0,2466.5,-343
22099,2636,2295,1.0,2465.5,341
22100,2284,2626,0.0,2455.0,-342
22101,2609,2149,1.0,2379.0,460
22102,2270,2604,0.0,2437.0,-334
22103,2588,2263,1.0,2425.5,325
22104,2247,2599,0.5,2423.0,-352
22105,2580,2247,0.5,2413.5,333
22106,2237,2595,0.0,2416.0,-358
22107,2594,2226,1.0,2410.0,368
22108,2231,2578,0.5,2404.5,-347
22109,2572,2230,1.0,2401.0,342
22110,2210,2562,0.0,2386.0,-352
22111,2559,2218,1.0,2388.5,341
22112,2207,2558,0.0,2382.5,-351
22113,2556,2162,1.0,2359.0,394
22114,2196,2546,0.0,2371.0,-350
22115,2451,2706,0.5,2578.5,-255
22116,2652,2459,1.0,2555.5,193
22117,2442,2642,0.0,2542.0,-200
22118,2638,2444,0.0,2541.0,194
22119,2436,2636,1.0,2536.0,-200
22120,2419,2609,0.5,2514.0,-190
22121,2604,2425,1.0,2514.5,179
22122,2402,2588,0.5,2495.0,-186
22123,2595,2399,1.0,2497.0,196
22124,2390,2594,0.5,2492.0,-204
22125,2370,2572,0.0,2471.0,-202
22126,2562,2378,0.5,2470.0,184
22127,2353,2559,0.5,2456.0,-206
22128,2558,2393,1.0,2475.5,165
22129,2298,2556,0.0,2427.0,-258
22130,2546,2382,0.5,2464.0,164
22131,2012,2545,0.0,2278.5,-533
22132,2536,2359,1.0,2447.5,177
22133,2026,2534,0.5,2280.0,-508
22134,2536,2652,0.5,2594.0,-116
22135,2642,2529,1.0,2585.5,113
22136,2515,2604,0.5,2559.5,-89
22137,2490,2595,0.5,2542.5,-105
22138,2572,2486,0.5,2529.0,86
22139,2444,2558,0.0,2501.0,-114
22140,2556,2436,0.5,2496.0,120
22141,2545,2015,1.0,2280.0,530
22142,2706,2419,1.0,2562.5,287
22143,2506,2626,0.5,2566.0,-120
22144,2609,2451,0.5,2530.0,158
22145,2588,2390,1.0,2489.0,198
22146,2437,2599,0.5,2518.0,-162
22147,2580,2402,1.0,2491.0,178
22148,2594,2360,1.0,2477.0,234
22149,2382,2562,0.0,2472.0,-180
22150,2559,2300,1.0,2429.5,259
22151,2378,2546,0.0,2462.0,-168
22152,2534,2353,1.0,2443.5,181
22153,2636,2026,1.0,2331.0,610
22154,2558,2642,1.0,2600.0,-84
22155,2706,2545,0.5,2625.5,161
22156,2652,2559,0.5,2605.5,93
22157,2604,2556,0.0,2580.0,48
22158,2546,2588,0.5,2567.0,-42
22159,2580,2536,0.0,2558.0,44
22160,2595,2534,0.5,2564.5,61
22161,2486,2594,0.5,2540.0,-108
22162,2436,2572,0.5,2504.0,-136
22163,2562,2515,0.0,2538.5,47
22164,2626,2490,0.5,2558.0,136
22165,2425,2636,1.0,2530.5,-211
22166,2399,2609,0.5,2504.0,-210
22167,2599,2409,0.0,2504.0,190
22168,2578,2399,1.0,2488.5,179
22169,2529,2393,0.5,2461.0,136
22170,2370,2506,1.0,2438.0,-136
22171,2499,2359,1.0,2429.0,140
22172,2451,2336,1.0,2393.5,115
22173,2015,2444,0.0,2229.5,-429
22174,2556,2558,1.0,2557.0,-2
22175,2545,2536,1.0,2540.5,9
22176,2515,2652,0.0,2583.5,-137
22177,2490,2706,0.5,2598.0,-216
22178,2642,2499,0.5,2570.5,143
22179,2588,2486,1.0,2537.0,102
22180,2444,2595,0.5,2519.5,-151
22181,2594,2451,1.0,2522.5,143
22182,2437,2578,1.0,2507.5,-141
22183,2572,2425,1.0,2498.5,147
22184,2559,2436,0.5,2497.5,123
22185,2409,2546,0.0,2477.5,-137
22186,2534,2370,0.5,2452.0,164
22187,2399,2638,0.0,2518.5,-239
22188,2396,2626,0.5,2511.0,-230
22189,2609,2296,1.0,2452.5,313
22190,2393,2604,1.0,2498.5,-211
22191,2382,2580,0.0,2481.0,-198
22192,2295,2562,0.0,2428.5,-267
22193,2295,2529,0.0,2412.0,-234
22194,1821,1711,1.0,1766.0,110
22195,2672,2706,0.5,2689.0,-34
22196,2759,2691,1.0,2725.0,68
22197,2754,2782,1.0,2768.0,-28
22198,2812,2789,1.0,2800.5,23
22199,2777,2718,0.5,2747.5,59
22200,2734,2719,0.5,2726.5,15
22201,2782,2672,1.0,2727.0,110
22202,2789,2759,0.5,2774.0,30
22203,2719,2777,1.0,2748.0,-58
22204,2718,2812,0.0,2765.0,-94
22205,2706,2734,0.0,2720.0,-28
22206,2691,2754,0.0,2722.5,-63
22207,2759,2718,1.0,2738.5,41
22208,2706,2782,0.5,2744.0,-76
22209,2812,2719,1.0,2765.5,93
22210,2734,2777,0.5,2755.5,-43
22211,2754,2789,0.5,2771.5,-35
22212,2672,2691,0.5,2681.5,-19
22213,2691,2706,1.0,2698.5,-15
22214,2789,2672,0.0,2730.5,117
22215,2782,2734,0.5,2758.0,48
22216,2777,2812,0.5,2794.5,-35
22217,2719,2759,0.5,2739.0,-40
22218,2718,2754,0.5,2736.0,-36
22219,2607,2602,1.0,2604.5,5
22220,2457,2637,0.0,2547.0,-180
22221,2567,2560,1.0,2563.5,7
22222,2553,2566,0.0,2559.5,-13
22223,2710,2430,1.0,2570.0,280
22224,2593,2677,1.0,2635.0,-84
22225,2431,2711,0.0,2571.0,-280
22226,2560,2607,0.5,2583.5,-47
22227,2602,2593,1.0,2597.5,9
22228,2677,2457,0.5,2567.0,220
22229,2430,2567,0.5,2498.5,-137
22230,2566,2431,1.0,2498.5,135
22231,2711,2710,0.0,2710.5,1
22232,2637,2553,1.0,2595.0,84
22233,2567,2607,0.0,2587.0,-40
22234,2430,2711,0.0,2570.5,-281
22235,2431,2637,0.0,2534.0,-206
22236,2710,2566,0.5,2638.0,144
22237,2457,2602,0.5,2529.5,-145
22238,2553,2677,0.0,2615.0,-124
22239,2593,2560,0.5,2576.5,33
22240,2607,2593,1.0,2600.0,14
22241,2560,2457,0.5,2508.5,103
22242,2602,2553,0.0,2577.5,49
22243,2677,2431,1.0,2554.0,246
22244,2637,2710,0.5,2673.5,-73
22245,2566,2430,0.5,2498.0,136
22246,2711,2567,1.0,2639.0,144
22247,2457,2607,0.5,2532.0,-150
22248,2711,2566,0.5,2638.5,145
22249,2710,2677,1.0,2693.5,33
22250,2567,2593,0.0,2580.0,-26
22251,2553,2560,0.5,2556.5,-7
22252,2431,2602,0.5,2516.5,-171
22253,2430,2637,0.5,2533.5,-207
22254,2215,1714,1.0,1964.5,501
22255,2615,2592,0.0,2603.5,23
22256,2440,2400,0.0,2420.0,40
22257,2436,2361,1.0,2398.5,75
22258,2340,2425,1.0,2382.5,-85
22259,2315,2411,0.0,2363.0,-96
22260,2259,2441,0.0,2350.0,-182
22261,2204,2382,0.0,2293.0,-178
22262,2170,2317,1.0,2243.5,-147
22263,2370,2334,1.0,2352.0,36
22264,2318,2302,0.5,2310.0,16
22265,2419,2444,0.5,2431.5,-25
22266,2429,2583,1.0,2506.0,-154
22267,2474,2606,0.0,2540.0,-132
22268,2510,2632,1.0,2571.0,-122
22269,2509,2398,1.0,2453.5,111
22270,2415,2421,1.0,2418.0,-6
22271,2400,2453,0.5,2426.5,-53
22272,2317,2256,1.0,2286.5,61
22273,2202,2297,0.0,2249.5,-95
22274,2343,2230,0.5,2286.5,113
22275,2518,2415,1.0,2466.5,103
22276,2378,2614,0.5,2496.0,-236
22277,2617,2377,0.0,2497.0,240
22278,2490,2503,0.0,2496.5,-13
22279,2566,2586,0.0,2576.0,-20
22280,2482,2370,1.0,2426.0,112
22281,2376,2386,0.0,2381.0,-10
22282,2289,2384,0.0,2336.5,-95
22283,2365,2319,0.0,2342.0,46
22284,2292,2261,1.0,2276.5,31
22285,2063,2071,0.0,2067.0,-8
22286,2424,2423,0.5,2423.5,1
22287,2416,2395,1.0,2405.5,21
22288,2288,2637,0.5,2462.5,-349
22289,2432,2112,1.0,2272.0,320
22290,2330,2295,0.5,2312.5,35
22291,2330,2315,0.5,2322.5,15
22292,2234,2311,0.0,2272.5,-77
22293,2216,2360,0.5,2288.0,-144
22294,2138,2333,1.0,2235.5,-195
22295,2368,2210,0.5,2289.0,158
22296,2523,2630,0.5,2576.5,-107
22297,2619,2340,1.0,2479.5,279
22298,2555,2590,0.5,2572.5,-35
22299,2576,2345,0.5,2460.5,231
22300,2534,2392,1.0,2463.0,142
22301,2424,2282,0.0,2353.0,142
22302,2266,2382,0.5,2324.0,-116
22303,2352,2217,1.0,2284.5,135
22304,2220,2286,0.5,2253.0,-66
22305,2311,2185,1.0,2248.0,126
22306,2313,2455,1.0,2384.0,-142
22307,2536,1995,1.0,2265.5,541
22308,2419,2329,1.0,2374.0,90
22309,2340,2160,1.0,2250.0,180
22310,2448,2292,1.0,2370.0,156
22311,2266,2387,0.0,2326.5,-121
22312,2303,2215,1.0,2259.0,88
22313,2256,2151,0.5,2203.5,105
22314,2198,2157,0.5,2177.5,41
22315,2187,2147,1.0,2167.0,40
22316,2497,2347,0.5,2422.0,150
22317,2602,2493,0.5,2547.5,109
22318,2590,2414,1.0,2502.0,176
22319,2455,2378,1.0,2416.5,77
22320,2349,2440,0.5,2394.5,-91
22321,2479,2523,0.5,2501.0,-44
22322,2379,2371,1.0,2375.0,8
22323,2370,2380,0.5,2375.0,-10
22324,2327,2339,1.0,2333.0,-12
22325,2397,2324,0.0,2360.5,73
22326,2363,2216,0.5,2289.5,147
22327,2305,2331,1.0,2318.0,-26
22328,2457,2206,0.5,2331.5,251
22329,2201,2461,1.0,2331.0,-260
22330,2238,2379,0.5,2308.5,-141
22331,2337,2170,0.5,2253.5,167
22332,2204,2242,1.0,2223.0,-38
22333,2209,2223,1.0,2216.0,-14
22334,2314,2107,1.0,2210.5,207
22335,1973,2244,1.0,2108.5,-271
22336,2200,2029,1.0,2114.5,171
22337,2595,2568,0.5,2581.5,27
22338,2404,2571,0.0,2487.5,-167
22339,2402,2493,0.0,2447.5,-91
22340,2368,2548,0.5,2458.0,-180
22341,2381,2402,0.0,2391.5,-21
22342,2364,2381,0.5,2372.5,-17
22343,2428,2383,1.0,2405.5,45
22344,2292,2417,0.5,2354.5,-125
22345,2202,2394,1.0,2298.0,-192
22346,2286,2309,0.5,2297.5,-23
22347,1964,2150,0.0,2057.0,-186
22348,2599,2592,0.5,2595.5,7
22349,2552,2331,1.0,2441.5,221
22350,2534,1939,1.0,2236.5,595
22351,2393,2234,1.0,2313.5,159
22352,2230,1873,1.0,2051.5,357
22353,2362,2506,0.5,2434.0,-144
22354,2018,2213,0.0,2115.5,-195
22355,2374,2184,1.0,2279.0,190
22356,2283,2195,1.0,2239.0,88
22357,2485,2511,0.0,2498.0,-26
22358,2674,2626,0.5,2650.0,48
22359,2350,2467,0.0,2408.5,-117
22360,2578,2499,1.0,2538.5,79
22361,2367,2444,0.0,2405.5,-77
22362,2435,2338,1.0,2386.5,97
22363,2417,2219,1.0,2318.0,198
22364,2188,2296,0.5,2242.0,-108
22365,2325,2266,1.0,2295.5,59
22366,2202,2423,0.5,2312.5,-221
22367,2580,2615,0.5,2597.5,-35
22368,2205,2571,0.0,2388.0,-366
22369,2402,2577,1.0,2489.5,-175
22370,2524,2595,1.0,2559.5,-71
22371,2381,2401,1.0,2391.0,-20
22372,2465,2417,0.5,2441.0,48
22373,2309,2363,0.0,2336.0,-54
22374,2371,2190,1.0,2280.5,181
22375,2404,2252,0.5,2328.0,152
22376,2406,2381,1.0,2393.5,25
22377,2485,2447,1.0,2466.0,38
22378,2514,2496,0.5,2505.0,18
22379,2374,2405,1.0,2389.5,-31
22380,2386,2381,0.0,2383.5,5
22381,2391,2346,0.5,2368.5,45
22382,2409,2388,0.5,2398.5,21
22383,2311,2480,1.0,2395.5,-169
22384,2352,2319,1.0,2335.5,33
22385,2247,2297,0.5,2272.0,-50
22386,2454,2315,0.5,2384.5,139
22387,2492,2404,0.0,2448.0,88
22388,2493,2290,1.0,2391.5,203
22389,2428,2384,1.0,2406.0,44
22390,2368,2283,1.0,2325.5,85
22391,2388,2292,1.0,2340.0,96
22392,2383,2344,1.0,2363.5,39
22393,2404,2364,1.0,2384.0,40
22394,2394,2179,0.5,2286.5,215
22395,2202,2286,0.0,2244.0,-84
22396,2239,2225,1.0,2232.0,14
22397,1969,2192,1.0,2080.5,-223
22398,2479,2340,1.0,2409.5,139
22399,2677,2602,0.5,2639.5,75
22400,2455,2220,1.0,2337.5,235
22401,2555,2397,0.5,2476.0,158
22402,2371,2345,1.0,2358.0,26
22403,2523,2347,1.0,2435.0,176
22404,2414,2217,0.5,2315.5,197
22405,2534,2440,0.5,2487.0,94
22406,2370,2266,1.0,2318.0,104
22407,2492,2365,1.0,2428.5,127
22408,1953,2448,0.0,2200.5,-495
22409,2853,2816,0.0,2834.5,37
22410,2814,2816,1.0,2815.0,-2
22411,2765,2808,1.0,2786.5,-43
22412,2793,2771,1.0,2782.0,22
22413,2779,2731,0.0,2755.0,48
22414,2176,2224,0.5,2200.0,-48
22415,2430,2424,0.5,2427.0,6
22416,2434,2388,1.0,2411.0,46
22417,2476,2293,1.0,2384.5,183
22418,2480,2452,0.5,2466.0,28
22419,2327,2378,0.5,2352.5,-51
22420,2323,2411,0.0,2367.0,-88
22421,2424,2411,0.5,2417.5,13
22422,2378,2323,1.0,2350.5,55
22423,2452,2327,0.5,2389.5,125
22424,2293,2480,0.0,2386.5,-187
22425,2388,2476,0.5,2432.0,-88
22426,2430,2434,0.5,2432.0,-4
22427,2434,2424,0.5,2429.0,10
22428,2476,2430,0.5,2453.0,46
22429,2480,2388,1.0,2434.0,92
22430,2327,2293,0.5,2310.0,34
22431,2323,2452,0.0,2387.5,-129
22432,2411,2378,0.5,2394.5,33
22433,2424,2378,0.0,2401.0,46
22434,2452,2411,0.5,2431.5,41
22435,2293,2323,1.0,2308.0,-30
22436,2388,2327,0.5,2357.5,61
22437,2430,2480,0.5,2455.0,-50
22438,2434,2476,0.5,2455.0,-42
22439,2476,2424,1.0,2450.0,52
22440,2480,2434,0.0,2457.0,46
22441,2327,2430,0.0,2378.5,-103
22442,2323,2388,0.5,2355.5,-65
22443,2411,2293,1.0,2352.0,118
22444,2378,2452,1.0,2415.0,-74
22445,2424,2452,0.0,2438.0,-28
22446,2293,2378,0.0,2335.5,-85
22447,2388,2411,0.5,2399.5,-23
22448,2430,2323,0.5,2376.5,107
22449,2434,2327,1.0,2380.5,107
22450,2476,2480,0.5,2478.0,-4
22451,2480,2424,1.0,2452.0,56
22452,2327,2476,1.0,2401.5,-149
22453,2323,2434,1.0,2378.5,-111
22454,2411,2430,1.0,2420.5,-19
22455,2378,2388,1.0,2383.0,-10
22456,2452,2293,1.0,2372.5,159
22457,2424,2293,0.0,2358.5,131
22458,2388,2452,1.0,2420.0,-64
22459,2430,2378,0.5,2404.0,52
22460,2434,2411,0.5,2422.5,23
22461,2476,2323,1.0,2399.5,153
22462,2480,2327,0.0,2403.5,153
22463,2327,2424,0.0,2375.5,-97
22464,2323,2480,0.0,2401.5,-157
22465,2411,2476,1.0,2443.5,-65
22466,2378,2434,0.5,2406.0,-56
22467,2452,2430,1.0,2441.0,22
22468,2293,2388,1.0,2340.5,-95
22469,2424,2388,0.5,2406.0,36
22470,2430,2293,0.5,2361.5,137
22471,2434,2452,0.5,2443.0,-18
22472,2476,2378,0.5,2427.0,98
22473,2480,2411,0.5,2445.5,69
22474,2327,2323,1.0,2325.0,4
22475,2323,2424,0.5,2373.5,-101
22476,2411,2327,0.5,2369.0,84
22477,2378,2480,0.5,2429.0,-102
22478,2452,2476,0.5,2464.0,-24
22479,2293,2434,0.5,2363.5,-141
22480,2388,2430,0.5,2409.0,-42
22481,2158,2076,0.5,2117.0,82
22482,2586,2603,0.5,2594.5,-17
22483,2590,2661,1.0,2625.5,-71
22484,2448,2416,1.0,2432.0,32
22485,2477,2491,0.0,2484.0,-14
22486,2473,2410,0.0,2441.5,63
22487,2273,2279,0.0,2276.0,-6
22488,2379,2449,0.5,2414.0,-70
22489,2291,2443,0.0,2367.0,-152
22490,2300,2346,0.0,2323.0,-46
22491,2233,2177,1.0,2205.0,56
22492,2380,2552,1.0,2466.0,-172
22493,2527,2253,0.0,2390.0,274
22494,2620,2341,1.0,2480.5,279
22495,2289,2611,0.0,2450.0,-322
22496,2526,2193,1.0,2359.5,333
22497,2233,2405,0.5,2319.0,-172
22498,2516,2289,0.0,2402.5,227
22499,2272,2366,0.5,2319.0,-94
22500,2348,2206,0.5,2277.0,142
22501,2340,2180,1.0,2260.0,160
22502,2130,2244,0.5,2187.0,-114
22503,2772,2773,0.5,2772.5,-1
22504,2755,2710,0.5,2732.5,45
22505,2795,2633,1.0,2714.0,162
22506,2785,2786,0.5,2785.5,-1
22507,2751,2724,0.5,2737.5,27
22508,2652,2750,0.0,2701.0,-98
22509,2696,2621,0.5,2658.5,75
22510,2750,2747,1.0,2748.5,3
22511,2710,2727,0.5,2718.5,-17
22512,2773,2795,0.5,2784.0,-22
22513,2710,2772,0.5,2741.0,-62
22514,2750,2755,0.5,2752.5,-5
22515,2786,2751,1.0,2768.5,35
22516,2696,2785,0.5,2740.5,-89
22517,2724,2750,1.0,2737.0,-26
22518,2621,2710,0.5,2665.5,-89
22519,2633,2652,0.5,2642.5,-19
22520,2747,2727,1.0,2737.0,20
22521,2786,2773,0.5,2779.5,13
22522,2772,2750,0.5,2761.0,22
22523,2795,2710,0.5,2752.5,85
22524,2755,2724,0.5,2739.5,31
22525,2785,2633,1.0,2709.0,152
22526,2750,2696,0.5,2723.0,54
22527,2652,2621,1.0,2636.5,31
22528,2710,2747,0.5,2728.5,-37
22529,2727,2751,0.5,2739.0,-24
22530,2773,2785,0.5,2779.0,-12
22531,2755,2772,0.5,2763.5,-17
22532,2750,2786,0.5,2768.0,-36
22533,2710,2724,0.5,2717.0,-14
22534,2696,2795,0.5,2745.5,-99
22535,2652,2710,0.5,2681.0,-58
22536,2751,2750,0.0,2750.5,1
22537,2621,2747,0.5,2684.0,-126
22538,2633,2727,0.5,2680.0,-94
22539,2724,2773,0.0,2748.5,-49
22540,2772,2795,0.5,2783.5,-23
22541,2786,2755,0.5,2770.5,31
22542,2785,2750,0.5,2767.5,35
22543,2750,2710,0.5,2730.0,40
22544,2747,2696,0.5,2721.5,51
22545,2727,2652,0.0,2689.5,75
22546,2710,2751,0.5,2730.5,-41
22547,2633,2621,0.5,2627.0,12
22548,2152,1989,1.0,2070.5,163
22549,2523,2305,1.0,2414.0,218
22550,2379,2425,0.5,2402.0,-46
22551,2324,2216,1.0,2270.0,108
22552,2206,2590,0.5,2398.0,-384
22553,2497,2337,1.0,2417.0,160
22554,2201,2327,1.0,2264.0,-126
22555,2378,2107,1.0,2242.5,271
22556,2209,2379,0.5,2294.0,-170
22557,2349,2082,0.0,2215.5,267
22558,2242,2380,0.5,2311.0,-138
22559,2048,2101,0.5,2074.5,-53
22560,2527,2531,1.0,2529.0,-4
22561,2450,2289,1.0,2369.5,161
22562,2341,2573,1.0,2457.0,-232
22563,2545,2552,0.0,2548.5,-7
22564,2233,2418,0.0,2325.5,-185
22565,2374,2340,0.0,2357.0,34
22566,2272,2399,0.0,2335.5,-127
22567,2324,2206,0.5,2265.0,118
22568,2289,2373,0.5,2331.0,-84
22569,2236,2248,0.0,2242.0,-12
22570,2574,2379,1.0,2476.5,195
22571,2511,2574,0.5,2542.5,-63
22572,2428,2625,0.5,2526.5,-197
22573,2468,2387,0.5,2427.5,81
22574,2372,2358,0.5,2365.0,14
22575,2399,2288,0.0,2343.5,111
22576,2399,2285,0.5,2342.0,114
22577,2312,2294,1.0,2303.0,18
22578,2403,2411,0.5,2407.0,-8
22579,2222,2279,0.0,2250.5,-57
22580,2279,2446,1.0,2362.5,-167
22581,2437,2661,0.5,2549.0,-224
22582,2448,2462,0.0,2455.0,-14
22583,2402,2491,0.5,2446.5,-89
22584,2443,2274,1.0,2358.5,169
22585,2446,2473,0.0,2459.5,-27
22586,2586,2408,1.0,2497.0,178
22587,2408,2325,0.5,2366.5,83
22588,2300,2400,1.0,2350.0,-100
22589,2342,2177,1.0,2259.5,165
22590,1896,2439,0.0,2167.5,-543
22591,2169,2182,1.0,2175.5,-13
22592,2288,2400,0.5,2344.0,-112
22593,2465,2318,1.0,2391.5,147
22594,2474,2440,0.5,2457.0,34
22595,2452,2391,0.5,2421.5,61
22596,2484,2513,0.5,2498.5,-29
22597,2341,2316,0.5,2328.5,25
22598,2041,2414,0.0,2227.5,-373
22599,2405,2253,1.0,2329.0,152
22600,2344,2399,0.5,2371.5,-55
22601,2447,2226,1.0,2336.5,221
22602,2422,2380,0.0,2401.0,42
22603,2411,2546,1.0,2478.5,-135
22604,2574,2391,1.0,2482.5,183
22605,2301,2398,0.5,2349.5,-97
22606,2371,2288,1.0,2329.5,83
22607,2278,2378,0.0,2328.0,-100
22608,2432,2336,1.0,2384.0,96
22609,2157,2190,0.5,2173.5,-33
22610,2312,2385,0.0,2348.5,-73
22611,2489,2626,0.5,2557.5,-137
22612,2358,2609,0.0,2483.5,-251
22613,2495,2514,1.0,2504.5,-19
22614,2424,2403,1.0,2413.5,21
22615,2158,2408,0.0,2283.0,-250
22616,2318,2296,0.5,2307.0,22
22617,2341,2380,0.5,2360.5,-39
22618,2399,2196,1.0,2297.5,203
22619,2268,2200,1.0,2234.0,68
22620,2713,2696,0.0,2704.5,17
22621,2778,2739,0.0,2758.5,39
22622,2837,2732,1.0,2784.5,105
22623,2732,2739,1.0,2735.5,-7
22624,2696,2837,0.5,2766.5,-141
22625,2713,2778,0.0,2745.5,-65
22626,2837,2713,0.5,2775.0,124
22627,2778,2732,1.0,2755.0,46
22628,2739,2696,1.0,2717.5,43
22629,2615,2674,0.5,2644.5,-59
22630,2639,2475,1.0,2557.0,164
22631,2605,2312,1.0,2458.5,293
22632,2631,2663,0.5,2647.0,-32
22633,2506,2559,0.5,2532.5,-53
22634,2299,2531,0.0,2415.0,-232
22635,2553,2408,1.0,2480.5,145
22636,2686,2446,1.0,2566.0,240
22637,2681,2319,1.0,2500.0,362
22638,2315,2548,0.5,2431.5,-233
22639,2547,2251,1.0,2399.0,296
22640,2642,2512,0.5,2577.0,130
22641,2141,2488,0.0,2314.5,-347
22642,2573,2416,0.5,2494.5,157
22643,2698,2642,1.0,2670.0,56
22644,2530,2375,1.0,2452.5,155
22645,2599,2653,0.0,2626.0,-54
22646,2579,2644,0.0,2611.5,-65
22647,2646,2684,1.0,2665.0,-38
22648,2569,2638,0.5,2603.5,-69
22649,2686,2646,0.5,2666.0,40
22650,2446,2530,0.5,2488.0,-84
22651,2644,2698,0.5,2671.0,-54
22652,2559,2478,1.0,2518.5,81
22653,2653,2639,0.5,2646.0,14
22654,2531,2435,0.5,2483.0,96
22655,2484,2319,0.5,2401.5,165
22656,2684,2631,0.5,2657.5,53
22657,2642,2569,0.5,2605.5,73
22658,2374,2573,0.5,2473.5,-199
22659,2488,2553,0.5,2520.5,-65
22660,2512,2599,0.5,2555.5,-87
22661,2547,2642,1.0,2594.5,-95
22662,2416,2315,1.0,2365.5,101
22663,2279,2485,0.0,2382.0,-206
22664,2475,2579,0.0,2527.0,-104
22665,2674,2605,0.5,2639.5,69
22666,2663,2615,1.0,2639.0,48
22667,2638,2681,0.5,2659.5,-43
22668,2548,2506,0.5,2527.0,42
22669,2646,2663,0.5,2654.5,-17
22670,2698,2547,1.0,2622.5,151
22671,2653,2686,0.5,2669.5,-33
22672,2639,2644,0.5,2641.5,-5
22673,2605,2684,0.0,2644.5,-79
22674,2681,2674,0.5,2677.5,7
22675,2631,2642,0.5,2636.5,-11
22676,2579,2638,0.5,2608.5,-59
22677,2569,2559,1.0,2564.0,10
22678,2485,2615,0.0,2550.0,-130
22679,2506,2599,0.5,2552.5,-93
22680,2553,2416,1.0,2484.5,137
22681,2548,2446,0.0,2497.0,102
22682,2251,2531,1.0,2391.0,-280
22683,2530,2488,1.0,2509.0,42
22684,2435,2512,1.0,2473.5,-77
22685,2329,2642,0.0,2485.5,-313
22686,2573,2355,0.5,2464.0,218
22687,2282,2484,0.5,2383.0,-202
22688,2478,2375,1.0,2426.5,103
22689,2646,2698,0.5,2672.0,-52
22690,2686,2569,0.5,2627.5,117
22691,2684,2639,0.5,2661.5,45
22692,2663,2653,1.0,2658.0,10
22693,2644,2631,0.5,2637.5,13
22694,2547,2681,1.0,2614.0,-134
22695,2674,2553,0.5,2613.5,121
22696,2642,2530,0.5,2586.0,112
22697,2638,2435,1.0,2536.5,203
22698,2615,2251,1.0,2433.0,364
22699,2446,2579,0.0,2512.5,-133
22700,2642,2449,1.0,2545.5,193
22701,2599,2428,1.0,2513.5,171
22702,2559,2141,1.0,2350.0,418
22703,2312,2506,0.0,2409.0,-194
22704,2416,2573,0.0,2494.5,-157
22705,2355,2548,0.0,2451.5,-193
22706,2531,2416,0.0,2473.5,115
22707,2512,2408,0.5,2460.0,104
22708,2157,2213,0.5,2185.0,-56
22709,2429,2261,1.0,2345.0,168
22710,2605,2453,1.0,2529.0,152
22711,2510,2647,0.0,2578.5,-137
22712,2376,2398,0.0,2387.0,-22
22713,2444,2365,1.0,2404.5,79
22714,2518,2343,0.5,2430.5,175
22715,2415,2572,0.0,2493.5,-157
22716,2352,2297,1.0,2324.5,55
22717,2317,2566,0.5,2441.5,-249
22718,2384,2353,1.0,2368.5,31
22719,2599,2315,1.0,2457.0,284
22720,2441,2565,0.5,2503.0,-124
22721,2533,2436,1.0,2484.5,97
22722,2400,2339,0.0,2369.5,61
22723,2502,2370,1.0,2436.0,132
22724,2317,2318,1.0,2317.5,-1
22725,2420,2425,0.0,2422.5,-5
22726,2302,2357,1.0,2329.5,-55
22727,2118,2204,0.5,2161.0,-86
22728,2168,2234,0.5,2201.0,-66
22729,2378,2372,0.5,2375.0,6
22730,2421,2490,0.5,2455.5,-69
22731,2415,2420,0.5,2417.5,-5
22732,2449,2482,0.5,2465.5,-33
22733,2509,2294,1.0,2401.5,215
22734,2398,2292,1.0,2345.0,106
22735,2319,2152,0.0,2235.5,167
22736,2250,2107,0.5,2178.5,143
22737,2377,2211,1.0,2294.0,166
22738,2213,2182,0.0,2197.5,31
22739,2361,2583,0.5,2472.0,-222
22740,2632,2592,1.0,2612.0,40
22741,2340,2421,0.0,2380.5,-81
22742,2474,2411,1.0,2442.5,63
22743,2170,2400,0.5,2285.0,-230
22744,2509,2382,1.0,2445.5,127
22745,2334,2276,1.0,2305.0,58
22746,2440,2202,0.5,2321.0,238
22747,2256,2215,0.5,2235.5,41
22748,2077,1794,1.0,1935.5,283
22749,2573,2448,1.0,2510.5,125
22750,2491,2236,1.0,2363.5,255
22751,2450,2586,0.0,2518.0,-136
22752,2473,2418,1.0,2445.5,55
22753,2374,2379,0.0,2376.5,-5
22754,2279,2312,1.0,2295.5,-33
22755,2399,2300,0.0,2349.5,99
22756,2177,2324,0.0,2250.5,-147
22757,2216,2257,1.0,2236.5,-41
22758,2216,2373,0.0,2294.5,-157
22759,2411,2598,0.5,2504.5,-187
22760,2462,2399,1.0,2430.5,63
22761,2222,2408,1.0,2315.0,-186
22762,2408,2358,0.5,2383.0,50
22763,2468,2437,1.0,2452.5,31
22764,2514,2511,0.0,2512.5,3
22765,2405,2446,0.5,2425.5,-41
22766,2402,2285,1.0,2343.5,117
22767,2200,2446,0.5,2323.0,-246
22768,2400,2379,1.0,2389.5,21
22769,2591,2399,1.0,2495.0,192
22770,2387,2341,1.0,2364.0,46
22771,2552,2507,0.0,2529.5,45
22772,2403,2489,1.0,2446.0,-86
22773,2289,2428,0.5,2358.5,-139
22774,2336,2527,1.0,2431.5,-191
22775,2233,2294,1.0,2263.5,-61
22776,2396,2206,1.0,2301.0,190
22777,2248,2279,1.0,2263.5,-31
22778,2372,2340,0.5,2356.0,32
22779,2523,2308,0.5,2415.5,215
22780,2469,2607,0.5,2538.0,-138
22781,2526,2474,0.5,2500.0,52
22782,2318,2516,0.0,2417.0,-198
22783,2405,2263,0.0,2334.0,142
22784,2369,2348,0.5,2358.5,21
22785,2380,2346,0.5,2363.0,34
22786,2244,2253,0.5,2248.5,-9
22787,2359,2288,0.5,2323.5,71
22788,2486,2620,0.5,2553.0,-134
22789,2140,2291,1.0,2215.5,-151
22790,2452,2488,0.0,2470.0,-36
22791,2768,2877,0.5,2822.5,-109
22792,2805,2787,0.5,2796.0,18
22793,2772,2801,0.0,2786.5,-29
22794,2787,2877,0.5,2832.0,-90
22795,2801,2768,1.0,2784.5,33
22796,2805,2772,1.0,2788.5,33
22797,2877,2801,0.0,2839.0,76
22798,2768,2805,1.0,2786.5,-37
22799,2772,2787,1.0,2779.5,-15
22800,2801,2805,1.0,2803.0,-4
22801,2877,2772,0.5,2824.5,105
22802,2768,2787,0.5,2777.5,-19
22803,2787,2801,0.0,2794.0,-14
22804,2805,2877,0.0,2841.0,-72
22805,2772,2768,1.0,2770.0,4
22806,1985,1891,1.0,1938.0,94
22807,2780,2508,1.0,2644.0,272
22808,2748,2529,1.0,2638.5,219
22809,2535,2741,0.5,2638.0,-206
22810,2750,2534,1.0,2642.0,216
22811,2547,2741,0.5,2644.0,-194
22812,2738,2566,1.0,2652.0,172
22813,2731,2573,1.0,2652.0,158
22814,2570,2727,0.0,2648.5,-157
22815,2716,2574,1.0,2645.0,142
22816,2728,2569,1.0,2648.5,159
22817,2710,2578,1.0,2644.0,132
22818,2708,2567,1.0,2637.5,141
22819,2588,2701,0.5,2644.5,-113
22820,2695,2594,1.0,2644.5,101
22821,2674,2610,0.5,2642.0,64
22822,2702,2627,0.5,2664.5,75
22823,2699,2619,0.5,2659.0,80
22824,2670,2629,0.5,2649.5,41
22825,2666,2625,0.5,2645.5,41
22826,2642,2654,0.5,2648.0,-12
22827,2650,2645,1.0,2647.5,5
22828,2646,2657,0.5,2651.5,-11
22829,2508,2780,0.0,2644.0,-272
22830,2529,2748,0.5,2638.5,-219
22831,2741,2535,0.5,2638.0,206
22832,2534,2750,0.0,2642.0,-216
22833,2741,2547,0.5,2644.0,194
22834,2566,2738,0.5,2652.0,-172
22835,2573,2731,0.0,2652.0,-158
22836,2727,2570,1.0,2648.5,157
22837,2574,2716,0.5,2645.0,-142
22838,2569,2728,0.5,2648.5,-159
22839,2578,2710,0.5,2644.0,-132
22840,2567,2708,0.0,2637.5,-141
22841,2701,2588,0.5,2644.5,113
22842,2594,2695,0.5,2644.5,-101
22843,2610,2674,1.0,2642.0,-64
22844,2627,2702,0.5,2664.5,-75
22845,2619,2699,0.5,2659.0,-80
22846,2629,2670,0.5,2649.5,-41
22847,2625,2666,0.5,2645.5,-41
22848,2654,2642,1.0,2648.0,12
22849,2645,2650,1.0,2647.5,-5
22850,2657,2646,0.5,2651.5,11
22851,2535,2741,0.5,2638.0,-206
22852,2547,2741,0.5,2644.0,-194
22853,2701,2588,0.5,2644.5,113
22854,2702,2627,1.0,2664.5,75
22855,2619,2699,1.0,2659.0,-80
22856,2629,2670,0.0,2649.5,-41
22857,2625,2666,0.5,2645.5,-41
22858,2650,2645,1.0,2647.5,5
22859,2657,2646,0.0,2651.5,11
22860,2741,2535,1.0,2638.0,206
22861,2741,2547,1.0,2644.0,194
22862,2588,2701,1.0,2644.5,-113
22863,2627,2702,1.0,2664.5,-75
22864,2699,2619,0.5,2659.0,80
22865,2670,2629,0.5,2649.5,41
22866,2666,2625,1.0,2645.5,41
22867,2645,2650,0.0,2647.5,-5
22868,2646,2657,1.0,2651.5,-11
22869,2627,2702,0.5,2664.5,-75
22870,2702,2627,1.0,2664.5,75
22871,2648,2827,0.0,2737.5,-179
22872,2792,2633,0.5,2712.5,159
22873,2646,2799,0.5,2722.5,-153
22874,2803,2650,1.0,2726.5,153
22875,2670,2802,0.5,2736.0,-132
22876,2797,2688,0.5,2742.5,109
22877,2651,2781,0.5,2716.0,-130
22878,2804,2654,1.0,2729.0,150
22879,2648,2788,0.5,2718.0,-140
22880,2794,2649,0.0,2721.5,145
22881,2670,2771,0.5,2720.5,-101
22882,2780,2666,0.5,2723.0,114
22883,2668,2777,0.5,2722.5,-109
22884,2748,2675,0.5,2711.5,73
22885,2670,2741,0.5,2705.5,-71
22886,2756,2619,0.5,2687.5,137
22887,2682,2739,0.5,2710.5,-57
22888,2750,2702,0.5,2726.0,48
22889,2610,2745,0.5,2677.5,-135
22890,2741,2617,0.5,2679.0,124
22891,2692,2742,0.5,2717.0,-50
22892,2739,2702,0.0,2720.5,37
22893,2695,2738,0.5,2716.5,-43
22894,2720,2695,1.0,2707.5,25
22895,2731,2694,1.0,2712.5,37
22896,2701,2737,0.5,2719.0,-36
22897,2728,2708,0.5,2718.0,20
22898,2698,2727,0.5,2712.5,-29
22899,2728,2694,0.5,2711.0,34
22900,2710,2716,0.5,2713.0,-6
22901,2728,2714,0.5,2721.0,14
22902,2588,2565,0.5,2576.5,23
22903,2827,2648,1.0,2737.5,179
22904,2633,2792,0.5,2712.5,-159
22905,2799,2646,0.5,2722.5,153
22906,2650,2803,0.5,2726.5,-153
22907,2802,2670,0.5,2736.0,132
22908,2688,2797,0.5,2742.5,-109
22909,2781,2651,0.5,2716.0,130
22910,2654,2804,0.5,2729.0,-150
22911,2788,2648,0.5,2718.0,140
22912,2649,2794,0.5,2721.5,-145
22913,2771,2670,0.5,2720.5,101
22914,2666,2780,1.0,2723.0,-114
22915,2777,2668,0.5,2722.5,109
22916,2675,2748,0.5,2711.5,-73
22917,2741,2670,0.5,2705.5,71
22918,2619,2756,0.5,2687.5,-137
22919,2739,2682,0.5,2710.5,57
22920,2702,2750,0.5,2726.0,-48
22921,2745,2610,0.5,2677.5,135
22922,2617,2741,0.5,2679.0,-124
22923,2742,2692,0.5,2717.0,50
22924,2702,2739,0.5,2720.5,-37
22925,2738,2695,0.0,2716.5,43
22926,2695,2720,1.0,2707.5,-25
22927,2694,2731,0.5,2712.5,-37
22928,2737,2701,0.5,2719.0,36
22929,2708,2728,0.5,2718.0,-20
22930,2727,2698,0.5,2712.5,29
22931,2694,2728,0.5,2711.0,-34
22932,2716,2710,1.0,2713.0,6
22933,2714,2728,0.5,2721.0,-14
22934,2565,2588,1.0,2576.5,-23
22935,2792,2633,0.5,2712.5,159
22936,2646,2799,0.5,2722.5,-153
22937,2802,2670,0.5,2736.0,132
22938,2797,2688,0.0,2742.5,109
22939,2781,2651,1.0,2716.0,130
22940,2648,2788,0.5,2718.0,-140
22941,2670,2771,0.0,2720.5,-101
22942,2668,2777,0.5,2722.5,-109
22943,2675,2748,1.0,2711.5,-73
22944,2670,2741,0.5,2705.5,-71
22945,2756,2619,1.0,2687.5,137
22946,2682,2739,0.5,2710.5,-57
22947,2702,2750,0.5,2726.0,-48
22948,2745,2610,0.5,2677.5,135
22949,2617,2741,0.5,2679.0,-124
22950,2692,2742,1.0,2717.0,-50
22951,2720,2695,1.0,2707.5,25
22952,2737,2701,0.0,2719.0,36
22953,2728,2708,0.5,2718.0,20
22954,2698,2727,0.5,2712.5,-29
22955,2728,2694,0.0,2711.0,34
22956,2714,2728,0.5,2721.0,-14
22957,2633,2792,0.5,2712.5,-159
22958,2799,2646,0.5,2722.5,153
22959,2670,2802,0.5,2736.0,-132
22960,2688,2797,1.0,2742.5,-109
22961,2651,2781,0.5,2716.0,-130
22962,2788,2648,1.0,2718.0,140
22963,2771,2670,0.5,2720.5,101
22964,2777,2668,0.5,2722.5,109
22965,2748,2675,0.5,2711.5,73
22966,2741,2670,1.0,2705.5,71
22967,2619,2756,0.5,2687.5,-137
22968,2739,2682,0.0,2710.5,57
22969,2750,2702,0.5,2726.0,48
22970,2610,2745,0.0,2677.5,-135
22971,2741,2617,0.0,2679.0,124
22972,2742,2692,1.0,2717.0,50
22973,2695,2720,0.0,2707.5,-25
22974,2701,2737,0.5,2719.0,-36
22975,2708,2728,0.5,2718.0,-20
22976,2727,2698,0.5,2712.5,29
22977,2694,2728,1.0,2711.0,-34
22978,2728,2714,0.0,2721.0,14
22979,2633,2792,0.0,2712.5,-159
22980,2799,2646,1.0,2722.5,153
22981,2670,2802,0.0,2736.0,-132
22982,2668,2777,0.0,2722.5,-109
22983,2702,2750,1.0,2726.0,-48
22984,2742,2692,1.0,2717.0,50
22985,2708,2728,0.0,2718.0,-20
22986,2698,2727,0.5,2712.5,-29
22987,2792,2633,1.0,2712.5,159
22988,2646,2799,0.0,2722.5,-153
22989,2802,2670,1.0,2736.0,132
22990,2777,2668,1.0,2722.5,109
22991,2750,2702,0.0,2726.0,48
22992,2692,2742,1.0,2717.0,-50
22993,2728,2708,0.0,2718.0,20
22994,2727,2698,1.0,2712.5,29
22995,2692,2742,1.0,2717.0,-50
22996,2708,2728,0.0,2718.0,-20
22997,2742,2692,0.5,2717.0,50
22998,2728,2708,1.0,2718.0,20
22999,2827,2714,0.0,2770.5,113
23000,2716,2792,0.0,2754.0,-76
23001,2799,2694,0.5,2746.5,105
23002,2727,2803,0.5,2765.0,-76
23003,2802,2728,1.0,2765.0,74
23004,2701,2688,0.5,2694.5,13
23005,2781,2731,0.5,2756.0,50
23006,2565,2804,0.5,2684.5,-239
23007,2788,2720,0.5,2754.0,68
23008,2695,2649,1.0,2672.0,46
23009,2771,2702,0.5,2736.5,69
23010,2692,2666,0.5,2679.0,26
23011,2777,2617,0.5,2697.0,160
23012,2745,2675,0.5,2710.0,70
23013,2741,2702,0.5,2721.5,39
23014,2682,2756,0.5,2719.0,-74
23015,2714,2827,0.5,2770.5,-113
23016,2792,2716,0.5,2754.0,76
23017,2694,2799,0.5,2746.5,-105
23018,2803,2727,0.0,2765.0,76
23019,2728,2802,1.0,2765.0,-74
23020,2688,2701,0.0,2694.5,-13
23021,2731,2781,1.0,2756.0,-50
23022,2804,2565,0.5,2684.5,239
23023,2720,2788,0.5,2754.0,-68
23024,2649,2695,0.0,2672.0,-46
23025,2702,2771,0.5,2736.5,-69
23026,2666,2692,1.0,2679.0,-26
23027,2617,2777,0.5,2697.0,-160
23028,2675,2745,0.5,2710.0,-70
23029,2702,2741,0.5,2721.5,-39
23030,2756,2682,1.0,2719.0,74
23031,2694,2799,0.5,2746.5,-105
23032,2802,2728,0.5,2765.0,74
23033,2565,2804,0.0,2684.5,-239
23034,2788,2720,0.5,2754.0,68
23035,2702,2771,0.5,2736.5,-69
23036,2777,2617,1.0,2697.0,160
23037,2675,2745,1.0,2710.0,-70
23038,2741,2702,0.5,2721.5,39
23039,2799,2694,0.0,2746.5,105
23040,2728,2802,0.5,2765.0,-74
23041,2804,2565,0.5,2684.5,239
23042,2720,2788,0.5,2754.0,-68
23043,2771,2702,1.0,2736.5,69
23044,2617,2777,1.0,2697.0,-160
23045,2745,2675,0.5,2710.0,70
23046,2702,2741,1.0,2721.5,-39
23047,2802,2728,1.0,2765.0,74
23048,2720,2788,0.5,2754.0,-68
23049,2777,2617,1.0,2697.0,160
23050,2728,2802,1.0,2765.0,-74
23051,2788,2720,1.0,2754.0,68
23052,2617,2777,0.0,2697.0,-160
23053,2728,2802,0.0,2765.0,-74
23054,2802,2728,0.5,2765.0,74
23055,1928,2197,0.0,2062.5,-269
23056,2840,2706,1.0,2773.0,134
23057,2773,2736,0.5,2754.5,37
23058,2702,2750,0.5,2726.0,-48
23059,2695,2808,0.0,2751.5,-113
23060,2653,2755,0.0,2704.0,-102
23061,2766,2785,0.5,2775.5,-19
23062,2780,2767,0.5,2773.5,13
23063,2767,2840,0.5,2803.5,-73
23064,2706,2773,0.5,2739.5,-67
23065,2755,2780,0.0,2767.5,-25
23066,2785,2653,0.0,2719.0,132
23067,2808,2766,1.0,2787.0,42
23068,2750,2695,1.0,2722.5,55
23069,2736,2702,0.5,2719.0,34
23070,2780,2840,0.5,2810.0,-60
23071,2773,2767,1.0,2770.0,6
23072,2695,2736,0.5,2715.5,-41
23073,2653,2808,0.5,2730.5,-155
23074,2755,2785,0.5,2770.0,-30
23075,2766,2750,0.5,2758.0,16
23076,2702,2706,0.0,2704.0,-4
23077,2840,2773,0.5,2806.5,67
23078,2767,2702,0.5,2734.5,65
23079,2706,2695,1.0,2700.5,11
23080,2785,2780,1.0,2782.5,5
23081,2808,2755,0.5,2781.5,53
23082,2736,2766,0.5,2751.0,-30
23083,2750,2653,0.0,2701.5,97
23084,2702,2840,1.0,2771.0,-138
23085,2780,2773,1.0,2776.5,7
23086,2653,2736,1.0,2694.5,-83
23087,2766,2706,0.5,2736.0,60
23088,2785,2808,0.5,2796.5,-23
23089,2755,2750,0.5,2752.5,5
23090,2695,2767,0.5,2731.0,-72
23091,2612,2608,1.0,2610.0,4
23092,2603,2612,1.0,2607.5,-9
23093,2642,2667,0.0,2654.5,-25
23094,2467,2605,0.0,2536.0,-138
23095,2370,2667,0.0,2518.5,-297
23096,2665,2584,1.0,2624.5,81
23097,2499,2697,0.0,2598.0,-198
23098,2612,2499,1.0,2555.5,113
23099,2667,2467,1.0,2567.0,200
23100,2584,2370,1.0,2477.0,214
23101,2697,2612,0.5,2654.5,85
23102,2608,2665,0.0,2636.5,-57
23103,2605,2603,0.5,2604.0,2
23104,2667,2642,0.5,2654.5,25
23105,2667,2584,0.0,2625.5,83
23106,2665,2697,1.0,2681.0,-32
23107,2499,2605,0.5,2552.0,-106
23108,2370,2608,0.0,2489.0,-238
23109,2612,2612,1.0,2612.0,0
23110,2642,2467,1.0,2554.5,175
23111,2603,2667,1.0,2635.0,-64
23112,2467,2603,0.5,2535.0,-136
23113,2608,2667,0.0,2637.5,-59
23114,2697,2370,1.0,2533.5,327
23115,2667,2499,1.0,2583.0,168
23116,2584,2642,0.5,2613.0,-58
23117,2612,2665,0.0,2638.5,-53
23118,2605,2612,0.5,2608.5,-7
23119,2370,2612,0.5,2491.0,-242
23120,2665,2605,0.5,2635.0,60
23121,2612,2667,0.5,2639.5,-55
23122,2642,2603,0.5,2622.5,39
23123,2667,2697,0.5,2682.0,-30
23124,2584,2608,0.5,2596.0,-24
23125,2499,2467,1.0,2483.0,32
23126,2083,1960,1.0,2021.5,123
23127,2731,2723,0.5,2727.0,8
23128,2733,2671,0.5,2702.0,62
23129,2740,2724,1.0,2732.0,16
23130,1957,1767,0.0,1862.0,190
23131,2808,2675,1.0,2741.5,133
23132,2617,2789,0.5,2703.0,-172
23133,2782,2512,1.0,2647.0,270
23134,2582,2679,1.0,2630.5,-97
23135,2739,2602,1.0,2670.5,137
23136,2622,2709,0.5,2665.5,-87
23137,2675,2558,1.0,2616.5,117
23138,2526,2647,0.0,2586.5,-121
23139,2808,2583,1.0,2695.5,225
23140,2567,2731,0.5,2649.0,-164
23141,2740,2568,0.5,2654.0,172
23142,2459,2754,0.0,2606.5,-295
23143,2485,2722,0.5,2603.5,-237
23144,2666,2453,0.5,2559.5,213
23145,2406,2696,0.0,2551.0,-290
23146,2688,2401,1.0,2544.5,287
23147,2752,2857,0.5,2804.5,-105
23148,2651,2671,0.5,2661.0,-20
23149,2669,2570,1.0,2619.5,99
23150,2537,2640,1.0,2588.5,-103
23151,2638,2738,0.0,2688.0,-100
23152,2665,2609,0.0,2637.0,56
23153,2499,2635,0.5,2567.0,-136
23154,2666,2519,0.5,2592.5,147
23155,2635,2665,0.5,2650.0,-30
23156,2609,2652,0.0,2630.5,-43
23157,2616,2601,0.0,2608.5,15
23158,2575,2565,0.0,2570.0,10
23159,2631,2640,0.5,2635.5,-9
23160,2684,2601,1.0,2642.5,83
23161,2571,2614,0.5,2592.5,-43
23162,2585,2565,0.0,2575.0,20
23163,2813,2742,0.5,2777.5,71
23164,2651,2617,0.0,2634.0,34
23165,2664,2591,1.0,2627.5,73
23166,2519,2623,0.5,2571.0,-104
23167,2736,2716,1.0,2726.0,20
23168,2662,2675,0.5,2668.5,-13
23169,2646,2630,1.0,2638.0,16
23170,2566,2639,0.5,2602.5,-73
23171,2723,2737,0.5,2730.0,-14
23172,2753,2633,1.0,2693.0,120
23173,2435,2725,0.5,2580.0,-290
23174,2717,2448,1.0,2582.5,269
23175,2720,2618,1.0,2669.0,102
23176,2595,2636,0.5,2615.5,-41
23177,2581,2524,0.5,2552.5,57
23178,2572,2553,1.0,2562.5,19
23179,2668,2648,1.0,2658.0,20
23180,2584,2608,1.0,2596.0,-24
23181,2622,2543,1.0,2582.5,79
23182,2437,2584,0.5,2510.5,-147
23183,2652,2696,0.5,2674.0,-44
23184,2583,2599,0.0,2591.0,-16
23185,2591,2582,0.5,2586.5,9
23186,2450,2547,0.0,2498.5,-97
23187,2511,2673,0.0,2592.0,-162
23188,2651,2444,1.0,2547.5,207
23189,2413,2476,0.5,2444.5,-63
23190,2404,2379,1.0,2391.5,25
23191,2566,2554,1.0,2560.0,12
23192,2546,2566,0.0,2556.0,-20
23193,2478,2508,0.5,2493.0,-30
23194,2444,2435,0.0,2439.5,9
23195,2555,2618,0.5,2586.5,-63
23196,2641,2559,0.5,2600.0,82
23197,2475,2470,0.0,2472.5,5
23198,2318,2459,1.0,2388.5,-141
23199,2697,2634,0.5,2665.5,63
23200,2616,2573,1.0,2594.5,43
23201,2448,2523,0.5,2485.5,-75
23202,2499,2430,0.5,2464.5,69
23203,2650,2755,0.5,2702.5,-105
23204,2611,2662,0.0,2636.5,-51
23205,2537,2640,0.5,2588.5,-103
23206,2592,2459,1.0,2525.5,133
23207,2612,2384,0.0,2498.0,228
23208,2301,2552,0.0,2426.5,-251
23209,2509,2232,1.0,2370.5,277
23210,2173,2577,0.0,2375.0,-404
23211,2560,2531,0.5,2545.5,29
23212,2550,2492,1.0,2521.0,58
23213,2447,2513,1.0,2480.0,-66
23214,2482,2455,1.0,2468.5,27
23215,2585,2687,0.5,2636.0,-102
23216,2619,2518,1.0,2568.5,101
23217,2548,2630,0.0,2589.0,-82
23218,2605,2458,1.0,2531.5,147
23219,2565,2604,0.5,2584.5,-39
23220,2513,2437,1.0,2475.0,76
23221,2519,2594,0.5,2556.5,-75
23222,2542,2351,0.5,2446.5,191
23223,2574,2590,0.5,2582.0,-16
23224,2606,2547,1.0,2576.5,59
23225,2545,2585,0.5,2565.0,-40
23226,2536,2442,0.5,2489.0,94
23227,2642,2484,0.5,2563.0,158
23228,2503,2583,0.0,2543.0,-80
23229,2460,2432,0.5,2446.0,28
23230,2265,2432,0.5,2348.5,-167
23231,2406,2564,0.5,2485.0,-158
23232,2415,2387,0.0,2401.0,28
23233,2294,2374,0.5,2334.0,-80
23234,2322,2323,1.0,2322.5,-1
23235,2534,2548,0.5,2541.0,-14
23236,2499,2517,0.0,2508.0,-18
23237,2482,2484,0.0,2483.0,-2
23238,2464,2457,0.5,2460.5,7
23239,2687,2473,1.0,2580.0,214
23240,2501,2654,0.5,2577.5,-153
23241,2626,2407,1.0,2516.5,219
23242,2368,2618,1.0,2493.0,-250
23243,2595,2257,1.0,2426.0,338
23244,2248,2535,0.0,2391.5,-287
23245,2526,2196,1.0,2361.0,330
23246,2203,2522,1.0,2362.5,-319
23247,2431,2550,0.0,2490.5,-119
23248,2521,2488,0.5,2504.5,33
23249,2512,2427,0.0,2469.5,85
23250,1574,2413,0.0,1993.5,-839
23251,2493,2488,0.0,2490.5,5
23252,2351,2280,1.0,2315.5,71
23253,2340,2276,1.0,2308.0,64
23254,2239,2241,1.0,2240.0,-2
23255,2436,2487,1.0,2461.5,-51
23256,2367,2378,0.0,2372.5,-11
23257,2434,2366,1.0,2400.0,68
23258,2343,2245,1.0,2294.0,98
23259,2610,2556,0.5,2583.0,54
23260,2321,2436,1.0,2378.5,-115
23261,2150,2327,0.0,2238.5,-177
23262,1860,2119,1.0,1989.5,-259
23263,2348,2391,0.5,2369.5,-43
23264,2481,2175,1.0,2328.0,306
23265,2219,2387,0.0,2303.0,-168
23266,2214,2194,0.0,2204.0,20
23267,2390,2580,0.0,2485.0,-190
23268,2458,2433,1.0,2445.5,25
23269,2350,2468,1.0,2409.0,-118
23270,2354,2127,0.5,2240.5,227
23271,2446,2490,0.0,2468.0,-44
23272,2510,2492,0.5,2501.0,18
23273,2513,2465,1.0,2489.0,48
23274,2427,2444,0.0,2435.5,-17
23275,2170,2558,0.0,2364.0,-388
23276,2401,1997,1.0,2199.0,404
23277,2009,2398,1.0,2203.5,-389
23278,2282,1842,0.5,2062.0,440
23279,2661,2405,1.0,2533.0,256
23280,2363,2451,0.0,2407.0,-88
23281,2431,2200,1.0,2315.5,231
23282,2114,2419,0.0,2266.5,-305
23283,2345,2641,0.0,2493.0,-296
23284,2545,2239,1.0,2392.0,306
23285,2187,2523,0.0,2355.0,-336
23286,2491,2067,1.0,2279.0,424
23287,2637,2120,1.0,2378.5,517
23288,2020,2439,0.5,2229.5,-419
23289,2345,2015,1.0,2180.0,330
23290,2052,2233,0.0,2142.5,-181
23291,2314,2398,0.0,2356.0,-84
23292,2340,2255,1.0,2297.5,85
23293,2308,2223,1.0,2265.5,85
23294,2100,2345,1.0,2222.5,-245
23295,2131,2422,0.0,2276.5,-291
23296,2342,2018,1.0,2180.0,324
23297,1879,2335,0.0,2107.0,-456
23298,2407,2245,0.0,2326.0,162
23299,2253,2289,1.0,2271.0,-36
23300,2148,2294,1.0,2221.0,-146
23301,2455,2354,1.0,2404.5,101
23302,2260,2454,0.0,2357.0,-194
23303,2393,2142,1.0,2267.5,251
23304,2123,2315,0.0,2219.0,-192
23305,2305,2340,0.0,2322.5,-35
23306,2336,2208,0.0,2272.0,128
23307,2077,2334,0.0,2205.5,-257
23308,2259,2027,1.0,2143.0,232
23309,2192,2199,0.5,2195.5,-7
23310,2216,1900,1.0,2058.0,316
23311,1890,2183,0.0,2036.5,-293
23312,2167,2030,1.0,2098.5,137
23313,2315,2334,0.5,2324.5,-19
23314,2111,2276,0.0,2193.5,-165
23315,2274,2018,0.5,2146.0,256
23316,2343,2208,0.0,2275.5,135
23317,2451,2058,0.5,2254.5,393
23318,2065,2219,0.0,2142.0,-154
23319,2401,2172,1.0,2286.5,229
23320,1983,2049,1.0,2016.0,-66
23321,2238,2416,0.5,2327.0,-178
23322,2350,2117,1.0,2233.5,233
23323,2146,2247,1.0,2196.5,-101
23324,2177,2074,0.5,2125.5,103
23325,2329,2172,1.0,2250.5,157
23326,2151,2374,0.0,2262.5,-223
23327,2348,2068,1.0,2208.0,280
23328,2017,2267,0.0,2142.0,-250
23329,2238,2377,1.0,2307.5,-139
23330,2310,2025,1.0,2167.5,285
23331,1950,2291,0.5,2120.5,-341
23332,2054,2111,1.0,2082.5,-57
23333,2183,2453,0.5,2318.0,-270
23334,2434,2128,0.5,2281.0,306
23335,2199,2340,0.0,2269.5,-141
23336,2230,2116,1.0,2173.0,114
23337,2285,2396,0.0,2340.5,-111
23338,2239,2248,1.0,2243.5,-9
23339,2235,2227,1.0,2231.0,8
23340,2122,2205,0.5,2163.5,-83
23341,2161,2099,1.0,2130.0,62
23342,2034,2251,0.0,2142.5,-217
23343,2361,2013,0.0,2187.0,348
23344,2017,2236,0.5,2126.5,-219
23345,2261,2348,0.5,2304.5,-87
23346,2312,2251,1.0,2281.5,61
23347,2096,2309,0.5,2202.5,-213
23348,2341,2094,1.0,2217.5,247
23349,2458,2190,1.0,2324.0,268
23350,2034,2328,0.0,2181.0,-294
23351,2295,2164,1.0,2229.5,131
23352,2042,2233,0.0,2137.5,-191
23353,2269,2388,1.0,2328.5,-119
23354,2082,1979,0.0,2030.5,103
23355,2175,2229,1.0,2202.0,-54
23356,2373,2012,0.0,2192.5,361
23357,2503,2482,1.0,2492.5,21
23358,2100,2190,1.0,2145.0,-90
23359,2153,2142,0.5,2147.5,11
23360,2215,2202,1.0,2208.5,13
23361,1930,2003,0.0,1966.5,-73
23362,2158,2166,0.0,2162.0,-8
23363,1972,2119,0.0,2045.5,-147
23364,2176,2119,1.0,2147.5,57
23365,2097,1655,0.0,1876.0,442
23366,1766,2076,0.5,1921.0,-310
23367,1624,2069,1.0,1846.5,-445
23368,1992,1726,0.0,1859.0,266
23369,1911,2044,0.5,1977.5,-133
23370,1933,1840,1.0,1886.5,93
23371,2092,2053,1.0,2072.5,39
23372,1868,1944,0.0,1906.0,-76
23373,2023,2036,0.0,2029.5,-13
23374,2337,2104,0.5,2220.5,233
23375,2392,2318,0.0,2355.0,74
23376,2270,2289,0.0,2279.5,-19
23377,2114,2174,0.0,2144.0,-60
23378,2269,2189,0.0,2229.0,80
23379,2168,2293,0.5,2230.5,-125
23380,2099,2149,1.0,2124.0,-50
23381,2087,2016,1.0,2051.5,71
23382,1966,2014,1.0,1990.0,-48
23383,1850,1999,1.0,1924.5,-149
23384,1940,1909,0.0,1924.5,31
23385,1606,2234,0.0,1920.0,-628
23386,2150,2439,1.0,2294.5,-289
23387,2060,2058,1.0,2059.0,2
23388,2216,2116,0.0,2166.0,100
23389,1991,2056,0.0,2023.5,-65
23390,2002,1917,1.0,1959.5,85
23391,2007,2034,0.0,2020.5,-27
23392,1993,2169,0.5,2081.0,-176
23393,1963,2082,0.5,2022.5,-119
23394,1879,1894,0.5,1886.5,-15
23395,1852,2070,0.0,1961.0,-218
23396,2204,2063,0.5,2133.5,141
23397,2032,2047,0.5,2039.5,-15
23398,1855,2145,0.0,2000.0,-290
23399,2119,1880,1.0,1999.5,239
23400,1853,1929,0.0,1891.0,-76
23401,1893,1692,0.0,1792.5,201
23402,1964,1951,1.0,1957.5,13
23403,1992,1675,0.5,1833.5,317
23404,1908,1914,0.5,1911.0,-6
23405,1889,1977,0.0,1933.0,-88
23406,2050,1842,1.0,1946.0,208
23407,1825,1932,1.0,1878.5,-107
23408,2044,1867,1.0,1955.5,177
23409,1869,2060,0.0,1964.5,-191
23410,2049,1915,0.0,1982.0,134
23411,1782,1971,1.0,1876.5,-189
23412,1976,1671,1.0,1823.5,305
23413,2115,1995,1.0,2055.0,120
23414,1851,1880,0.0,1865.5,-29
23415,1918,1939,1.0,1928.5,-21
23416,2339,2013,1.0,2176.0,326
23417,1986,2215,0.0,2100.5,-229
23418,2051,1812,0.5,1931.5,239
23419,1717,2126,0.0,1921.5,-409
23420,1793,1924,0.0,1858.5,-131
23421,1861,1870,0.5,1865.5,-9
23422,1713,1889,0.0,1801.0,-176
23423,1670,1322,1.0,1496.0,348
23424,2054,2095,0.5,2074.5,-41
23425,1943,1787,1.0,1865.0,156
23426,1923,1663,0.0,1793.0,260
23427,1736,1877,0.5,1806.5,-141
23428,1800,1685,1.0,1742.5,115
23429,1668,1561,1.0,1614.5,107
23430,2205,2036,0.0,2120.5,169
23431,2024,1576,1.0,1800.0,448
23432,1952,1912,0.0,1932.0,40
23433,2128,1760,1.0,1944.0,368
23434,1963,2000,1.0,1981.5,-37
23435,1758,1857,0.5,1807.5,-99
23436,1610,1798,0.5,1704.0,-188
23437,1732,1782,1.0,1757.0,-50
23438,1730,1662,1.0,1696.0,68
23439,1678,1516,0.0,1597.0,162
23440,1615,1447,1.0,1531.0,168
23441,1712,1768,0.0,1740.0,-56
23442,2354,2254,0.5,2304.0,100
23443,2096,2339,0.0,2217.5,-243
23444,2192,2153,0.0,2172.5,39
23445,2259,2272,0.0,2265.5,-13
23446,2439,2398,0.0,2418.5,41
23447,2402,2320,0.5,2361.0,82
23448,2326,2322,0.0,2324.0,4
23449,2283,2259,1.0,2271.0,24
23450,2658,2538,0.5,2598.0,120
23451,2520,2583,0.0,2551.5,-63
23452,2475,2475,1.0,2475.0,0
23453,2484,2417,1.0,2450.5,67
23454,2467,2437,0.5,2452.0,30
23455,2429,2372,1.0,2400.5,57
23456,2379,2346,0.0,2362.5,33
23457,2246,2355,1.0,2300.5,-109
23458,2550,2515,1.0,2532.5,35
23459,2386,2539,0.5,2462.5,-153
23460,2475,2358,0.5,2416.5,117
23461,2232,2457,0.0,2344.5,-225
23462,2295,1993,0.5,2144.0,302
23463,1923,2361,0.5,2142.0,-438
23464,2339,1994,1.0,2166.5,345
23465,1945,2302,0.0,2123.5,-357
23466,2444,2542,0.5,2493.0,-98
23467,2408,2366,0.0,2387.0,42
23468,2449,2402,0.0,2425.5,47
23469,2379,2365,0.5,2372.0,14
23470,2338,2368,0.0,2353.0,-30
23471,2306,2325,0.0,2315.5,-19
23472,2316,2258,0.5,2287.0,58
23473,2231,2249,0.0,2240.0,-18
23474,2408,2422,0.5,2415.0,-14
23475,2391,2322,0.5,2356.5,69
23476,2290,2288,1.0,2289.0,2
23477,2147,2216,0.0,2181.5,-69
23478,2486,2331,1.0,2408.5,155
23479,2214,2463,0.5,2338.5,-249
23480,2474,2220,1.0,2347.0,254
23481,2021,2419,0.5,2220.0,-398
23482,2429,2304,1.0,2366.5,125
23483,2219,2335,0.0,2277.0,-116
23484,2314,2234,1.0,2274.0,80
23485,2247,2308,0.5,2277.5,-61
23486,2318,2378,0.5,2348.0,-60
23487,2272,2221,0.0,2246.5,51
23488,2161,2189,1.0,2175.0,-28
23489,2219,2207,1.0,2213.0,12
23490,2474,2362,0.5,2418.0,112
23491,2301,2383,1.0,2342.0,-82
23492,2342,2232,0.5,2287.0,110
23493,2235,2324,1.0,2279.5,-89
23494,2281,2536,0.0,2408.5,-255
23495,2421,2128,1.0,2274.5,293
23496,2119,2298,1.0,2208.5,-179
23497,2189,1965,1.0,2077.0,224
23498,2315,2245,1.0,2280.0,70
23499,2267,2281,0.5,2274.0,-14
23500,2276,2201,0.5,2238.5,75
23501,2137,2269,0.0,2203.0,-132
23502,2382,2389,0.5,2385.5,-7
23503,2275,2170,0.5,2222.5,105
23504,2222,2162,0.5,2192.0,60
23505,2065,2087,0.0,2076.0,-22
23506,2243,2075,0.5,2159.0,168
23507,2046,2306,1.0,2176.0,-260
23508,2241,2106,1.0,2173.5,135
23509,2011,2178,1.0,2094.5,-167
23510,2394,2422,0.5,2408.0,-28
23511,2369,2353,0.5,2361.0,16
23512,2331,2277,1.0,2304.0,54
23513,2188,2395,0.5,2291.5,-207
23514,2324,2332,0.5,2328.0,-8
23515,2247,2289,0.0,2268.0,-42
23516,2324,2186,1.0,2255.0,138
23517,2109,2223,0.0,2166.0,-114
23518,2332,2279,0.5,2305.5,53
23519,2176,2259,0.0,2217.5,-83
23520,2079,2125,1.0,2102.0,-46
23521,2086,2024,1.0,2055.0,62
23522,2444,2360,1.0,2402.0,84
23523,2271,2222,0.5,2246.5,49
23524,1996,2234,1.0,2115.0,-238
23525,2230,1913,0.5,2071.5,317
23526,2402,2136,1.0,2269.0,266
23527,2043,2150,0.0,2096.5,-107
23528,2096,2142,1.0,2119.0,-46
23529,2006,2053,0.0,2029.5,-47
23530,2238,2268,0.5,2253.0,-30
23531,2093,2095,1.0,2094.0,-2
23532,2003,2079,1.0,2041.0,-76
23533,2030,2023,0.0,2026.5,7
23534,2183,2092,1.0,2137.5,91
23535,2027,2209,1.0,2118.0,-182
23536,2201,2019,1.0,2110.0,182
23537,1840,2194,0.0,2017.0,-354
23538,2353,2386,0.5,2369.5,-33
23539,2323,2262,0.5,2292.5,61
23540,1892,2017,0.5,1954.5,-125
23541,2133,1883,0.0,2008.0,250
23542,2033,2230,0.0,2131.5,-197
23543,2147,2063,1.0,2105.0,84
23544,1886,1994,0.0,1940.0,-108
23545,1780,1724,1.0,1752.0,56
23546,2059,2389,0.0,2224.0,-330
23547,2376,2043,1.0,2209.5,333
23548,1953,2268,0.0,2110.5,-315
23549,2183,1921,0.5,2052.0,262
23550,2285,2149,0.0,2217.0,136
23551,2025,2031,1.0,2028.0,-6
23552,1994,1830,1.0,1912.0,164
23553,1825,2103,0.5,1964.0,-278
23554,2276,2125,0.0,2200.5,151
23555,2078,2205,0.5,2141.5,-127
23556,2164,1789,1.0,1976.5,375
23557,1855,2101,0.0,1978.0,-246
23558,1803,2367,0.0,2085.0,-564
23559,2092,1814,1.0,1953.0,278
23560,1922,2064,0.0,1993.0,-142
23561,1992,1701,1.0,1846.5,291
23562,2181,2199,0.5,2190.0,-18
23563,1667,2167,0.0,1917.0,-500
23564,2139,1623,0.5,1881.0,516
23565,2249,2060,1.0,2154.5,189
23566,2194,2182,0.0,2188.0,12
23567,2383,2411,1.0,2397.0,-28
23568,2062,2035,1.0,2048.5,27
23569,2355,2279,1.0,2317.0,76
23570,2046,2159,0.0,2102.5,-113
23571,2273,2140,0.5,2206.5,133
23572,1793,2015,0.5,1904.0,-222
23573,2254,2085,1.0,2169.5,169
23574,1894,2381,0.0,2137.5,-487
23575,2047,2216,1.0,2131.5,-169
23576,1643,1679,0.5,1661.0,-36
23577,1932,1992,1.0,1962.0,-60
23578,2223,2252,1.0,2237.5,-29
23579,1881,1947,0.0,1914.0,-66
23580,1957,2127,1.0,2042.0,-170
23581,2175,1807,1.0,1991.0,368
23582,1834,1831,0.0,1832.5,3
23583,2113,2106,1.0,2109.5,7
23584,1703,1732,0.5,1717.5,-29
23585,2142,1949,1.0,2045.5,193
23586,1857,1903,0.0,1880.0,-46
23587,1773,1908,0.0,1840.5,-135
23588,1822,1833,1.0,1827.5,-11
23589,2048,1641,1.0,1844.5,407
23590,2002,2129,1.0,2065.5,-127
23591,1913,1868,1.0,1890.5,45
23592,1993,1965,0.5,1979.0,28
23593,2040,1836,0.5,1938.0,204
23594,1953,2159,0.5,2056.0,-206
23595,1681,1721,0.0,1701.0,-40
23596,1745,1844,0.5,1794.5,-99
23597,2204,1392,1.0,1798.0,812
23598,1674,1851,0.5,1762.5,-177
23599,2117,1983,0.0,2050.0,134
23600,1725,1684,1.0,1704.5,41
23601,2002,1928,0.5,1965.0,74
23602,2105,2104,0.0,2104.5,1
23603,1718,1888,1.0,1803.0,-170
23604,1883,1954,0.0,1918.5,-71
23605,1778,1631,0.0,1704.5,147
23606,2119,2199,0.0,2159.0,-80
23607,1703,1802,0.0,1752.5,-99
23608,2000,2035,1.0,2017.5,-35
23609,2015,1636,1.0,1825.5,379
23610,1781,1948,0.0,1864.5,-167
23611,1735,2073,0.0,1904.0,-338
23612,1795,1837,0.5,1816.0,-42
23613,1897,1881,1.0,1889.0,16
23614,1460,1515,0.0,1487.5,-55
23615,1751,1926,1.0,1838.5,-175
23616,1351,1735,0.0,1543.0,-384
23617,1808,1935,0.0,1871.5,-127
23618,1783,1738,1.0,1760.5,45
23619,1766,1746,0.5,1756.0,20
23620,1529,1815,0.0,1672.0,-286
23621,1716,1731,1.0,1723.5,-15
23622,1584,1594,1.0,1589.0,-10
23623,1574,1750,0.0,1662.0,-176
23624,1983,2017,0.5,2000.0,-34
23625,1577,1668,0.5,1622.5,-91
23626,1584,1626,0.0,1605.0,-42
23627,1660,1606,0.0,1633.0,54
23628,2001,1547,1.0,1774.0,454
23629,1983,1824,1.0,1903.5,159
23630,1728,2064,1.0,1896.0,-336
23631,1896,1703,1.0,1799.5,193
23632,1783,1812,0.5,1797.5,-29
23633,1778,1857,0.5,1817.5,-79
23634,1528,1699,1.0,1613.5,-171
23635,1704,1584,1.0,1644.0,120
23636,1492,1826,0.0,1659.0,-334
23637,1797,1603,0.5,1700.0,194
23638,1948,1671,1.0,1809.5,277
23639,1864,1907,1.0,1885.5,-43
23640,1786,1625,0.0,1705.5,161
23641,1497,1654,0.0,1575.5,-157
23642,2200,1894,0.5,2047.0,306
23643,1737,1910,0.5,1823.5,-173
23644,1922,1617,1.0,1769.5,305
23645,1490,1807,0.0,1648.5,-317
23646,1889,1777,0.5,1833.0,112
23647,1531,1899,1.0,1715.0,-368
23648,1768,1700,0.0,1734.0,68
23649,1736,1781,0.0,1758.5,-45
23650,1971,2023,1.0,1997.0,-52
23651,1662,1759,0.5,1710.5,-97
23652,1719,1770,0.0,1744.5,-51
23653,1696,1794,1.0,1745.0,-98
23654,1876,1787,1.0,1831.5,89
23655,1773,1748,0.0,1760.5,25
23656,1825,1942,0.5,1883.5,-117
23657,1724,1594,1.0,1659.0,130
23658,1585,1637,1.0,1611.0,-52
23659,1350,1476,0.5,1413.0,-126
23660,1802,1491,1.0,1646.5,311
23661,1794,1763,1.0,1778.5,31
23662,1821,1611,0.5,1716.0,210
23663,1605,1616,0.5,1610.5,-11
23664,1668,1403,0.0,1535.5,265
23665,1574,1474,1.0,1524.0,100
23666,1928,1605,1.0,1766.5,323
23667,1740,1632,0.0,1686.0,108
23668,1679,1535,0.0,1607.0,144
23669,1480,1488,0.5,1484.0,-8
23670,1689,1871,1.0,1780.0,-182
23671,1517,1621,0.0,1569.0,-104
23672,1563,1659,1.0,1611.0,-96
23673,1232,1632,0.0,1432.0,-400
23674,1613,1372,1.0,1492.5,241
23675,1407,1559,1.0,1483.0,-152
23676,1555,1561,0.0,1558.0,-6
23677,1775,1450,1.0,1612.5,325
23678,1570,1151,1.0,1360.5,419
23679,1499,1488,1.0,1493.5,11
23680,1591,1642,1.0,1616.5,-51
23681,1419,1542,1.0,1480.5,-123
23682,1528,1312,0.5,1420.0,216
23683,1226,1482,0.0,1354.0,-256
23684,1754,1022,0.5,1388.0,732
23685,1259,1392,1.0,1325.5,-133
23686,1072,1668,0.0,1370.0,-596
23687,1104,1059,1.0,1081.5,45
23688,1204,1566,0.0,1385.0,-362
23689,1264,1479,0.0,1371.5,-215
23690,1195,1504,1.0,1349.5,-309
23691,1476,1455,0.0,1465.5,21
23692,1363,1339,0.0,1351.0,24
23693,2050,1848,1.0,1949.0,202
23694,1915,1860,0.0,1887.5,55
23695,1729,1809,0.5,1769.0,-80
23696,1595,1561,0.0,1578.0,34
23697,2211,2049,1.0,2130.0,162
23698,2599,2350,1.0,2474.5,249
23699,2485,2611,1.0,2548.0,-126
23700,2592,2325,0.5,2458.5,267
23701,2446,2552,1.0,2499.0,-106
23702,2374,2499,0.0,2436.5,-125
23703,2417,2600,0.5,2508.5,-183
23704,2362,2338,0.0,2350.0,24
23705,2296,2213,1.0,2254.5,83
23706,2368,2367,1.0,2367.5,1
23707,2324,2393,0.0,2358.5,-69
23708,2492,2485,1.0,2488.5,7
23709,2388,2428,0.0,2408.0,-40
23710,2404,2618,0.0,2511.0,-214
23711,2496,2388,0.5,2442.0,108
23712,2373,2381,0.0,2377.0,-8
23713,2374,2344,1.0,2359.0,30
23714,2325,2315,0.0,2320.0,10
23715,2311,2290,0.5,2300.5,21
23716,2159,2210,0.5,2184.5,-51
23717,2319,2179,1.0,2249.0,140
23718,2402,2514,0.5,2458.0,-112
23719,2480,2417,1.0,2448.5,63
23720,2595,2409,0.5,2502.0,186
23721,2447,2193,1.0,2320.0,254
23722,2571,2346,0.5,2458.5,225
23723,2352,2202,1.0,2277.0,150
23724,2381,2386,0.5,2383.5,-5
23725,2297,2190,1.0,2243.5,107
23726,2404,2264,0.0,2334.0,140
23727,2454,2381,0.5,2417.5,73
23728,2493,2674,0.0,2583.5,-181
23729,2435,2383,0.5,2409.0,52
23730,2402,2511,0.5,2456.5,-109
23731,2467,2404,1.0,2435.5,63
23732,2394,2444,0.0,2419.0,-50
23733,2397,2384,0.5,2390.5,13
23734,2324,2266,0.0,2295.0,58
23735,2202,2292,0.0,2247.0,-90
23736,2364,2219,0.0,2291.5,145
23737,2054,2368,0.0,2211.0,-314
23738,2132,2078,0.5,2105.0,54
23739,2834,2811,0.5,2822.5,23
23740,2752,2680,1.0,2716.0,72
23741,2787,2743,1.0,2765.0,44
23742,2768,2655,0.5,2711.5,113
23743,2640,2753,0.5,2696.5,-113
23744,2767,2718,1.0,2742.5,49
23745,2792,2804,0.5,2798.0,-12
23746,2655,2834,0.0,2744.5,-179
23747,2752,2787,1.0,2769.5,-35
23748,2718,2792,0.5,2755.0,-74
23749,2680,2804,0.0,2742.0,-124
23750,2753,2767,0.5,2760.0,-14
23751,2811,2640,0.5,2725.5,171
23752,2743,2768,0.5,2755.5,-25
23753,2834,2743,0.5,2788.5,91
23754,2768,2752,0.5,2760.0,16
23755,2640,2655,1.0,2647.5,-15
23756,2792,2753,0.5,2772.5,39
23757,2767,2811,1.0,2789.0,-44
23758,2804,2718,0.5,2761.0,86
23759,2787,2680,0.5,2733.5,107
23760,2634,2607,0.5,2620.5,27
23761,2599,2718,0.5,2658.5,-119
23762,2652,2640,1.0,2646.0,12
23763,2489,2622,0.0,2555.5,-133
23764,2629,2481,1.0,2555.0,148
23765,2671,2634,0.5,2652.5,37
23766,2693,2497,0.5,2595.0,196
23767,2718,2671,1.0,2694.5,47
23768,2481,2599,1.0,2540.0,-118
23769,2622,2629,0.5,2625.5,-7
23770,2634,2652,0.5,2643.0,-18
23771,2634,2693,0.5,2663.5,-59
23772,2607,2497,0.5,2552.0,110
23773,2640,2489,0.0,2564.5,151
23774,2629,2640,0.0,2634.5,-11
23775,2599,2622,0.5,2610.5,-23
23776,2497,2634,0.5,2565.5,-137
23777,2693,2718,0.0,2705.5,-25
23778,2652,2607,1.0,2629.5,45
23779,2489,2634,0.5,2561.5,-145
23780,2671,2481,0.5,2576.0,190
23781,2191,2327,0.5,2259.0,-136
23782,2611,2202,1.0,2406.5,409
23783,2347,2592,0.0,2469.5,-245
23784,2552,2674,0.0,2613.0,-122
23785,2467,2527,1.0,2497.0,-60
23786,2368,2578,0.0,2473.0,-210
23787,2511,2393,1.0,2452.0,118
23788,2374,2435,0.5,2404.5,-61
23789,2397,2213,0.0,2305.0,184
23790,2341,2266,0.0,2303.5,75
23791,2444,1798,1.0,2121.0,646
23792,2626,2622,0.5,2624.0,4
23793,2447,2350,1.0,2398.5,97
23794,2499,2386,0.5,2442.5,113
23795,2297,2325,0.5,2311.0,-28
23796,2615,2409,1.0,2512.0,206
23797,2514,2338,0.5,2426.0,176
23798,2485,2346,1.0,2415.5,139
23799,2405,2417,1.0,2411.0,-12
23800,2423,2480,0.5,2451.5,-57
23801,2352,2296,1.0,2324.0,56
23802,2595,2311,1.0,2453.0,284
23803,2319,2571,0.0,2445.0,-252
23804,2402,2618,0.5,2510.0,-216
23805,2374,2381,0.0,2377.5,-7
23806,2417,2496,0.5,2456.5,-79
23807,2315,2309,0.5,2312.0,6
23808,2190,2391,1.0,2290.5,-201
23809,2182,2381,0.5,2281.5,-199
23810,2193,2381,0.0,2287.0,-188
23811,2210,2404,0.5,2307.0,-194
23812,2402,2435,1.0,2418.5,-33
23813,2592,2493,1.0,2542.5,99
23814,2383,2359,0.0,2371.0,24
23815,2506,2384,1.0,2445.0,122
23816,2404,2502,0.5,2453.0,-98
23817,2250,2368,0.0,2309.0,-118
23818,2292,2283,1.0,2287.5,9
23819,2230,2394,0.5,2312.0,-164
23820,2286,2331,0.5,2308.5,-45
23821,2234,2324,0.5,2279.0,-90
23822,2256,2302,0.5,2279.0,-46
23823,2756,2714,0.5,2735.0,42
23824,2792,2702,0.5,2747.0,90
23825,2675,2694,0.5,2684.5,-19
23826,2727,2777,1.0,2752.0,-50
23827,2666,2802,0.5,2734.0,-136
23828,2701,2771,0.5,2736.0,-70
23829,2695,2731,0.0,2713.0,-36
23830,2804,2788,0.5,2796.0,16
23831,2714,2756,0.5,2735.0,-42
23832,2702,2792,0.5,2747.0,-90
23833,2694,2675,0.5,2684.5,19
23834,2777,2727,0.5,2752.0,50
23835,2802,2666,1.0,2734.0,136
23836,2771,2701,1.0,2736.0,70
23837,2731,2695,0.0,2713.0,36
23838,2788,2804,0.5,2796.0,-16
23839,2714,2756,0.0,2735.0,-42
23840,2792,2702,1.0,2747.0,90
23841,2694,2675,0.5,2684.5,19
23842,2731,2695,1.0,2713.0,36
23843,2788,2804,0.5,2796.0,-16
23844,2756,2714,1.0,2735.0,42
23845,2702,2792,0.5,2747.0,-90
23846,2675,2694,1.0,2684.5,-19
23847,2695,2731,0.0,2713.0,-36
23848,2804,2788,0.5,2796.0,16
23849,2804,2788,1.0,2796.0,16
23850,2788,2804,0.5,2796.0,-16
23851,2756,2804,0.5,2780.0,-48
23852,2731,2792,0.5,2761.5,-61
23853,2675,2771,0.5,2723.0,-96
23854,2802,2727,1.0,2764.5,75
23855,2804,2756,0.5,2780.0,48
23856,2792,2731,1.0,2761.5,61
23857,2771,2675,1.0,2723.0,96
23858,2727,2802,0.5,2764.5,-75
23859,2804,2756,0.5,2780.0,48
23860,2756,2804,0.0,2780.0,-48
23861,1954,1591,1.0,1772.5,363
23862,2545,2620,0.5,2582.5,-75
23863,2607,2573,0.5,2590.0,34
23864,2450,2380,1.0,2415.0,70
23865,2516,2374,1.0,2445.0,142
23866,2418,2366,1.0,2392.0,52
23867,2348,2399,0.5,2373.5,-51
23868,2324,2405,0.0,2364.5,-81
23869,2359,2373,0.0,2366.0,-14
23870,2236,2253,0.0,2244.5,-17
23871,2180,2216,1.0,2198.0,-36
23872,2405,2661,0.0,2533.0,-256
23873,2448,2511,0.5,2479.5,-63
23874,2468,2473,1.0,2470.5,-5
23875,2491,2358,0.5,2424.5,133
23876,2411,2379,0.0,2395.0,32
23877,2443,2379,0.5,2411.0,64
23878,2222,2300,1.0,2261.0,-78
23879,2279,2214,1.0,2246.5,65
23880,2285,2216,1.0,2250.5,69
23881,2177,2312,0.0,2244.5,-135
23882,1980,1818,0.5,1899.0,162
23883,2798,2759,1.0,2778.5,39
23884,2759,2798,0.0,2778.5,-39
23885,2798,2759,0.5,2778.5,39
23886,2462,2544,0.5,2503.0,-82
23887,2470,2613,0.0,2541.5,-143
23888,2544,2462,0.5,2503.0,82
23889,2613,2470,0.5,2541.5,143
23890,2462,2544,0.5,2503.0,-82
23891,2470,2613,0.5,2541.5,-143
23892,2544,2462,0.5,2503.0,82
23893,2613,2470,0.0,2541.5,143
23894,2462,2544,0.5,2503.0,-82
23895,2470,2613,0.0,2541.5,-143
23896,2462,2798,0.0,2630.0,-336
23897,2470,2759,0.0,2614.5,-289
23898,2544,2613,1.0,2578.5,-69
23899,2759,2798,0.5,2778.5,-39
23900,2613,2462,1.0,2537.5,151
23901,2470,2544,0.5,2507.0,-74
23902,2544,2759,1.0,2651.5,-215
23903,2798,2613,0.5,2705.5,185
23904,2462,2470,1.0,2466.0,-8
23905,2759,2613,1.0,2686.0,146
23906,2544,2462,0.0,2503.0,82
23907,2470,2798,0.5,2634.0,-328
23908,2462,2759,0.0,2610.5,-297
23909,2798,2544,1.0,2671.0,254
23910,2613,2470,1.0,2541.5,143
23911,2759,2798,0.0,2778.5,-39
23912,2306,2728,0.5,2517.0,-422
23913,2698,2306,1.0,2502.0,392
23914,2295,2678,0.0,2486.5,-383
23915,2661,2292,1.0,2476.5,369
23916,2281,2660,0.0,2470.5,-379
23917,2657,2280,1.0,2468.5,377
23918,2271,2656,0.5,2463.5,-385
23919,2649,2260,1.0,2454.5,389
23920,2260,2649,0.0,2454.5,-389
23921,2639,2259,1.0,2449.0,380
23922,2258,2639,0.0,2448.5,-381
23923,2635,2256,1.0,2445.5,379
23924,2229,2618,0.0,2423.5,-389
23925,2613,2228,1.0,2420.5,385
23926,2226,2608,0.5,2417.0,-382
23927,2592,2217,1.0,2404.5,375
23928,2213,2585,0.5,2399.0,-372
23929,2583,2206,1.0,2394.5,377
23930,2204,2578,0.5,2391.0,-374
23931,2576,2204,1.0,2390.0,372
23932,2507,2698,0.5,2602.5,-191
23933,2678,2498,0.5,2588.0,180
23934,2498,2661,0.0,2579.5,-163
23935,2660,2494,1.0,2577.0,166
23936,2476,2657,0.5,2566.5,-181
23937,2457,2649,0.0,2553.0,-192
23938,2649,2430,1.0,2539.5,219
23939,2419,2639,0.5,2529.0,-220
23940,2639,2415,1.0,2527.0,224
23941,2398,2635,0.0,2516.5,-237
23942,2629,2392,1.0,2510.5,237
23943,2618,2383,0.5,2500.5,235
23944,2392,2613,1.0,2502.5,-221
23945,2383,2592,0.0,2487.5,-209
23946,2376,2583,0.5,2479.5,-207
23947,2352,2576,0.0,2464.0,-224
23948,2571,2350,1.0,2460.5,221
23949,2318,2567,0.0,2442.5,-249
23950,2557,2328,1.0,2442.5,229
23951,2307,2543,0.0,2425.0,-236
23952,2661,2571,1.0,2616.0,90
23953,2576,2660,1.0,2618.0,-84
23954,2649,2557,1.0,2603.0,92
23955,2567,2649,1.0,2608.0,-82
23956,2543,2639,1.0,2591.0,-96
23957,2635,2526,0.5,2580.5,109
23958,2524,2629,0.5,2576.5,-105
23959,2592,2513,0.5,2552.5,79
23960,2698,2392,0.5,2545.0,306
23961,2578,2728,0.5,2653.0,-150
23962,2678,2507,1.0,2592.5,171
23963,2657,2499,1.0,2578.0,158
23964,2498,2656,0.0,2577.0,-158
23965,2639,2481,0.5,2560.0,158
23966,2618,2476,1.0,2547.0,142
23967,2383,2608,0.0,2495.5,-225
23968,2306,2585,0.5,2445.5,-279
23969,2583,2419,0.5,2501.0,164
23970,2613,2376,0.5,2494.5,237
23971,2281,2498,0.5,2389.5,-217
23972,2131,1937,1.0,2034.0,194
23973,2497,2501,0.0,2499.0,-4
23974,2481,2477,0.5,2479.0,4
23975,2433,2454,0.0,2443.5,-21
23976,2406,2422,0.5,2414.0,-16
23977,2372,2364,0.0,2368.0,8
23978,2289,2364,1.0,2326.5,-75
23979,2366,2168,0.5,2267.0,198
23980,2175,2275,0.0,2225.0,-100
23981,2415,2402,0.5,2408.5,13
23982,2210,2315,1.0,2262.5,-105
23983,2215,2013,0.5,2114.0,202
23984,1727,2201,0.0,1964.0,-474
23985,2450,2263,1.0,2356.5,187
23986,2200,2382,0.0,2291.0,-182
23987,2431,2162,1.0,2296.5,269
23988,2114,1894,0.0,2004.0,220
23989,2324,2403,0.5,2363.5,-79
23990,2346,2216,0.0,2281.0,130
23991,2284,2275,0.5,2279.5,9
23992,2227,2005,1.0,2116.0,222
23993,2331,2414,1.0,2372.5,-83
23994,2353,2146,0.0,2249.5,207
23995,2162,2411,0.5,2286.5,-249
23996,2316,2127,1.0,2221.5,189
23997,2351,2131,1.0,2241.0,220
23998,2108,2310,0.0,2209.0,-202
23999,2259,2103,1.0,2181.0,156
24000,2050,2031,1.0,2040.5,19
24001,2425,2396,1.0,2410.5,29
24002,2148,2329,0.5,2238.5,-181
24003,2332,2051,1.0,2191.5,281
24004,2097,2177,1.0,2137.0,-80
24005,2292,2463,0.0,2377.5,-171
24006,2289,2117,0.5,2203.0,172
24007,2139,2191,1.0,2165.0,-52
24008,2044,2136,0.0,2090.0,-92
24009,2186,2364,0.0,2275.0,-178
24010,2214,2246,1.0,2230.0,-32
24011,2103,2254,0.5,2178.5,-151
24012,2282,2104,1.0,2193.0,178
24013,2420,2187,1.0,2303.5,233
24014,2093,2274,0.0,2183.5,-181
24015,2263,1953,1.0,2108.0,310
24016,1677,2117,0.0,1897.0,-440
24017,2321,2276,0.0,2298.5,45
24018,2034,2139,1.0,2086.5,-105
24019,2176,2051,0.0,2113.5,125
24020,2103,2102,0.0,2102.5,1
24021,2216,2271,1.0,2243.5,-55
24022,2167,2155,1.0,2161.0,12
24023,2109,2074,0.5,2091.5,35
24024,2138,1877,1.0,2007.5,261
24025,2396,2206,1.0,2301.0,190
24026,2102,2263,0.5,2182.5,-161
24027,2142,2059,0.0,2100.5,83
24028,1808,2124,1.0,1966.0,-316
24029,2250,2447,0.0,2348.5,-197
24030,2257,2008,0.5,2132.5,249
24031,1880,2030,1.0,1955.0,-150
24032,2083,1856,0.0,1969.5,227
24033,2274,2259,0.5,2266.5,15
24034,2100,2032,1.0,2066.0,68
24035,1864,2049,0.0,1956.5,-185
24036,1947,1513,1.0,1730.0,434
24037,2163,2135,0.0,2149.0,28
24038,2044,1850,1.0,1947.0,194
24039,1727,2048,0.5,1887.5,-321
24040,2025,1648,1.0,1836.5,377
24041,2099,1944,0.0,2021.5,155
24042,1626,1994,0.0,1810.0,-368
24043,1970,1632,1.0,1801.0,338
24044,1638,1929,0.0,1783.5,-291
24045,2048,1318,1.0,1683.0,730
24046,1744,1977,1.0,1860.5,-233
24047,1974,1703,1.0,1838.5,271
24048,1406,1313,1.0,1359.5,93
24049,1628,1948,0.0,1788.0,-320
24050,2051,1944,0.0,1997.5,107
24051,1442,2081,0.0,1761.5,-639
24052,1874,1594,0.0,1734.0,280
24053,1860,1766,0.0,1813.0,94
24054,1772,1889,0.0,1830.5,-117
24055,1888,1771,1.0,1829.5,117
24056,1352,1818,0.0,1585.0,-466
24057,1648,1827,1.0,1737.5,-179
24058,1795,1682,0.5,1738.5,113
24059,1687,1632,1.0,1659.5,55
24060,1516,1653,1.0,1584.5,-137
24061,1923,1783,1.0,1853.0,140
24062,1626,1766,0.5,1696.0,-140
24063,1716,1422,1.0,1569.0,294
24064,1272,1453,0.0,1362.5,-181
24065,1726,1429,0.0,1577.5,297
24066,1335,1398,0.0,1366.5,-63
24067,1564,1248,0.0,1406.0,316
24068,1259,1220,1.0,1239.5,39
24069,2101,1889,1.0,1995.0,212
24070,1677,1943,0.5,1810.0,-266
24071,1841,1763,1.0,1802.0,78
24072,1911,1605,1.0,1758.0,306
24073,1685,1720,0.0,1702.5,-35
24074,1609,1682,1.0,1645.5,-73
24075,1619,1631,0.0,1625.0,-12
24076,1962,1370,1.0,1666.0,592
24077,1604,2154,0.5,1879.0,-550
24078,1548,1763,1.0,1655.5,-215
24079,1289,1593,1.0,1441.0,-304
24080,2364,1177,0.5,1770.5,1187
24081,2481,2501,0.5,2491.0,-20
24082,2168,2289,0.0,2228.5,-121
24083,2095,2406,1.0,2250.5,-311
24084,2402,2003,0.5,2202.5,399
24085,2382,2450,0.5,2416.0,-68
24086,2210,2314,0.0,2262.0,-104
24087,2297,2431,0.0,2364.0,-134
24088,2331,2013,0.5,2172.0,318
24089,2477,2497,1.0,2487.0,-20
24090,2162,2146,0.0,2154.0,16
24091,2336,2433,1.0,2384.5,-97
24092,2372,2127,0.0,2249.5,245
24093,2315,2415,0.5,2365.0,-100
24094,2366,2364,1.0,2365.0,2
24095,2152,2215,1.0,2183.5,-63
24096,2324,2316,0.0,2320.0,8
24097,2266,2351,1.0,2308.5,-85
24098,2284,2216,0.0,2250.0,68
24099,2259,2310,1.0,2284.5,-51
24100,2403,2143,0.5,2273.0,260
24101,2117,2292,0.0,2204.5,-175
24102,2275,2288,1.0,2281.5,-13
24103,1890,2139,0.0,2014.5,-249
24104,2364,2227,0.5,2295.5,137
24105,2274,2420,1.0,2347.0,-146
24106,2282,2214,0.5,2248.0,68
24107,2117,2263,1.0,2190.0,-146
24108,2208,2270,0.5,2239.0,-62
24109,2350,2329,0.0,2339.5,21
24110,2034,2276,0.5,2155.0,-242
24111,2177,2332,1.0,2254.5,-155
24112,2271,2103,1.0,2187.0,168
24113,2008,2250,0.0,2129.0,-242
24114,2074,2167,0.5,2120.5,-93
24115,1856,1880,1.0,1868.0,-24
24116,2263,2138,1.0,2200.5,125
24117,2049,2100,1.0,2074.5,-51
24118,2107,2200,0.0,2153.5,-93
24119,1947,2051,0.0,1999.0,-104
24120,2206,2114,0.0,2160.0,92
24121,2289,2463,0.5,2376.0,-174
24122,2059,2102,0.5,2080.5,-43
24123,2044,2191,0.0,2117.5,-147
24124,2396,1808,1.0,2102.0,588
24125,1994,2099,0.0,2046.5,-105
24126,2097,2148,1.0,2122.5,-51
24127,1897,1970,0.0,1933.5,-73
24128,2131,1884,0.5,2007.5,247
24129,2139,2321,0.0,2230.0,-182
24130,2103,2108,1.0,2105.5,-5
24131,2102,2176,0.0,2139.0,-74
24132,2187,2050,1.0,2118.5,137
24133,2103,2186,0.0,2144.5,-83
24134,1953,2107,0.5,2030.0,-154
24135,2081,2104,1.0,2092.5,-23
24136,2353,1677,1.0,2015.0,676
24137,2155,2216,0.0,2185.5,-61
24138,2316,2411,1.0,2363.5,-95
24139,1877,2109,0.0,1993.0,-232
24140,2135,2325,0.0,2230.0,-190
24141,2263,2396,1.0,2329.5,-133
24142,2048,2044,0.5,2046.0,4
24143,1881,2142,1.0,2011.5,-261
24144,2171,2025,1.0,2098.0,146
24145,1682,1648,0.5,1665.0,34
24146,1977,2048,0.5,2012.5,-71
24147,1644,1687,0.0,1665.5,-43
24148,2447,1974,1.0,2210.5,473
24149,1766,1923,0.0,1844.5,-157
24150,2121,2257,1.0,2189.0,-136
24151,1453,1716,0.0,1584.5,-263
24152,1429,2083,0.0,1756.0,-654
24153,1860,2077,0.5,1968.5,-217
24154,1248,1335,0.0,1291.5,-87
24155,1818,1888,1.0,1853.0,-70
24156,1318,1259,0.0,1288.5,59
24157,2032,2274,0.5,2153.0,-242
24158,1703,1744,0.0,1723.5,-41
24159,1513,1745,1.0,1629.0,-232
24160,1948,1406,0.0,1677.0,542
24161,1850,2163,1.0,2006.5,-313
24162,1874,2051,1.0,1962.5,-177
24163,1648,1727,0.5,1687.5,-79
24164,2101,1651,1.0,1876.0,450
24165,1944,1628,0.5,1786.0,316
24166,1841,1943,1.0,1892.0,-102
24167,1594,1442,0.5,1518.0,152
24168,1944,1636,0.0,1790.0,308
24169,1772,1766,1.0,1769.0,6
24170,1632,1626,0.0,1629.0,6
24171,1352,1771,1.0,1561.5,-419
24172,1726,1638,1.0,1682.0,88
24173,1682,1911,0.5,1796.5,-229
24174,1564,1398,1.0,1481.0,166
24175,1370,1609,0.5,1489.5,-239
24176,1827,1490,0.0,1658.5,337
24177,1763,1962,0.5,1862.5,-199
24178,1632,1795,0.5,1713.5,-163
24179,1177,1548,1.0,1362.5,-371
24180,1783,1427,0.5,1605.0,356
24181,1712,1720,0.5,1716.0,-8
24182,1422,1626,1.0,1524.0,-204
24183,1619,1631,0.5,1625.0,-12
24184,2154,1272,0.5,1713.0,882
24185,1763,1889,0.5,1826.0,-126
24186,1604,1618,0.5,1611.0,-14
24187,1618,1289,1.0,1453.5,329
24188,2501,2415,1.0,2458.0,86
24189,2315,2481,0.0,2398.0,-166
24190,2454,2215,0.5,2334.5,239
24191,2201,2406,0.0,2303.5,-205
24192,2497,2351,1.0,2424.0,146
24193,2266,2477,0.0,2371.5,-211
24194,2422,2310,1.0,2366.0,112
24195,2259,2336,0.0,2297.5,-77
24196,2450,2403,0.5,2426.5,47
24197,2346,2382,0.5,2364.0,-36
24198,2431,2288,1.0,2359.5,143
24199,2227,2297,0.5,2262.0,-70
24200,2420,2402,0.5,2411.0,18
24201,2314,2274,0.5,2294.0,40
24202,2263,2210,0.5,2236.5,53
24203,2013,2117,0.5,2065.0,-104
24204,2364,2331,1.0,2347.5,33
24205,2146,2289,0.5,2217.5,-143
24206,2168,2162,1.0,2165.0,6
24207,2127,2175,0.0,2151.0,-48
24208,2425,2271,1.0,2348.0,154
24209,2167,2350,0.5,2258.5,-183
24210,2332,2074,0.5,2203.0,258
24211,2138,2177,0.5,2157.5,-39
24212,2364,2208,1.0,2286.0,156
24213,2276,2214,0.5,2245.0,62
24214,2254,2034,1.0,2144.0,220
24215,2051,2270,0.0,2160.5,-219
24216,2206,2396,1.0,2301.0,-190
24217,2148,2102,0.5,2125.0,46
24218,2059,2097,0.5,2078.0,-38
24219,1884,1808,1.0,1846.0,76
24220,2414,2131,1.0,2272.5,283
24221,2108,2411,0.0,2259.5,-303
24222,2316,2103,0.5,2209.5,213
24223,1791,2325,0.0,2058.0,-534
24224,2292,2372,0.0,2332.0,-80
24225,2364,2139,0.5,2251.5,225
24226,2136,2366,0.0,2251.0,-230
24227,2275,1890,1.0,2082.5,385
24228,2259,2324,0.5,2291.5,-65
24229,2216,2100,0.0,2158.0,116
24230,2049,2284,1.0,2166.5,-235
24231,2005,2051,0.0,2028.0,-46
24232,2107,2263,1.0,2185.0,-156
24233,2200,2093,0.5,2146.5,107
24234,1953,2162,0.0,2057.5,-209
24235,2114,1677,1.0,1895.5,437
24236,2396,2077,1.0,2236.5,319
24237,1860,2263,0.0,2061.5,-403
24238,2124,1889,1.0,2006.5,235
24239,1888,1881,1.0,1884.5,7
24240,2163,2171,0.0,2167.0,-8
24241,2048,1850,0.5,1949.0,198
24242,1727,1977,0.0,1852.0,-250
24243,1974,1648,1.0,1811.0,326
24244,2274,2447,1.0,2360.5,-173
24245,2257,2032,0.5,2144.5,225
24246,1864,2121,0.0,1992.5,-257
24247,2083,1745,1.0,1914.0,338
24248,2463,2250,0.0,2356.5,213
24249,2008,2289,0.5,2148.5,-281
24250,2191,1880,0.0,2035.5,311
24251,1856,2044,1.0,1950.0,-188
24252,1766,2186,1.0,1976.0,-420
24253,2246,1772,1.0,2009.0,474
24254,1771,2103,0.0,1937.0,-332
24255,2081,1352,1.0,1716.5,729
24256,2321,2135,1.0,2228.0,186
24257,2044,2139,1.0,2091.5,-95
24258,2176,2048,1.0,2112.0,128
24259,2025,2102,1.0,2063.5,-77
24260,2216,2101,0.5,2158.5,115
24261,1943,2155,0.0,2049.0,-212
24262,2109,1841,0.0,1975.0,268
24263,1605,1877,1.0,1741.0,-272
24264,2099,2051,1.0,2075.0,48
24265,2081,1994,1.0,2037.5,87
24266,1970,1874,1.0,1922.0,96
24267,1651,1929,0.0,1790.0,-278
24268,1628,1429,0.5,1528.5,199
24269,1335,1944,0.0,1639.5,-609
24270,1442,1248,0.0,1345.0,194
24271,1259,1594,0.5,1426.5,-335
24272,1648,1783,1.0,1715.5,-135
24273,1631,1682,0.0,1656.5,-51
24274,1687,1626,1.0,1656.5,61
24275,1272,1653,0.0,1462.5,-381
24276,1962,1726,0.5,1844.0,236
24277,1398,1763,0.0,1580.5,-365
24278,1548,1564,0.5,1556.0,-16
24279,1490,1177,1.0,1333.5,313
24280,1744,1766,0.5,1755.0,-22
24281,1716,1703,0.5,1709.5,13
24282,1406,1453,1.0,1429.5,-47
24283,1889,1944,0.5,1916.5,-55
24284,1626,1677,0.0,1651.5,-51
24285,1638,1632,0.0,1635.0,6
24286,1720,1618,1.0,1669.0,102
24287,1795,1827,0.5,1811.0,-32
24288,1685,1712,1.0,1698.5,-27
24289,1427,1632,0.0,1529.5,-205
24290,1911,1619,0.0,1765.0,292
24291,1618,2154,1.0,1886.0,-536
24292,1609,1682,1.0,1645.5,-73
24293,1593,1604,1.0,1598.5,-11
24294,2501,1370,0.5,1935.5,1131
24295,2274,2420,0.0,2347.0,-146
24296,2406,2481,1.0,2443.5,-75
24297,2117,2263,1.0,2190.0,-146
24298,2497,2095,0.5,2296.0,402
24299,2289,2364,0.0,2326.5,-75
24300,2422,2477,1.0,2449.5,-55
24301,2175,2168,1.0,2171.5,7
24302,2415,2336,0.0,2375.5,79
24303,2382,2450,1.0,2416.0,-68
24304,2215,2315,0.0,2265.0,-100
24305,2297,2431,1.0,2364.0,-134
24306,2402,2152,0.5,2277.0,250
24307,2329,2425,1.0,2377.0,-96
24308,2210,2314,1.0,2262.0,-104
24309,2332,2350,0.5,2341.0,-18
24310,2351,2013,0.5,2182.0,338
24311,2411,2353,1.0,2382.0,58
24312,2310,2266,1.0,2288.0,44
24313,2325,2316,0.5,2320.5,9
24314,2372,2259,1.0,2315.5,113
24315,2214,2364,0.0,2289.0,-150
24316,2366,2364,0.5,2365.0,2
24317,2282,2254,1.0,2268.0,28
24318,2403,2275,1.0,2339.0,128
24319,2100,2259,1.0,2179.5,-159
24320,2275,2346,1.0,2310.5,-71
24321,2051,2049,0.0,2050.0,2
24322,2263,2227,0.5,2245.0,36
24323,2263,2396,1.0,2329.5,-133
24324,2162,2200,0.0,2181.0,-38
24325,2124,2142,0.0,2133.0,-18
24326,2396,2114,1.0,2255.0,282
24327,2048,2171,0.0,2109.5,-123
24328,2051,2148,0.5,2099.5,-97
24329,1974,1977,0.0,1975.5,-3
24330,2447,2097,1.0,2272.0,350
24331,2276,2208,1.0,2242.0,68
24332,2121,2257,0.0,2189.0,-136
24333,2103,2051,0.0,2077.0,52
24334,2250,2083,0.5,2166.5,167
24335,2146,2331,1.0,2238.5,-185
24336,1880,2008,1.0,1944.0,-128
24337,2127,2162,1.0,2144.5,-35
24338,2271,1287,0.5,1779.0,984
24339,2102,2206,0.5,2154.0,-104
24340,2074,2167,1.0,2120.5,-93
24341,1630,1808,0.0,1719.0,-178
24342,2131,2138,0.0,2134.5,-7
24343,2117,2292,0.0,2204.5,-175
24344,2103,2108,0.0,2105.5,-5
24345,2136,2139,0.0,2137.5,-3
24346,2246,2050,1.0,2148.0,196
24347,1970,2099,0.5,2034.5,-129
24348,2104,2103,0.5,2103.5,1
24349,1897,1929,1.0,1913.0,-32
24350,2324,2081,0.5,2202.5,243
24351,2107,2187,0.0,2147.0,-80
24352,2284,2216,1.0,2250.0,68
24353,1677,2093,0.0,1885.0,-416
24354,2101,2143,0.0,2122.0,-42
24355,2176,2139,1.0,2157.5,37
24356,1841,1943,1.0,1892.0,-102
24357,1880,2102,1.0,1991.0,-222
24358,2463,1636,0.5,2049.5,827
24359,1850,2163,0.5,2006.5,-313
24360,2191,2289,0.5,2240.0,-98
24361,1648,1727,0.0,1687.5,-79
24362,2135,2044,0.5,2089.5,91
24363,1682,1648,0.5,1665.0,34
24364,2048,2044,0.5,2046.0,4
24365,1644,1687,0.0,1665.5,-43
24366,2077,2025,0.0,2051.0,52
24367,2032,2274,1.0,2153.0,-242
24368,1889,1860,1.0,1874.5,29
24369,1513,1745,0.0,1629.0,-232
24370,1318,1888,0.0,1603.0,-570
24371,1677,1889,0.0,1783.0,-212
24372,1703,1744,0.5,1723.5,-41
24373,1618,1763,1.0,1690.5,-145
24374,1628,1406,0.0,1517.0,222
24375,1763,1962,0.0,1862.5,-199
24376,1442,1944,1.0,1693.0,-502
24377,1177,1548,0.5,1362.5,-371
24378,1726,1594,0.0,1660.0,132
24379,2155,2216,1.0,2185.5,-61
24380,1564,1398,0.5,1481.0,166
24381,1877,2109,0.0,1993.0,-232
24382,1429,1490,0.0,1459.5,-61
24383,1766,1923,1.0,1844.5,-157
24384,1248,1335,0.5,1291.5,-87
24385,1453,1716,1.0,1584.5,-263
24386,1783,1259,0.5,1521.0,524
24387,1772,1766,1.0,1769.0,6
24388,1422,1626,0.0,1524.0,-204
24389,1352,1771,1.0,1561.5,-419
24390,2051,1272,1.0,1661.5,779
24391,1712,1720,0.0,1716.0,-8
24392,1874,2081,1.0,1977.5,-207
24393,1619,1685,0.5,1652.0,-66
24394,1944,1651,0.0,1797.5,293
24395,1682,1911,0.5,1796.5,-229
24396,1638,1632,0.5,1635.0,6
24397,1554,1609,0.5,1581.5,-55
24398,2154,1445,1.0,1799.5,709
24399,1795,1827,1.0,1811.0,-32
24400,1604,1618,0.0,1611.0,-14
24401,1427,1632,0.5,1529.5,-205
24402,2081,2049,0.0,2065.0,32
24403,2135,2795,0.0,2465.0,-660
24404,2751,2256,1.0,2503.5,495
24405,2249,2786,0.0,2517.5,-537
24406,2714,2321,1.0,2517.5,393
24407,2717,2297,1.0,2507.0,420
24408,2350,2723,0.0,2536.5,-373
24409,2680,2282,1.0,2481.0,398
24410,2246,2707,0.0,2476.5,-461
24411,2630,2396,1.0,2513.0,234
24412,2180,2628,0.5,2404.0,-448
24413,2528,2082,1.0,2305.0,446
24414,2254,2528,1.0,2391.0,-274
24415,2317,2720,0.0,2518.5,-403
24416,2708,2405,1.0,2556.5,303
24417,2250,2680,0.0,2465.0,-430
24418,2624,2121,1.0,2372.5,503
24419,2686,2344,1.0,2515.0,342
24420,2373,2672,0.0,2522.5,-299
24421,2655,2252,1.0,2453.5,403
24422,2183,2500,0.0,2341.5,-317
24423,2508,2637,0.0,2572.5,-129
24424,2690,2170,1.0,2430.0,520
24425,2320,2704,0.0,2512.0,-384
24426,2676,2105,1.0,2390.5,571
24427,2706,2334,1.0,2520.0,372
24428,2261,2659,0.0,2460.0,-398
24429,2653,2244,1.0,2448.5,409
24430,2138,2624,0.0,2381.0,-486
24431,2425,2742,0.0,2583.5,-317
24432,2668,2259,1.0,2463.5,409
24433,2166,2666,0.0,2416.0,-500
24434,2638,2222,1.0,2430.0,416
24435,2354,2671,0.0,2512.5,-317
24436,2656,2368,1.0,2512.0,288
24437,2229,2624,0.0,2426.5,-395
24438,2651,2106,1.0,2378.5,545
24439,2665,2414,1.0,2539.5,251
24440,2244,2665,0.0,2454.5,-421
24441,2650,2210,1.0,2430.0,440
24442,2177,2653,0.0,2415.0,-476
24443,2523,2745,0.0,2634.0,-222
24444,2631,2176,1.0,2403.5,455
24445,2122,2664,0.0,2393.0,-542
24446,2638,2117,1.0,2377.5,521
24447,2646,2315,1.0,2480.5,331
24448,2326,2639,0.0,2482.5,-313
24449,2689,2226,1.0,2457.5,463
24450,2140,2612,0.0,2376.0,-472
24451,2341,2760,0.0,2550.5,-419
24452,2664,2277,1.0,2470.5,387
24453,2296,2649,0.0,2472.5,-353
24454,2550,1965,1.0,2257.5,585
24455,2181,2659,0.0,2420.0,-478
24456,2576,2280,1.0,2428.0,296
24457,2225,2640,0.0,2432.5,-415
24458,2612,2245,1.0,2428.5,367
24459,2716,2283,1.0,2499.5,433
24460,2239,2676,0.0,2457.5,-437
24461,2634,2166,1.0,2400.0,468
24462,2202,2549,0.0,2375.5,-347
24463,2311,2698,0.0,2504.5,-387
24464,2624,2309,0.5,2466.5,315
24465,2143,2620,0.0,2381.5,-477
24466,2603,2075,1.0,2339.0,528
24467,2681,2329,1.0,2505.0,352
24468,2126,2553,0.0,2339.5,-427
24469,2548,2258,1.0,2403.0,290
24470,2165,2461,0.0,2313.0,-296
24471,2263,2645,0.5,2454.0,-382
24472,2590,2085,1.0,2337.5,505
24473,2246,2619,0.0,2432.5,-373
24474,2565,2272,1.0,2418.5,293
24475,2565,2243,1.0,2404.0,322
24476,2118,2587,0.0,2352.5,-469
24477,2560,2261,1.0,2410.5,299
24478,2221,2530,0.0,2375.5,-309
24479,2273,2713,0.0,2493.0,-440
24480,2618,2197,1.0,2407.5,421
24481,2168,2581,0.0,2374.5,-413
24482,2542,2187,1.0,2364.5,355
24483,2663,2307,1.0,2485.0,356
24484,2157,2630,0.0,2393.5,-473
24485,2553,2186,1.0,2369.5,367
24486,2170,2117,1.0,2143.5,53
24487,2218,2650,0.0,2434.0,-432
24488,2572,2215,1.0,2393.5,357
24489,2214,2524,0.0,2369.0,-310
24490,2496,2156,0.0,2326.0,340
24491,2671,2317,1.0,2494.0,354
24492,2090,2563,0.5,2326.5,-473
24493,2608,2172,1.0,2390.0,436
24494,2173,2548,0.0,2360.5,-375
24495,2222,2644,0.5,2433.0,-422
24496,2641,2193,0.5,2417.0,448
24497,2195,2544,0.0,2369.5,-349
24498,2526,2144,1.0,2335.0,382
24499,2632,2121,1.0,2376.5,511
24500,2194,2529,0.0,2361.5,-335
24501,2569,2218,1.0,2393.5,351
24502,1986,2614,0.0,2300.0,-628
24503,2143,2678,0.0,2410.5,-535
24504,2580,2251,1.0,2415.5,329
24505,2169,2595,0.0,2382.0,-426
24506,2532,2106,1.0,2319.0,426
24507,2618,2183,1.0,2400.5,435
24508,2112,2569,0.0,2340.5,-457
24509,2537,2253,0.5,2395.0,284
24510,2014,2490,0.0,2252.0,-476
24511,2141,2613,0.0,2377.0,-472
24512,2602,2164,1.0,2383.0,438
24513,2067,2602,0.0,2334.5,-535
24514,2554,2093,1.0,2323.5,461
24515,2570,2236,1.0,2403.0,334
24516,2110,2568,0.0,2339.0,-458
24517,2583,2104,1.0,2343.5,479
24518,2069,2522,0.0,2295.5,-453
24519,2183,2634,0.0,2408.5,-451
24520,2501,2048,1.0,2274.5,453
24521,2507,2439,1.0,2473.0,68
24522,2625,2139,1.0,2382.0,486
24523,2084,2139,0.0,2111.5,-55
24524,2579,2574,1.0,2576.5,5
24525,1979,2079,0.0,2029.0,-100
24526,2216,2561,0.5,2388.5,-345
24527,2510,2615,1.0,2562.5,-105
24528,1946,2106,0.0,2026.0,-160
24529,2367,2471,1.0,2419.0,-104
24530,2571,2188,1.0,2379.5,383
24531,2081,2063,0.0,2072.0,18
24532,2559,2595,0.5,2577.0,-36
24533,2121,2120,0.5,2120.5,1
24534,2137,2554,0.0,2345.5,-417
24535,2564,2574,1.0,2569.0,-10
24536,2105,2113,0.0,2109.0,-8
24537,2541,2562,1.0,2551.5,-21
24538,2602,2057,0.5,2329.5,545
24539,2056,2164,0.0,2110.0,-108
24540,2487,2586,1.0,2536.5,-99
24541,2024,2087,0.0,2055.5,-63
24542,2272,2453,0.0,2362.5,-181
24543,2473,2622,1.0,2547.5,-149
24544,1760,2125,0.0,1942.5,-365
24545,2458,2528,1.0,2493.0,-70
24546,2627,1846,1.0,2236.5,781
24547,2121,2083,0.0,2102.0,38
24548,2466,2487,1.0,2476.5,-21
24549,2024,2087,0.0,2055.5,-63
24550,2055,2589,0.0,2322.0,-534
24551,2598,2594,1.0,2596.0,4
24552,1964,2063,0.0,2013.5,-99
24553,2424,2499,1.0,2461.5,-75
24554,2522,1904,1.0,2213.0,618
24555,1803,2067,0.0,1935.0,-264
24556,2533,2525,1.0,2529.0,8
24557,2270,2477,0.0,2373.5,-207
24558,2556,2644,1.0,2600.0,-88
24559,1976,2119,0.0,2047.5,-143
24560,2460,2432,1.0,2446.0,28
24561,2604,1889,1.0,2246.5,715
24562,2061,1930,0.0,1995.5,131
24563,2473,2503,1.0,2488.0,-30
24564,2137,1980,0.0,2058.5,157
24565,2131,2373,0.0,2252.0,-242
24566,2448,2543,1.0,2495.5,-95
24567,2194,1952,0.0,2073.0,242
24568,2555,2426,1.0,2490.5,129
24569,2535,2064,1.0,2299.5,471
24570,2085,2508,0.0,2296.5,-423
24571,2491,2046,1.0,2268.5,445
24572,2038,2411,0.0,2224.5,-373
24573,2201,2547,0.0,2374.0,-346
24574,2467,1993,1.0,2230.0,474
24575,1996,2203,0.0,2099.5,-207
24576,2396,2026,1.0,2211.0,370
24577,2544,2068,1.0,2306.0,476
24578,2070,2519,0.0,2294.5,-449
24579,2467,2024,1.0,2245.5,443
24580,2002,2351,0.0,2176.5,-349
24581,2085,2606,0.0,2345.5,-521
24582,2435,2001,1.0,2218.0,434
24583,1933,2402,0.0,2167.5,-469
24584,2447,2032,1.0,2239.5,415
24585,2644,2060,1.0,2352.0,584
24586,2017,2455,0.0,2236.0,-438
24587,2323,2115,1.0,2219.0,208
24588,1951,2277,0.0,2114.0,-326
24589,2559,2531,1.0,2545.0,28
24590,1972,2036,0.0,2004.0,-64
24591,2470,2461,1.0,2465.5,9
24592,2533,1963,1.0,2248.0,570
24593,1945,2106,0.0,2025.5,-161
24594,2457,2537,1.0,2497.0,-80
24595,1858,2111,0.0,1984.5,-253
24596,1880,2455,0.0,2167.5,-575
24597,2473,2578,1.0,2525.5,-105
24598,2034,2056,0.0,2045.0,-22
24599,2423,2448,1.0,2435.5,-25
24600,2590,1917,1.0,2253.5,673
24601,1996,2036,0.0,2016.0,-40
24602,2438,2526,1.0,2482.0,-88
24603,2031,1920,0.5,1975.5,111
24604,1944,2363,0.0,2153.5,-419
24605,2505,2521,1.0,2513.0,-16
24606,2074,1910,0.0,1992.0,164
24607,2486,2437,1.0,2461.5,49
24608,2487,2051,1.0,2269.0,436
24609,1860,1985,0.0,1922.5,-125
24610,2500,2464,1.0,2482.0,36
24611,1977,1933,0.0,1955.0,44
24612,2388,2426,0.0,2407.0,-38
24613,2421,2522,0.0,2471.5,-101
24614,2155,2279,0.0,2217.0,-124
24615,2453,2418,1.0,2435.5,35
24616,2437,2011,1.0,2224.0,426
24617,1987,2431,0.0,2209.0,-444
24618,2425,1952,1.0,2188.5,473
24619,1817,2445,0.0,2131.0,-628
24620,2114,2549,0.0,2331.5,-435
24621,2461,1829,1.0,2145.0,632
24622,1873,2365,0.0,2119.0,-492
24623,2186,1846,1.0,2016.0,340
24624,2500,1937,1.0,2218.5,563
24625,1883,2450,0.0,2166.5,-567
24626,2440,1828,1.0,2134.0,612
24627,1969,2353,0.0,2161.0,-384
24628,1746,2513,0.0,2129.5,-767
24629,2390,2044,1.0,2217.0,346
24630,2075,2501,0.0,2288.0,-426
24631,2513,1908,1.0,2210.5,605
24632,2180,2462,0.0,2321.0,-282
24633,2402,1645,1.0,2023.5,757
24634,1580,2334,0.0,1957.0,-754
24635,1948,2448,0.0,2198.0,-500
24636,2390,1844,1.0,2117.0,546
24637,1899,2318,0.0,2108.5,-419
24638,2313,1534,1.0,1923.5,779
24639,2495,1920,0.5,2207.5,575
24640,1883,2419,0.0,2151.0,-536
24641,2382,1808,1.0,2095.0,574
24642,1606,2323,0.0,1964.5,-717
24643,1845,2489,0.0,2167.0,-644
24644,2427,1848,1.0,2137.5,579
24645,1769,2382,0.0,2075.5,-613
24646,2387,1720,1.0,2053.5,667
24647,2480,2039,0.0,2259.5,441
24648,1944,2426,1.0,2185.0,-482
24649,2327,1312,0.0,1819.5,1015
24650,1875,2327,1.0,2101.0,-452
24651,1828,2581,0.0,2204.5,-753
24652,2416,1630,1.0,2023.0,786
24653,1724,2284,0.0,2004.0,-560
24654,2061,1777,1.0,1919.0,284
24655,2431,1707,1.0,2069.0,724
24656,1922,2419,0.0,2170.5,-497
24657,2347,1799,1.0,2073.0,548
24658,2054,2349,0.0,2201.5,-295
24659,2410,2590,1.0,2500.0,-180
24660,2181,2301,1.0,2241.0,-120
24661,2433,1928,1.0,2180.5,505
24662,1899,2036,0.0,1967.5,-137
24663,2251,2328,1.0,2289.5,-77
24664,2055,1893,0.0,1974.0,162
24665,2296,2525,1.0,2410.5,-229
24666,2374,2374,1.0,2374.0,0
24667,2469,2012,1.0,2240.5,457
24668,1893,2384,0.0,2138.5,-491
24669,2303,2224,1.0,2263.5,79
24670,2436,2435,1.0,2435.5,1
24671,1688,1779,0.0,1733.5,-91
24672,2275,2346,1.0,2310.5,-71
24673,2507,1689,1.0,2098.0,818
24674,2320,2361,1.0,2340.5,-41
24675,1950,2256,0.0,2103.0,-306
24676,2365,2463,1.0,2414.0,-98
24677,1755,1802,0.0,1778.5,-47
24678,2172,2222,0.0,2197.0,-50
24679,2416,2178,1.0,2297.0,238
24680,2100,2413,0.0,2256.5,-313
24681,2392,2273,0.0,2332.5,119
24682,2030,2449,0.0,2239.5,-419
24683,1817,2316,0.0,2066.5,-499
24684,1841,2366,0.0,2103.5,-525
24685,2383,1833,1.0,2108.0,550
24686,1909,2311,0.0,2110.0,-402
24687,2277,2350,1.0,2313.5,-73
24688,1899,2225,1.0,2062.0,-326
24689,2399,1783,1.0,2091.0,616
24690,1668,2333,0.0,2000.5,-665
24691,2289,2236,0.0,2262.5,53
24692,2330,2471,1.0,2400.5,-141
24693,2189,2380,1.0,2284.5,-191
24694,2186,2250,1.0,2218.0,-64
24695,2387,2392,0.0,2389.5,-5
24696,2289,2277,0.0,2283.0,12
24697,2286,2333,1.0,2309.5,-47
24698,2157,2239,1.0,2198.0,-82
24699,2333,2255,0.0,2294.0,78
24700,2272,2190,0.0,2231.0,82
24701,2283,2332,1.0,2307.5,-49
24702,2128,2150,1.0,2139.0,-22
24703,2323,2236,0.0,2279.5,87
24704,2224,2211,0.0,2217.5,13
24705,2724,2372,1.0,2548.0,352
24706,2329,2659,0.0,2494.0,-330
24707,2649,2114,1.0,2381.5,535
24708,2226,2613,0.0,2419.5,-387
24709,2357,2288,1.0,2322.5,69
24710,1751,2299,0.0,2025.0,-548
24711,2760,2549,1.0,2654.5,211
24712,2461,2795,0.0,2628.0,-334
24713,2786,2365,1.0,2575.5,421
24714,2186,2714,0.5,2450.0,-528
24715,2500,2744,1.0,2622.0,-244
24716,2723,2477,0.5,2600.0,246
24717,2450,2680,0.5,2565.0,-230
24718,2707,2440,1.0,2573.5,267
24719,2591,2877,0.5,2734.0,-286
24720,2630,2437,0.5,2533.5,193
24721,2425,2528,0.5,2476.5,-103
24722,2528,2445,0.5,2486.5,83
24723,2768,2513,1.0,2640.5,255
24724,2390,2708,0.0,2549.0,-318
24725,2680,2501,1.0,2590.5,179
24726,2418,2624,0.0,2521.0,-206
24727,2513,2805,0.5,2659.0,-292
24728,2686,2462,1.0,2574.0,224
24729,2439,2672,0.5,2555.5,-233
24730,2655,2402,1.0,2528.5,253
24731,2740,2653,0.5,2696.5,87
24732,2448,2690,0.0,2569.0,-242
24733,2704,2390,0.0,2547.0,314
24734,2318,2676,0.0,2497.0,-358
24735,2489,2706,0.5,2597.5,-217
24736,2659,2427,1.0,2543.0,232
24737,2382,2653,0.5,2517.5,-271
24738,2624,2387,1.0,2505.5,237
24739,2718,2581,0.5,2649.5,137
24740,2416,2668,0.0,2542.0,-252
24741,2666,2284,1.0,2475.0,382
24742,2061,2638,0.0,2349.5,-577
24743,2441,2743,0.5,2592.0,-302
24744,2659,2431,1.0,2545.0,228
24745,2419,2649,0.0,2534.0,-230
24746,2613,2347,1.0,2480.0,266
24747,2753,2590,1.0,2671.5,163
24748,2410,2656,0.5,2533.0,-246
24749,2624,2301,1.0,2462.5,323
24750,2181,2651,0.0,2416.0,-470
24751,2611,2665,0.5,2638.0,-54
24752,2665,2433,0.5,2549.0,232
24753,2328,2650,0.0,2489.0,-322
24754,2653,2251,1.0,2452.0,402
24755,2745,2525,1.0,2635.0,220
24756,2296,2631,0.0,2463.5,-335
24757,2664,2374,1.0,2519.0,290
24758,2291,2662,0.0,2476.5,-371
24759,2435,2709,0.0,2572.0,-274
24760,2639,2436,1.0,2537.5,203
24761,2346,2689,0.0,2517.5,-343
24762,2612,2305,1.0,2458.5,307
24763,2760,2416,1.0,2588.0,344
24764,2413,2664,0.0,2538.5,-251
24765,2649,2392,1.0,2520.5,257
24766,2273,2550,0.0,2411.5,-277
24767,2659,2449,0.5,2554.0,210
24768,2318,2576,0.0,2447.0,-258
24769,2640,2365,0.5,2502.5,275
24770,2316,2612,0.0,2464.0,-296
24771,2387,2716,0.0,2551.5,-329
24772,2676,2366,0.5,2521.0,310
24773,2383,2634,0.0,2508.5,-251
24774,2549,2311,1.0,2430.0,238
24775,2350,2681,0.0,2515.5,-331
24776,2553,2277,1.0,2415.0,276
24777,2225,2548,0.5,2386.5,-323
24778,2461,1899,1.0,2180.0,562
24779,2378,2801,0.0,2589.5,-423
24780,2587,2399,1.0,2493.0,188
24781,2333,2560,0.0,2446.5,-227
24782,2530,2289,1.0,2409.5,241
24783,2471,2632,0.5,2551.5,-161
24784,2529,2330,0.5,2429.5,199
24785,2380,2569,0.0,2474.5,-189
24786,2614,2189,1.0,2401.5,425
24787,2678,2527,0.0,2602.5,151
24788,2400,2580,0.0,2490.0,-180
24789,2250,2514,0.0,2382.0,-264
24790,2613,2333,1.0,2473.0,280
24791,2255,2602,0.0,2428.5,-347
24792,2602,2425,1.0,2513.5,177
24793,2272,2539,0.0,2405.5,-267
24794,2472,2649,0.5,2560.5,-177
24795,2570,2332,1.0,2451.0,238
24796,2283,2583,0.0,2433.0,-300
24797,2522,2150,1.0,2336.0,372
24798,2710,2408,1.0,2559.0,302
24799,2323,2634,0.0,2478.5,-311
24800,2501,2236,1.0,2368.5,265
24801,2211,2439,0.0,2325.0,-228
24802,2039,2625,0.5,2332.0,-586
24803,2574,1944,1.0,2259.0,630
24804,1312,2579,0.0,1945.5,-1267
24805,2554,1875,1.0,2214.5,679
24806,2698,2574,0.5,2636.0,124
24807,2564,2624,0.0,2594.0,-60
24808,2620,2562,0.5,2591.0,58
24809,2541,2618,0.5,2579.5,-77
24810,2645,2622,1.0,2633.5,23
24811,2593,2590,0.5,2591.5,3
24812,2669,2473,1.0,2571.0,196
24813,2528,2619,0.0,2573.5,-91
24814,2627,2671,0.0,2649.0,-44
24815,2606,2487,1.0,2546.5,119
24816,2466,2608,0.5,2537.0,-142
24817,2548,2589,0.5,2568.5,-41
24818,2594,2618,1.0,2606.0,-24
24819,2569,2598,1.0,2583.5,-29
24820,2499,2537,1.0,2518.0,-38
24821,2490,2490,0.5,2490.0,0
24822,2700,2562,0.5,2631.0,138
24823,2522,2615,0.0,2568.5,-93
24824,2510,2525,1.0,2517.5,-15
24825,2533,2471,1.0,2502.0,62
24826,2644,2602,1.0,2623.0,42
24827,2571,2556,0.5,2563.5,15
24828,2432,2586,0.0,2509.0,-154
24829,2487,2460,1.0,2473.5,27
24830,2590,2604,0.5,2597.0,-14
24831,2503,2526,1.0,2514.5,-23
24832,2438,2473,0.5,2455.5,-35
24833,2373,2363,0.0,2368.0,10
24834,2536,2502,0.5,2519.0,34
24835,2495,2448,0.5,2471.5,47
24836,2426,2419,1.0,2422.5,7
24837,2382,2555,0.0,2468.5,-173
24838,2507,2545,0.5,2526.0,-38
24839,2535,2320,1.0,2427.5,215
24840,2256,2508,0.0,2382.0,-252
24841,2411,2322,1.0,2366.5,89
24842,2654,2387,1.0,2520.5,267
24843,2392,2467,1.0,2429.5,-75
24844,2203,2277,0.5,2240.0,-74
24845,2239,2396,0.5,2317.5,-157
24846,2544,2663,0.0,2603.5,-119
24847,2630,2517,0.5,2573.5,113
24848,2519,2553,0.5,2536.0,-34
24849,2117,2467,0.0,2292.0,-350
24850,2709,2544,1.0,2626.5,165
24851,2606,2650,1.0,2628.0,-44
24852,2572,2435,0.5,2503.5,137
24853,2447,2496,0.0,2471.5,-49
24854,2644,2644,0.5,2644.0,0
24855,2455,2608,1.0,2531.5,-153
24856,2544,2323,1.0,2433.5,221
24857,2277,2526,0.5,2401.5,-249
24858,2559,2571,1.0,2565.0,-12
24859,2595,2461,0.0,2528.0,134
24860,2470,2549,0.5,2509.5,-79
24861,2559,2425,0.0,2492.0,134
24862,2523,2533,1.0,2528.0,-10
24863,2537,2522,0.5,2529.5,15
24864,2418,2457,1.0,2437.5,-39
24865,2455,2453,0.5,2454.0,2
24866,2578,2469,0.5,2523.5,109
24867,2384,2474,0.0,2429.0,-90
24868,2448,2303,0.5,2375.5,145
24869,2224,2423,0.0,2323.5,-199
24870,2521,2448,0.5,2484.5,73
24871,2463,2505,1.0,2484.0,-42
24872,2437,2365,0.5,2401.0,72
24873,2222,2486,0.0,2354.0,-264
24874,2438,2484,0.0,2461.0,-46
24875,2487,2333,1.0,2410.0,154
24876,2286,2464,0.0,2375.0,-178
24877,2500,2157,0.0,2328.5,343
24878,2180,2154,0.5,2167.0,26
24879,2139,2082,1.0,2110.5,57
24880,2254,2084,1.0,2169.0,170
24881,2079,2139,0.5,2109.0,-60
24882,2307,2137,0.0,2222.0,170
24883,2113,2157,0.0,2135.0,-44
24884,2186,2057,1.0,2121.5,129
24885,2042,2170,0.0,2106.0,-128
24886,2272,2215,0.0,2243.5,57
24887,2214,2085,1.0,2149.5,129
24888,2125,2156,0.0,2140.5,-31
24889,2116,1760,1.0,1938.0,356
24890,2083,2222,0.5,2152.5,-139
24891,2193,2121,1.0,2157.0,72
24892,2087,2195,0.0,2141.0,-108
24893,2070,1929,0.5,1999.5,141
24894,2125,2055,0.5,2090.0,70
24895,2063,2081,0.0,2072.0,-18
24896,2120,2190,0.5,2155.0,-70
24897,1964,2121,0.0,2042.5,-157
24898,2067,2388,0.0,2227.5,-321
24899,2279,1803,1.0,2041.0,476
24900,2081,2155,0.0,2118.0,-74
24901,2012,2311,0.5,2161.5,-299
24902,2119,2270,0.0,2194.5,-151
24903,2068,1889,1.0,1978.5,179
24904,1755,1950,0.5,1852.5,-195
24905,2061,1930,1.0,1995.5,131
24906,1952,2131,0.5,2041.5,-179
24907,1960,2194,0.0,2077.0,-234
24908,2085,2309,0.5,2197.0,-224
24909,2143,2046,1.0,2094.5,97
24910,2038,2075,1.0,2056.5,-37
24911,2201,2263,0.5,2232.0,-62
24912,2085,1993,1.0,2039.0,92
24913,1996,2246,0.0,2121.0,-250
24914,2272,2026,1.0,2149.0,246
24915,2090,2068,0.0,2079.0,22
24916,2024,2172,0.0,2098.0,-148
24917,2173,2002,1.0,2087.5,171
24918,1802,2105,0.0,1953.5,-303
24919,2112,2085,1.0,2098.5,27
24920,2001,2253,0.0,2127.0,-252
24921,2014,1933,1.0,1973.5,81
24922,2032,2065,0.5,2048.5,-33
24923,2060,2216,0.0,2138.0,-156
24924,2106,2017,1.0,2061.5,89
24925,2115,1946,0.5,2030.5,169
24926,2164,2123,1.0,2143.5,41
24927,2036,2056,0.0,2046.0,-20
24928,2087,1972,0.5,2029.5,115
24929,1963,2090,0.0,2026.5,-127
24930,2106,1996,0.0,2051.0,110
24931,2036,1945,1.0,1990.5,91
24932,1858,2031,1.0,1944.5,-173
24933,1920,1878,0.0,1899.0,42
24934,1920,1880,1.0,1900.0,40
24935,2056,1883,1.0,1969.5,173
24936,1808,2034,0.5,1921.0,-226
24937,1917,1606,1.0,1761.5,311
24938,2335,1944,1.0,2139.5,391
24939,1910,2074,0.5,1992.0,-164
24940,1985,1860,1.0,1922.5,125
24941,1933,1977,1.0,1955.0,-44
24942,2011,2256,0.0,2133.5,-245
24943,2249,1987,1.0,2118.0,262
24944,1952,2321,0.0,2136.5,-369
24945,2352,1817,1.0,2084.5,535
24946,2297,2350,0.0,2323.5,-53
24947,2231,2246,0.0,2238.5,-15
24948,2114,2317,0.0,2215.5,-203
24949,2405,1829,1.0,2117.0,576
24950,1873,2250,0.0,2061.5,-377
24951,2121,1884,0.0,2002.5,237
24952,2344,1937,1.0,2140.5,407
24953,1883,2373,0.0,2128.0,-490
24954,2252,1828,1.0,2040.0,424
24955,1892,2183,0.0,2037.5,-291
24956,1746,2508,0.0,2127.0,-762
24957,2170,2044,1.0,2107.0,126
24958,2075,2320,0.0,2197.5,-245
24959,2334,1908,1.0,2121.0,426
24960,2180,2261,1.0,2220.5,-81
24961,2299,1645,1.0,1972.0,654
24962,1580,2244,0.0,1912.0,-664
24963,1948,2425,0.0,2186.5,-477
24964,2259,1844,1.0,2051.5,415
24965,1899,2166,0.0,2032.5,-267
24966,2222,1534,1.0,1878.0,688
24967,1828,2354,0.0,2091.0,-526
24968,2368,1630,1.0,1999.0,738
24969,1724,2229,0.0,1976.5,-505
24970,2106,1777,1.0,1941.5,329
24971,2414,1707,1.0,2060.5,707
24972,1922,2210,0.5,2066.0,-288
24973,2177,1799,1.0,1988.0,378
24974,2070,2125,0.0,2097.5,-55
24975,2176,2523,1.0,2349.5,-347
24976,2117,2122,1.0,2119.5,-5
24977,2315,1884,1.0,2099.5,431
24978,1931,2054,0.0,1992.5,-123
24979,2226,2326,1.0,2276.0,-100
24980,1928,2140,0.0,2034.0,-212
24981,2036,2277,1.0,2156.5,-241
24982,2296,1953,1.0,2124.5,343
24983,1899,2125,0.5,2012.0,-226
24984,2055,2181,1.0,2118.0,-126
24985,2280,1963,1.0,2121.5,317
24986,2245,2225,1.0,2235.0,20
24987,2283,1854,1.0,2068.5,429
24988,1688,2239,1.0,1963.5,-551
24989,2166,1689,0.5,1927.5,477
24990,1622,2202,0.0,1912.0,-580
24991,2329,1653,1.0,1991.0,676
24992,1577,2126,0.0,1851.5,-549
24993,2165,1479,1.0,1822.0,686
24994,2243,2103,1.0,2173.0,140
24995,2261,2118,1.0,2189.5,143
24996,2197,2273,1.0,2235.0,-76
24997,1833,1841,0.0,1837.0,-8
24998,2187,2168,1.0,2177.5,19
24999,2121,1909,1.0,2015.0,212
25000,2141,2218,1.0,2179.5,-77
25001,1783,1986,0.0,1884.5,-203
25002,2251,2143,1.0,2197.0,108
25003,2106,2169,1.0,2137.5,-63
25004,2164,2141,1.0,2152.5,23
25005,1751,2067,0.0,1909.0,-316
25006,2236,2110,0.0,2173.0,126
25007,2104,2069,0.0,2086.5,35
25008,2048,2183,1.0,2115.5,-135
25009,2372,1845,1.0,2108.5,527
25010,1769,2329,0.0,2049.0,-560
25011,2114,1720,1.0,1917.0,394
25012,1723,2226,0.0,1974.5,-503
25013,2713,2288,1.0,2500.5,425
25014,2357,2581,0.0,2469.0,-224
25015,2542,2299,1.0,2420.5,243
25016,2312,2563,0.0,2437.5,-251
25017,2805,2768,0.5,2786.5,37
25018,2720,2686,0.5,2703.0,34
25019,2672,2708,0.0,2690.0,-36
25020,2680,2655,0.5,2667.5,25
25021,2787,2745,0.5,2766.0,42
25022,2631,2706,1.0,2668.5,-75
25023,2659,2662,1.0,2660.5,-3
25024,2638,2653,1.0,2645.5,-15
25025,2877,2521,1.0,2699.0,356
25026,2437,2630,0.5,2533.5,-193
25027,2628,2486,1.0,2557.0,142
25028,2427,2528,0.5,2477.5,-101
25029,2709,2740,0.5,2724.5,-31
25030,2665,2646,0.0,2655.5,19
25031,2689,2650,0.5,2669.5,39
25032,2653,2612,1.0,2632.5,41
25033,2735,2760,0.5,2747.5,-25
25034,2664,2576,0.5,2620.0,88
25035,2640,2649,0.5,2644.5,-9
25036,2603,2612,0.5,2607.5,-9
25037,2801,2645,1.0,2723.0,156
25038,2590,2565,1.0,2577.5,25
25039,2587,2669,0.5,2628.0,-82
25040,2619,2560,0.5,2589.5,59
25041,2632,2713,0.5,2672.5,-81
25042,2618,2529,0.5,2573.5,89
25043,2569,2581,0.5,2575.0,-12
25044,2563,2614,0.5,2588.5,-51
25045,2536,2613,0.5,2574.5,-77
25046,2602,2543,0.5,2572.5,59
25047,2426,2554,0.0,2490.0,-128
25048,2539,2555,0.5,2547.0,-16
25049,2578,2710,0.5,2644.0,-132
25050,2634,2473,1.0,2553.5,161
25051,2474,2501,0.5,2487.5,-27
25052,2439,2423,0.0,2431.0,16
25053,2484,2760,0.0,2622.0,-276
25054,2751,2487,1.0,2619.0,264
25055,2464,2786,0.0,2625.0,-322
25056,2714,2426,1.0,2570.0,288
25057,2740,2718,1.0,2729.0,22
25058,2742,2637,1.0,2689.5,105
25059,2690,2668,0.0,2679.0,22
25060,2666,2704,0.5,2685.0,-38
25061,2743,2671,0.5,2707.0,72
25062,2606,2724,0.5,2665.0,-118
25063,2649,2563,1.0,2606.0,86
25064,2608,2613,0.5,2610.5,-5
25065,2678,2753,0.5,2715.5,-75
25066,2671,2580,1.0,2625.5,91
25067,2595,2656,0.5,2625.5,-61
25068,2651,2514,0.5,2582.5,137
25069,2716,2594,1.0,2655.0,122
25070,2598,2676,0.0,2637.0,-78
25071,2634,2499,0.5,2566.5,135
25072,2490,2549,1.0,2519.5,-59
25073,2772,2698,1.0,2735.0,74
25074,2624,2681,0.5,2652.5,-57
25075,2553,2618,1.0,2585.5,-65
25076,2603,2548,1.0,2575.5,55
25077,2649,2700,0.5,2674.5,-51
25078,2615,2570,1.0,2592.5,45
25079,2568,2510,0.0,2539.0,58
25080,2471,2522,1.0,2496.5,-51
25081,2545,2523,1.0,2534.0,22
25082,2522,2535,1.0,2528.5,-13
25083,2508,2418,1.0,2463.0,90
25084,2453,2491,1.0,2472.0,-38
25085,2709,2531,1.0,2620.0,178
25086,2559,2650,0.5,2604.5,-91
25087,2572,2470,0.5,2521.0,102
25088,2425,2496,1.0,2460.5,-71
25089,2625,2602,0.5,2613.5,23
25090,2571,2574,0.0,2572.5,-3
25091,2579,2586,1.0,2582.5,-7
25092,2487,2561,0.5,2524.0,-74
25093,2744,2590,0.5,2667.0,154
25094,2526,2717,0.0,2621.5,-191
25095,2680,2438,0.5,2559.0,242
25096,2363,2707,0.0,2535.0,-344
25097,2604,2500,0.5,2552.0,104
25098,2477,2522,0.0,2499.5,-45
25099,2503,2440,0.5,2471.5,63
25100,2353,2473,1.0,2413.0,-120
25101,2663,2654,0.0,2658.5,9
25102,2547,2629,1.0,2588.0,-82
25103,2630,2467,0.5,2548.5,163
25104,2203,2553,0.0,2378.0,-350
25105,2387,2544,1.0,2465.5,-157
25106,2517,2392,1.0,2454.5,125
25107,2277,2519,0.0,2398.0,-242
25108,2467,2239,1.0,2353.0,228
25109,2448,2602,0.0,2525.0,-154
25110,2455,2463,0.0,2459.0,-8
25111,2365,2323,0.0,2344.0,42
25112,2277,2222,1.0,2249.5,55
25113,2644,2591,0.5,2617.5,53
25114,2431,2641,0.0,2536.0,-210
25115,2608,2425,1.0,2516.5,183
25116,2445,2544,1.0,2494.5,-99
25117,2574,2256,1.0,2415.0,318
25118,2249,2574,0.0,2411.5,-325
25119,2564,2321,1.0,2442.5,243
25120,2352,2541,0.5,2446.5,-189
25121,2562,2297,1.0,2429.5,265
25122,2350,2525,0.0,2437.5,-175
25123,2533,2231,1.0,2382.0,302
25124,2246,2477,0.5,2361.5,-231
25125,2344,2644,0.0,2494.0,-300
25126,2556,2373,1.0,2464.5,183
25127,2252,2460,1.0,2356.0,-208
25128,2447,2024,1.0,2235.5,423
25129,2544,2508,0.5,2526.0,36
25130,2170,2435,0.0,2302.5,-265
25131,2402,2320,0.5,2361.0,82
25132,2105,2447,0.0,2276.0,-342
25133,2653,2425,1.0,2539.0,228
25134,2259,2448,1.0,2353.5,-189
25135,2390,2166,1.0,2278.0,224
25136,2222,2313,0.0,2267.5,-91
25137,2659,2354,1.0,2506.5,305
25138,2368,2569,0.0,2468.5,-201
25139,2537,2229,1.0,2383.0,308
25140,2106,2490,1.0,2298.0,-384
25141,2523,2627,0.5,2575.0,-104
25142,2487,2222,1.0,2354.5,265
25143,2176,2466,0.0,2321.0,-290
25144,2589,2122,1.0,2355.5,467
25145,2533,2315,1.0,2424.0,218
25146,2326,2537,0.0,2431.5,-211
25147,2455,2226,0.5,2340.5,229
25148,2140,2398,0.0,2269.0,-258
25149,2329,2513,0.0,2421.0,-184
25150,2439,2126,0.0,2282.5,313
25151,2258,2402,1.0,2330.0,-144
25152,2334,2103,1.0,2218.5,231
25153,2263,2427,0.0,2345.0,-164
25154,2382,2085,1.0,2233.5,297
25155,2246,2387,0.0,2316.5,-141
25156,2391,2272,1.0,2331.5,119
25157,2243,2611,0.0,2427.0,-368
25158,2328,2118,1.0,2223.0,210
25159,2261,2251,0.0,2256.0,10
25160,1893,2221,1.0,2057.0,-328
25161,2449,2273,0.5,2361.0,176
25162,2197,2318,1.0,2257.5,-121
25163,2365,2168,1.0,2266.5,197
25164,2187,2320,1.0,2253.5,-133
25165,2307,2471,0.0,2389.0,-164
25166,2330,2157,0.5,2243.5,173
25167,2186,2380,1.0,2283.0,-194
25168,2173,2170,0.5,2171.5,3
25169,2218,2222,1.0,2220.0,-4
25170,2193,2215,0.0,2204.0,-22
25171,2214,2195,1.0,2204.5,19
25172,2070,2156,0.5,2113.0,-86
25173,2194,2388,0.0,2291.0,-194
25174,2279,2218,1.0,2248.5,61
25175,2141,2155,0.0,2148.0,-14
25176,2502,1986,0.0,2244.0,516
25177,2164,2141,0.0,2152.5,23
25178,2419,2495,0.0,2457.0,-76
25179,2093,2154,0.5,2123.5,-61
25180,2406,2323,1.0,2364.5,83
25181,2303,2384,1.0,2343.5,-81
25182,2341,2224,0.5,2282.5,117
25183,2333,2438,1.0,2385.5,-105
25184,2296,2277,0.0,2286.5,19
25185,2239,2286,1.0,2262.5,-47
25186,2622,2125,1.0,2373.5,497
25187,2251,2143,0.0,2197.0,108
25188,2473,2593,0.0,2533.0,-120
25189,1951,2106,0.5,2028.5,-155
25190,2549,2458,1.0,2503.5,91
25191,2253,2183,0.5,2218.0,70
25192,2365,2461,1.0,2413.0,-96
25193,2065,2014,0.0,2039.5,51
25194,2581,2186,1.0,2383.5,395
25195,2048,2183,0.0,2115.5,-135
25196,2284,2416,1.0,2350.0,-132
25197,2099,2139,0.0,2119.0,-40
25198,2125,2061,0.5,2093.0,64
25199,2419,2441,1.0,2430.0,-22
25200,2120,2081,0.5,2100.5,39
25201,2349,2347,1.0,2348.0,2
25202,2590,2121,1.0,2355.5,469
25203,2056,2164,0.5,2110.0,-108
25204,2301,2337,1.0,2319.0,-36
25205,2090,2024,1.0,2057.0,66
25206,2571,2181,1.0,2376.0,390
25207,2366,2387,0.5,2376.5,-21
25208,2559,2549,1.0,2554.0,10
25209,2177,2383,0.0,2280.0,-206
25210,2414,2554,0.0,2484.0,-140
25211,2277,2350,1.0,2313.5,-73
25212,2210,2244,0.5,2227.0,-34
25213,1899,2225,1.0,2062.0,-326
25214,2317,2177,0.0,2247.0,140
25215,2332,2472,0.0,2402.0,-140
25216,2173,2172,0.5,2172.5,1
25217,2128,2283,0.0,2205.5,-155
25218,2236,2105,1.0,2170.5,131
25219,1944,2039,0.0,1991.5,-95
25220,2069,2110,1.0,2089.5,-41
25221,2334,2078,0.0,2206.0,256
25222,2361,2507,1.0,2434.0,-146
25223,2299,2261,0.0,2280.0,38
25224,2322,2256,0.0,2289.0,66
25225,2106,2216,1.0,2161.0,-110
25226,1781,2188,1.0,1984.5,-407
25227,2525,2012,1.0,2268.5,513
25228,1893,2296,0.0,2094.5,-403
25229,2374,2291,0.0,2332.5,83
25230,2311,2378,0.0,2344.5,-67
25231,2399,2309,1.0,2354.0,90
25232,2143,2289,0.0,2216.0,-146
25233,2236,2121,0.5,2178.5,115
25234,2513,2068,1.0,2290.5,445
25235,2061,2390,1.0,2225.5,-329
25236,2411,1980,1.0,2195.5,431
25237,2137,2501,0.5,2319.0,-364
25238,2317,2435,1.0,2376.0,-118
25239,2436,2405,0.5,2420.5,31
25240,2250,2275,0.0,2262.5,-25
25241,2305,2193,0.0,2249.0,112
25242,2416,2181,0.5,2298.5,235
25243,2280,2413,0.0,2346.5,-133
25244,2392,2225,1.0,2308.5,167
25245,2245,2266,0.5,2255.5,-21
25246,2333,2283,0.0,2308.0,50
25247,2239,2255,0.0,2247.0,-16
25248,2425,2166,1.0,2295.5,259
25249,2202,2190,0.5,2196.0,12
25250,2408,1880,1.0,2144.0,528
25251,2056,2323,0.0,2189.5,-267
25252,2236,2000,0.5,2118.0,236
25253,1917,2224,0.0,2070.5,-307
25254,1996,2396,0.0,2196.0,-400
25255,2180,2036,1.0,2108.0,144
25256,2031,2254,0.0,2142.5,-223
25257,2139,1920,1.0,2029.5,219
25258,2154,1945,0.5,2049.5,209
25259,2111,2139,0.5,2125.0,-28
25260,2084,1858,1.0,1971.0,226
25261,1878,1979,0.5,1928.5,-101
25262,1920,2272,0.0,2096.0,-352
25263,2085,1883,0.0,1984.0,202
25264,1808,2125,0.0,1966.5,-317
25265,1846,1606,0.5,1726.0,240
25266,1950,1845,0.5,1897.5,105
25267,1848,1802,0.0,1825.0,46
25268,1755,1769,1.0,1762.0,-14
25269,2067,2270,1.0,2168.5,-203
25270,2119,1803,1.0,1961.0,316
25271,2081,1976,1.0,2028.5,105
25272,2036,2311,1.0,2173.5,-275
25273,2044,1746,1.0,1895.0,298
25274,1899,1953,0.5,1926.0,-54
25275,1779,2075,0.0,1927.0,-296
25276,1689,1688,1.0,1688.5,1
25277,1899,1844,1.0,1871.5,55
25278,2113,1622,0.5,1867.5,491
25279,1630,1828,1.0,1729.0,-198
25280,2057,2105,1.0,2081.0,-48
25281,1777,1724,0.0,1750.5,53
25282,2083,2042,1.0,2062.5,41
25283,2060,2070,0.0,2065.0,-10
25284,2024,2121,1.0,2072.5,-97
25285,1884,1929,0.0,1906.5,-45
25286,2030,2114,0.0,2072.0,-84
25287,1817,1846,0.0,1831.5,-29
25288,1841,2180,0.0,2010.5,-339
25289,1645,1833,0.0,1739.0,-188
25290,1909,1580,0.0,1744.5,329
25291,1729,2055,0.5,1892.0,-326
25292,2001,1933,0.5,1967.0,68
25293,2032,1751,1.0,1891.5,281
25294,1707,2020,1.0,1863.5,-313
25295,1799,1922,1.0,1860.5,-123
25296,2131,1685,0.5,1908.0,446
25297,1933,1985,1.0,1959.0,-52
25298,2194,1952,1.0,2073.0,242
25299,2030,1977,1.0,2003.5,53
25300,2011,2064,0.0,2037.5,-53
25301,2085,1987,1.0,2036.0,98
25302,1817,2038,0.0,1927.5,-221
25303,1937,1944,0.0,1940.5,-7
25304,1910,1883,0.0,1896.5,27
25305,1969,2051,1.0,2010.0,-82
25306,1565,1892,0.0,1728.5,-327
25307,2055,2054,0.0,2054.5,1
25308,1931,2063,1.0,1997.0,-132
25309,1928,1964,0.5,1946.0,-36
25310,2068,1817,1.0,1942.5,251
25311,1830,2070,1.0,1950.0,-240
25312,2024,1532,0.5,1778.0,492
25313,1653,2002,1.0,1827.5,-349
25314,2017,2060,1.0,2038.5,-43
25315,1479,1577,0.0,1528.0,-98
25316,2123,2115,1.0,2119.0,8
25317,1972,1951,1.0,1961.5,21
25318,1783,1963,0.0,1873.0,-180
25319,1993,2201,1.0,2097.0,-208
25320,2026,1996,1.0,2011.0,30
25321,2527,2372,0.5,2449.5,155
25322,2250,2114,1.0,2182.0,136
25323,2132,2186,0.0,2159.0,-54
25324,2288,2335,0.5,2311.5,-47
25325,2268,2357,0.0,2312.5,-89
25326,2299,2312,1.0,2305.5,-13
25327,2540,1973,1.0,2256.5,567
25328,2003,2531,0.0,2267.0,-528
25329,2484,1950,1.0,2217.0,534
25330,1947,2479,0.0,2213.0,-532
25331,2216,1989,0.0,2102.5,227
25332,1567,2189,0.0,1878.0,-622
25333,2166,1525,1.0,1845.5,641
25334,1421,2213,0.0,1817.0,-792
25335,2112,2530,0.0,2321.0,-418
25336,2487,1941,1.0,2214.0,546
25337,1844,2468,0.0,2156.0,-624
25338,2379,1972,1.0,2175.5,407
25339,2550,2012,1.0,2281.0,538
25340,1859,2494,0.0,2176.5,-635
25341,2475,1800,1.0,2137.5,675
25342,1707,2435,0.0,2071.0,-728
25343,1938,2418,0.0,2178.0,-480
25344,2392,2064,1.0,2228.0,328
25345,1947,2352,0.0,2149.5,-405
25346,2318,1787,1.0,2052.5,531
25347,2422,2112,1.0,2267.0,310
25348,2211,2446,0.5,2328.5,-235
25349,2354,1791,1.0,2072.5,563
25350,1687,2327,0.0,2007.0,-640
25351,2103,2474,0.0,2288.5,-371
25352,2366,1975,1.0,2170.5,391
25353,1904,2315,0.0,2109.5,-411
25354,2252,1794,1.0,2023.0,458
25355,2470,1811,1.0,2140.5,659
25356,2052,2380,0.0,2216.0,-328
25357,2359,1972,0.5,2165.5,387
25358,1938,2301,0.0,2119.5,-363
25359,1964,2385,0.0,2174.5,-421
25360,2375,1945,1.0,2160.0,430
25361,1916,2316,0.5,2116.0,-400
25362,2318,1886,1.0,2102.0,432
25363,2017,2275,0.0,2146.0,-258
25364,2313,2017,1.0,2165.0,296
25365,1833,2109,0.0,1971.0,-276
25366,1986,2395,0.0,2190.5,-409
25367,2424,1877,1.0,2150.5,547
25368,1899,2314,0.0,2106.5,-415
25369,2258,1906,0.0,2082.0,352
25370,2464,1981,1.0,2222.5,483
25371,2033,2364,0.0,2198.5,-331
25372,2301,1759,1.0,2030.0,542
25373,1519,2318,0.0,1918.5,-799
25374,2327,2347,1.0,2337.0,-20
25375,1974,2010,0.0,1992.0,-36
25376,2274,2321,1.0,2297.5,-47
25377,1859,1831,0.5,1845.0,28
25378,2312,2425,1.0,2368.5,-113
25379,1994,1981,0.0,1987.5,13
25380,2145,2323,1.0,2234.0,-178
25381,2391,1616,1.0,2003.5,775
25382,2004,2021,0.5,2012.5,-17
25383,2317,2324,1.0,2320.5,-7
25384,1785,1698,0.0,1741.5,87
25385,2071,2314,1.0,2192.5,-243
25386,2375,2336,0.5,2355.5,39
25387,1781,1890,0.0,1835.5,-109
25388,2252,2333,1.0,2292.5,-81
25389,2358,1693,1.0,2025.5,665
25390,1942,1964,0.0,1953.0,-22
25391,2338,2383,1.0,2360.5,-45
25392,1762,1649,0.0,1705.5,113
25393,1899,2214,0.0,2056.5,-315
25394,2324,2345,1.0,2334.5,-21
25395,1846,1920,0.0,1883.0,-74
25396,2317,2270,1.0,2293.5,47
25397,2307,1764,0.0,2035.5,543
25398,1921,2107,0.0,2014.0,-186
25399,2329,2269,1.0,2299.0,60
25400,1687,1709,0.0,1698.0,-22
25401,2024,2171,0.0,2097.5,-147
25402,2269,2352,1.0,2310.5,-83
25403,1747,1782,0.0,1764.5,-35
25404,2147,2232,1.0,2189.5,-85
25405,2229,1768,1.0,1998.5,461
25406,1734,1935,0.0,1834.5,-201
25407,2274,2334,1.0,2304.0,-60
25408,1795,1830,0.0,1812.5,-35
25409,1833,2263,0.0,2048.0,-430
25410,2206,2396,1.0,2301.0,-190
25411,1769,1713,0.0,1741.0,56
25412,2029,2128,1.0,2078.5,-99
25413,2282,1774,1.0,2028.0,508
25414,1732,1756,0.0,1744.0,-24
25415,2235,2218,1.0,2226.5,17
25416,1697,1805,0.0,1751.0,-108
25417,2422,2121,1.0,2271.5,301
25418,2347,2278,1.0,2312.5,69
25419,1731,1552,0.0,1641.5,179
25420,2217,2247,1.0,2232.0,-30
25421,2312,1550,1.0,1931.0,762
25422,1840,1892,0.0,1866.0,-52
25423,2276,2275,1.0,2275.5,1
25424,1627,1798,0.0,1712.5,-171
25425,1844,2200,0.0,2022.0,-356
25426,2289,2237,1.0,2263.0,52
25427,1735,1778,0.0,1756.5,-43
25428,2174,2271,1.0,2222.5,-97
25429,2346,1762,1.0,2054.0,584
25430,1869,1862,0.0,1865.5,7
25431,2125,2109,1.0,2117.0,16
25432,1657,1689,0.0,1673.0,-32
25433,1777,2123,0.0,1950.0,-346
25434,2257,2500,1.0,2378.5,-243
25435,1727,1715,0.5,1721.0,12
25436,2000,1933,1.0,1966.5,67
25437,2368,1624,1.0,1996.0,744
25438,1660,1633,0.0,1646.5,27
25439,2210,2210,1.0,2210.0,0
25440,1678,1920,0.0,1799.0,-242
25441,1747,2186,0.0,1966.5,-439
25442,2281,2327,1.0,2304.0,-46
25443,1759,1627,1.0,1693.0,132
25444,2042,2074,1.0,2058.0,-32
25445,2240,1589,1.0,1914.5,651
25446,1664,1726,0.0,1695.0,-62
25447,2218,2170,1.0,2194.0,48
25448,1603,1762,0.0,1682.5,-159
25449,1592,2180,0.0,1886.0,-588
25450,2190,2291,1.0,2240.5,-101
25451,1663,1771,0.0,1717.0,-108
25452,2019,2156,1.0,2087.5,-137
25453,2456,1667,1.0,2061.5,789
25454,1737,1607,0.0,1672.0,130
25455,2135,2189,1.0,2162.0,-54
25456,1622,1723,0.0,1672.5,-101
25457,2318,2269,1.0,2293.5,49
25458,1803,1536,0.0,1669.5,267
25459,2113,2184,1.0,2148.5,-71
25460,2170,1676,1.0,1923.0,494
25461,1747,1747,0.5,1747.0,0
25462,2117,2160,1.0,2138.5,-43
25463,1362,1634,0.0,1498.0,-272
25464,1712,2032,0.5,1872.0,-320
25465,2259,2251,1.0,2255.0,8
25466,2221,2043,1.0,2132.0,178
25467,1846,1698,0.0,1772.0,148
25468,2171,2120,1.0,2145.5,51
25469,2095,2016,1.0,2055.5,79
25470,2407,1541,1.0,1974.0,866
25471,1681,2261,0.0,1971.0,-580
25472,1724,2020,0.0,1872.0,-296
25473,1727,2293,0.0,2010.0,-566
25474,2196,1576,1.0,1886.0,620
25475,1534,2070,0.5,1802.0,-536
25476,2032,1538,1.0,1785.0,494
25477,2153,1874,1.0,2013.5,279
25478,1677,2169,0.0,1923.0,-492
25479,1752,2123,0.0,1937.5,-371
25480,1628,2214,0.0,1921.0,-586
25481,2205,1546,1.0,1875.5,659
25482,1472,2098,0.0,1785.0,-626
25483,2165,1536,1.0,1850.5,629
25484,2294,1838,1.0,2066.0,456
25485,1749,2205,0.0,1977.0,-456
25486,2127,2027,0.0,2077.0,100
25487,1627,2241,0.0,1934.0,-614
25488,2136,1454,1.0,1795.0,682
25489,1579,2089,0.0,1834.0,-510
25490,2109,1364,1.0,1736.5,745
25491,2141,1864,1.0,2002.5,277
25492,1540,2127,0.0,1833.5,-587
25493,2044,1521,1.0,1782.5,523
25494,1690,2099,0.0,1894.5,-409
25495,2094,2205,1.0,2149.5,-111
25496,1594,1511,0.0,1552.5,83
25497,2216,2068,1.0,2142.0,148
25498,2168,1811,1.0,1989.5,357
25499,1501,2173,0.0,1837.0,-672
25500,2098,1461,1.0,1779.5,637
25501,1519,2119,0.0,1819.0,-600
25502,2096,2076,1.0,2086.0,20
25503,1478,1723,0.0,1600.5,-245
25504,2008,2118,1.0,2063.0,-110
25505,2226,2222,0.0,2224.0,4
25506,2026,1526,1.0,1776.0,500
25507,1680,2000,0.0,1840.0,-320
25508,2262,2559,0.0,2410.5,-297
25509,2508,1994,1.0,2251.0,514
25510,1708,2468,0.0,2088.0,-760
25511,2453,1849,1.0,2151.0,604
25512,2342,2017,1.0,2179.5,325
25513,1797,2325,0.0,2061.0,-528
25514,2303,1851,1.0,2077.0,452
25515,1481,2279,0.0,1880.0,-798
25516,1507,2182,0.0,1844.5,-675
25517,2044,1530,1.0,1787.0,514
25518,1289,2048,0.0,1668.5,-759
25519,2394,1832,1.0,2113.0,562
25520,1913,2077,1.0,1995.0,-164
25521,1467,2027,0.5,1747.0,-560
25522,1860,2113,0.5,1986.5,-253
25523,2061,1982,0.0,2021.5,79
25524,2170,2095,0.0,2132.5,75
25525,1710,1862,0.0,1786.0,-152
25526,2008,2229,1.0,2118.5,-221
25527,1675,2045,0.5,1860.0,-370
25528,2122,1464,1.0,1793.0,658
25529,1969,2074,1.0,2021.5,-105
25530,2057,2159,0.0,2108.0,-102
25531,1916,1979,0.0,1947.5,-63
25532,2178,2060,0.0,2119.0,118
25533,1944,1873,0.0,1908.5,71
25534,2001,2147,1.0,2074.0,-146
25535,1964,1995,1.0,1979.5,-31
25536,2169,2065,0.0,2117.0,104
25537,1954,1932,0.0,1943.0,22
25538,2076,2188,1.0,2132.0,-112
25539,1715,1922,1.0,1818.5,-207
25540,2081,2016,0.0,2048.5,65
25541,1939,1950,0.0,1944.5,-11
25542,1999,2049,1.0,2024.0,-50
25543,1943,2041,1.0,1992.0,-98
25544,1982,1915,0.0,1948.5,67
25545,1862,1839,0.0,1850.5,23
25546,2027,2102,1.0,2064.5,-75
25547,1893,1980,1.0,1936.5,-87
25548,2158,2020,0.0,2089.0,138
25549,1903,1692,0.0,1797.5,211
25550,1968,2085,1.0,2026.5,-117
25551,1610,1920,1.0,1765.0,-310
25552,2559,2207,1.0,2383.0,352
25553,2076,2508,0.0,2292.0,-432
25554,2468,2096,1.0,2282.0,372
25555,2118,2453,0.0,2285.5,-335
25556,2168,2216,0.0,2192.0,-48
25557,2189,2173,1.0,2181.0,16
25558,2119,2166,0.0,2142.5,-47
25559,2182,2122,1.0,2152.0,60
25560,2226,2540,0.0,2383.0,-314
25561,2524,2222,1.0,2373.0,302
25562,2000,2484,0.0,2242.0,-484
25563,2479,1991,1.0,2235.0,488
25564,2555,2182,0.5,2368.5,373
25565,2165,2487,0.5,2326.0,-322
25566,2468,2048,1.0,2258.0,420
25567,1953,2379,0.0,2166.0,-426
25568,2170,2550,0.0,2360.0,-380
25569,2494,2095,1.0,2294.5,399
25570,2100,2475,1.0,2287.5,-375
25571,2435,1862,1.0,2148.5,573
25572,2521,2122,1.0,2321.5,399
25573,2074,2418,0.5,2246.0,-344
25574,2392,2019,1.0,2205.5,373
25575,1960,2352,0.0,2156.0,-392
25576,2474,2178,1.0,2326.0,296
25577,2060,2466,0.0,2263.0,-406
25578,2315,1944,0.0,2129.5,371
25579,1873,2252,0.0,2062.5,-379
25580,2147,2453,0.0,2300.0,-306
25581,2275,2001,1.0,2138.0,274
25582,1995,2313,0.0,2154.0,-318
25583,2109,1984,1.0,2046.5,125
25584,2169,2464,0.0,2316.5,-295
25585,2369,2065,0.0,2217.0,304
25586,1954,2364,0.5,2159.0,-410
25587,2318,1932,1.0,2125.0,386
25588,2485,2188,1.0,2336.5,297
25589,2076,2327,0.0,2201.5,-251
25590,2321,1922,1.0,2121.5,399
25591,1715,2274,0.0,1994.5,-559
25592,2081,2505,0.0,2293.0,-424
25593,2342,2016,1.0,2179.0,326
25594,1997,2325,0.0,2161.0,-328
25595,2303,1939,0.5,2121.0,364
25596,2049,2358,0.0,2203.5,-309
25597,2338,1999,1.0,2168.5,339
25598,2041,2214,0.5,2127.5,-173
25599,2034,1895,1.0,1964.5,139
25600,2345,2273,0.5,2309.0,72
25601,1982,2324,0.0,2153.0,-342
25602,2270,1915,1.0,2092.5,355
25603,1862,2317,0.0,2089.5,-455
25604,2352,2102,1.0,2227.0,250
25605,2027,2324,0.0,2175.5,-297
25606,2232,1980,1.0,2106.0,252
25607,1893,2147,0.0,2020.0,-254
25608,2158,2229,0.0,2193.5,-71
25609,2334,2020,1.0,2177.0,314
25610,1903,2286,0.0,2094.5,-383
25611,2274,1877,1.0,2075.5,397
25612,2396,2085,1.0,2240.5,311
25613,1968,2397,0.0,2182.5,-429
25614,2206,1920,1.0,2063.0,286
25615,1610,2128,0.0,1869.0,-518
25616,2218,2367,1.0,2292.5,-149
25617,2121,2235,1.0,2178.0,-114
25618,2312,2422,0.5,2367.0,-110
25619,2404,2275,0.5,2339.5,129
25620,2276,2446,0.0,2361.0,-170
25621,2354,2198,1.0,2276.0,156
25622,2215,2470,0.0,2342.5,-255
25623,2398,2237,1.0,2317.5,161
25624,2289,2380,0.5,2334.5,-91
25625,2301,2271,0.0,2286.0,30
25626,2480,2410,0.5,2445.0,70
25627,2346,2375,0.0,2360.5,-29
25628,2316,2109,1.0,2212.5,207
25629,2125,2318,0.0,2221.5,-193
25630,2425,2368,0.5,2396.5,57
25631,2210,2312,0.0,2261.0,-102
25632,2297,2210,0.5,2253.5,87
25633,2168,2145,1.0,2156.5,23
25634,2299,2391,0.0,2345.0,-92
25635,2324,2240,1.0,2282.0,84
25636,2170,2317,1.0,2243.5,-147
25637,2276,2218,1.0,2247.0,58
25638,2500,2296,0.5,2398.0,204
25639,2291,2235,0.5,2263.0,56
25640,2257,2190,0.5,2223.5,67
25641,2156,2000,1.0,2078.0,156
25642,2386,2456,1.0,2421.0,-70
25643,2189,2170,0.5,2179.5,19
25644,2160,2135,0.0,2147.5,25
25645,2131,2117,1.0,2124.0,14
25646,2269,2251,0.5,2260.0,18
25647,2259,2318,0.0,2288.5,-59
25648,2184,2221,0.0,2202.5,-37
25649,2074,2113,0.0,2093.5,-39
25650,2401,2293,0.5,2347.0,108
25651,2196,2120,1.0,2158.0,76
25652,2171,2070,0.0,2120.5,101
25653,2032,2016,1.0,2024.0,16
25654,2394,2407,0.0,2400.5,-13
25655,2261,2077,1.0,2169.0,184
25656,1913,2032,0.0,1972.5,-119
25657,2020,1862,1.0,1941.0,158
25658,2113,2236,0.0,2174.5,-123
25659,2169,2089,1.0,2129.0,80
25660,2061,2129,0.0,2095.0,-68
25661,2123,1982,0.0,2052.5,141
25662,2214,2229,1.0,2221.5,-15
25663,2008,2205,0.0,2106.5,-197
25664,2098,1942,1.0,2020.0,156
25665,2045,2165,0.5,2105.0,-120
25666,2395,2294,1.0,2344.5,101
25667,2127,2424,0.0,2275.5,-297
25668,2385,2027,0.0,2206.0,358
25669,1815,2314,0.0,2064.5,-499
25670,2241,2269,0.0,2255.0,-28
25671,2329,2089,1.0,2209.0,240
25672,2109,2171,0.0,2140.0,-62
25673,2331,2145,1.0,2238.0,186
25674,2278,2228,0.0,2253.0,50
25675,2141,2347,0.0,2244.0,-206
25676,2217,2044,1.0,2130.5,173
25677,2099,2200,1.0,2149.5,-101
25678,2327,2205,1.0,2266.0,122
25679,2094,2281,0.0,2187.5,-187
25680,2291,2068,1.0,2179.5,223
25681,2216,2042,1.0,2129.0,174
25682,2336,2375,0.0,2355.5,-39
25683,2289,2252,0.0,2270.5,37
25684,1991,2071,0.5,2031.0,-80
25685,1890,1756,1.0,1823.0,134
25686,1732,1693,1.0,1712.5,39
25687,1763,1805,0.0,1784.0,-42
25688,1892,1986,0.0,1939.0,-94
25689,1877,1840,0.5,1858.5,37
25690,1798,1899,0.5,1848.5,-101
25691,1906,1627,1.0,1766.5,279
25692,2107,1778,1.0,1942.5,329
25693,1735,1921,0.0,1828.0,-186
25694,1709,1762,0.0,1735.5,-53
25695,1723,1687,0.0,1705.0,36
25696,1862,2422,0.0,2142.0,-560
25697,1552,1869,0.0,1710.5,-317
25698,1689,1731,1.0,1710.0,-42
25699,1550,1599,1.0,1574.5,-49
25700,1633,1627,0.0,1630.0,6
25701,1669,1660,1.0,1664.5,9
25702,1920,1759,0.0,1839.5,161
25703,1589,1678,1.0,1633.5,-89
25704,1726,1989,1.0,1857.5,-263
25705,1567,1664,0.0,1615.5,-97
25706,1762,1525,1.0,1643.5,237
25707,1487,1603,0.5,1545.0,-116
25708,2112,1592,1.0,1852.0,520
25709,1663,1791,0.0,1727.0,-128
25710,1687,1667,1.0,1677.0,20
25711,1811,1618,1.0,1714.5,193
25712,1737,1607,0.0,1672.0,130
25713,1972,2052,1.0,2012.0,-80
25714,1537,1723,0.0,1630.0,-186
25715,1916,1945,1.0,1930.5,-29
25716,1803,1536,1.0,1669.5,267
25717,1860,1886,1.0,1873.0,-26
25718,1846,1676,0.0,1761.0,170
25719,1994,1981,0.5,1987.5,13
25720,1616,1734,1.0,1675.0,-118
25721,2021,1346,1.0,1683.5,675
25722,1681,2004,0.5,1842.5,-323
25723,1724,1785,0.0,1754.5,-61
25724,1874,1777,0.0,1825.5,97
25725,1727,1677,0.5,1702.0,50
25726,1729,1624,1.0,1676.5,105
25727,1747,1752,1.0,1749.5,-5
25728,1546,1628,0.0,1587.0,-82
25729,1634,1747,1.0,1690.5,-113
25730,1536,1472,0.0,1504.0,64
25731,1838,1478,0.0,1658.0,360
25732,1738,1712,1.0,1725.0,26
25733,1698,1749,0.0,1723.5,-51
25734,1519,2262,0.0,1890.5,-743
25735,1994,1723,0.0,1858.5,271
25736,1478,1708,0.0,1593.0,-230
25737,2017,1797,0.5,1907.0,220
25738,1851,1481,0.0,1666.0,370
25739,1627,1727,1.0,1677.0,-100
25740,1576,1454,1.0,1515.0,122
25741,1579,1534,0.0,1556.5,45
25742,1538,1364,1.0,1451.0,174
25743,1864,1832,0.0,1848.0,32
25744,1521,1540,0.5,1530.5,-19
25745,1860,1467,0.5,1663.5,393
25746,1511,1690,1.0,1600.5,-179
25747,1811,1594,1.0,1702.5,217
25748,1461,1501,1.0,1481.0,-40
25749,2003,1464,1.0,1733.5,539
25750,1947,1950,1.0,1948.5,-3
25751,1483,1526,0.0,1504.5,-43
25752,1507,1804,0.0,1655.5,-297
25753,1941,2112,1.0,2026.5,-171
25754,1441,1844,0.0,1642.5,-403
25755,2010,1974,0.0,1992.0,36
25756,1839,1710,1.0,1774.5,129
25757,2012,1410,1.0,1711.0,602
25758,1800,1859,1.0,1829.5,-59
25759,1947,2064,1.0,2005.5,-117
25760,1874,1787,1.0,1830.5,87
25761,1975,2103,1.0,2039.0,-128
25762,1663,1904,1.0,1783.5,-241
25763,2017,2017,0.0,2017.0,0
25764,1981,1833,1.0,1907.0,148
25765,1759,2033,1.0,1896.0,-274
25766,1920,1899,1.0,1909.5,21
25767,1764,1846,1.0,1805.0,-82
25768,1782,2024,0.0,1903.0,-242
25769,1768,1747,1.0,1757.5,21
25770,1734,1731,0.0,1732.5,3
25771,1830,1795,0.0,1812.5,35
25772,1918,1833,1.0,1875.5,85
25773,1774,1769,1.0,1771.5,5
25774,2474,2661,0.0,2567.5,-187
25775,2559,2466,1.0,2512.5,93
25776,2366,2468,0.5,2417.0,-102
25777,2453,2315,0.5,2384.0,138
25778,2216,2485,0.0,2350.5,-269
25779,2347,2189,1.0,2268.0,158
25780,2213,2321,0.5,2267.0,-108
25781,2274,2182,0.5,2228.0,92
25782,2540,2480,0.5,2510.0,60
25783,2385,2524,0.5,2454.5,-139
25784,2531,2375,1.0,2453.0,156
25785,2318,2484,0.5,2401.0,-166
25786,2490,2307,0.5,2398.5,183
25787,2269,2453,0.0,2361.0,-184
25788,2275,2329,0.5,2302.0,-54
25789,2171,2313,0.0,2242.0,-142
25790,2293,2352,0.0,2322.5,-59
25791,2324,2196,1.0,2260.0,128
25792,2070,2269,0.0,2169.5,-199
25793,2147,2032,1.0,2089.5,115
25794,2229,2236,0.0,2232.5,-7
25795,2153,2334,0.0,2243.5,-181
25796,2286,2169,0.5,2227.5,117
25797,2129,2263,0.0,2196.0,-134
25798,2422,2396,0.5,2409.0,26
25799,2397,2404,1.0,2400.5,-7
25800,2446,2206,0.0,2326.0,240
25801,2128,2327,0.0,2227.5,-199
25802,2464,2367,1.0,2415.5,97
25803,2282,2369,1.0,2325.5,-87
25804,2301,2218,1.0,2259.5,83
25805,2235,2318,0.0,2276.5,-83
25806,2407,2324,1.0,2365.5,83
25807,2317,2261,0.5,2289.0,56
25808,2032,2314,0.0,2173.0,-282
25809,2276,2020,1.0,2148.0,256
25810,2336,2521,0.5,2428.5,-185
25811,2418,2375,0.5,2396.5,43
25812,2333,2392,1.0,2362.5,-59
25813,2318,2289,1.0,2303.5,29
25814,2296,2505,0.5,2400.5,-209
25815,2342,2291,1.0,2316.5,51
25816,2190,2303,1.0,2246.5,-113
25817,2279,2156,0.5,2217.5,123
25818,2269,2345,0.5,2307.0,-76
25819,2324,2318,0.5,2321.0,6
25820,2113,2270,0.5,2191.5,-157
25821,2291,2102,1.0,2196.5,189
25822,2395,2555,0.0,2475.0,-160
25823,2530,2424,0.5,2477.0,106
25824,2385,2468,0.5,2426.5,-83
25825,2379,2314,0.0,2346.5,65
25826,2358,2456,0.0,2407.0,-98
25827,2189,2383,0.0,2286.0,-194
25828,2338,2135,1.0,2236.5,203
25829,2131,2034,0.0,2082.5,97
25830,2470,2214,0.5,2342.0,256
25831,2205,2398,0.5,2301.5,-193
25832,2380,2098,0.0,2239.0,282
25833,2165,2359,0.0,2262.0,-194
25834,2550,2327,1.0,2438.5,223
25835,2281,2494,0.0,2387.5,-213
25836,2475,2291,1.0,2383.0,184
25837,2074,2435,0.5,2254.5,-361
25838,2368,2347,1.0,2357.5,21
25839,2247,2210,0.0,2228.5,37
25840,2186,2217,1.0,2201.5,-31
25841,2200,2168,0.0,2184.0,32
25842,2228,2425,0.5,2326.5,-197
25843,2312,2127,1.0,2219.5,185
25844,2044,2297,0.5,2170.5,-253
25845,2323,2099,1.0,2211.0,224
25846,2215,2158,1.0,2186.5,57
25847,2020,2289,0.0,2154.5,-269
25848,2271,1903,1.0,2087.0,368
25849,1692,2174,0.0,1933.0,-482
25850,2085,2169,1.0,2127.0,-84
25851,2065,1968,0.5,2016.5,97
25852,1971,1954,0.0,1962.5,17
25853,1782,1920,0.0,1851.0,-138
25854,1973,2500,0.0,2236.5,-527
25855,2235,2003,1.0,2119.0,232
25856,1950,2257,0.0,2103.5,-307
25857,1933,1947,1.0,1940.0,-14
25858,1938,2386,0.0,2162.0,-448
25859,2170,1947,1.0,2058.5,223
25860,1787,2160,0.5,1973.5,-373
25861,2032,1874,1.0,1953.0,158
25862,2251,2103,1.0,2177.0,148
25863,1975,2043,0.0,2009.0,-68
25864,2221,1904,0.5,2062.5,317
25865,1794,2074,0.0,1934.0,-280
25866,2275,2312,1.0,2293.5,-37
25867,1974,2010,0.0,1992.0,-36
25868,2200,2198,1.0,2199.0,2
25869,2012,1831,0.0,1921.5,181
25870,2170,2240,0.5,2205.0,-70
25871,1859,2177,0.5,2018.0,-318
25872,2180,2218,1.0,2199.0,-38
25873,2294,1800,1.0,2047.0,494
25874,1877,1986,1.0,1931.5,-109
25875,2027,2127,1.0,2077.0,-100
25876,1906,1899,0.0,1902.5,7
25877,2205,1815,1.0,2010.0,390
25878,2033,1981,0.0,2007.0,52
25879,2068,2094,1.0,2081.0,-26
25880,1881,1759,0.5,1820.0,122
25881,2182,1999,0.5,2090.5,183
25882,1981,1859,0.5,1920.0,122
25883,2044,2165,1.0,2104.5,-121
25884,1734,1994,1.0,1864.0,-260
25885,2021,1953,0.0,1987.0,68
25886,2095,2170,0.0,2132.5,-75
25887,1698,2004,0.5,1851.0,-306
25888,1862,2100,0.0,1981.0,-238
25889,2178,1785,1.0,1981.5,393
25890,1920,1899,0.0,1909.5,21
25891,1944,2060,0.0,2002.0,-116
25892,1764,1846,1.0,1805.0,-82
25893,1747,1873,0.0,1810.0,-126
25894,1921,2107,1.0,2014.0,-186
25895,1759,1669,0.5,1714.0,90
25896,1658,1709,0.0,1683.5,-51
25897,2061,2089,1.0,2075.0,-28
25898,1882,1982,1.0,1932.0,-100
25899,2410,1935,1.0,2172.5,475
25900,1734,2109,0.0,1921.5,-375
25901,2125,1731,1.0,1928.0,394
25902,1830,2123,0.0,1976.5,-293
25903,1833,2401,0.0,2117.0,-568
25904,2120,1918,1.0,2019.0,202
25905,1713,2171,0.0,1942.0,-458
25906,2095,1769,0.5,1932.0,326
25907,2122,2394,0.0,2258.0,-272
25908,2077,2074,1.0,2075.5,3
25909,1969,2027,1.0,1998.0,-58
25910,1862,2019,0.5,1940.5,-157
25911,2112,2081,1.0,2096.5,31
25912,1997,2211,0.0,2104.0,-214
25913,1791,1939,0.0,1865.0,-148
25914,1950,1687,1.0,1818.5,263
25915,2017,2008,0.5,2012.5,9
25916,1942,1833,1.0,1887.5,109
25917,1808,2045,0.0,1926.5,-237
25918,1964,2049,0.0,2006.5,-85
25919,2041,1945,0.0,1993.0,96
25920,1916,1895,1.0,1905.5,21
25921,1943,1860,0.0,1901.5,83
25922,1727,2241,0.0,1984.0,-514
25923,2136,1576,1.0,1856.0,560
25924,1534,2109,0.0,1821.5,-575
25925,2145,1538,0.0,1841.5,607
25926,1712,1747,0.0,1729.5,-35
25927,1747,1738,0.0,1742.5,9
25928,1478,1362,0.5,1420.0,116
25929,1832,1698,0.0,1765.0,134
25930,2098,2173,1.0,2135.5,-75
25931,1467,2119,0.0,1793.0,-652
25932,1777,2147,0.0,1962.0,-370
25933,2001,1715,1.0,1858.0,286
25934,1727,1964,1.0,1845.5,-237
25935,1984,1729,1.0,1856.5,255
25936,2112,2226,0.5,2169.0,-114
25937,2222,1941,1.0,2081.5,281
25938,1844,2026,0.5,1935.0,-182
25939,1991,1972,0.5,1981.5,19
25940,2188,1811,1.0,1999.5,377
25941,1501,2076,0.0,1788.5,-575
25942,1922,1461,1.0,1691.5,461
25943,2102,1715,1.0,1908.5,387
25944,1732,1991,0.0,1861.5,-259
25945,1980,2027,0.0,2003.5,-47
25946,1697,1805,1.0,1751.0,-108
25947,1690,1626,0.0,1658.0,64
25948,1552,2422,1.0,1987.0,-870
25949,1594,1511,1.0,1552.5,83
25950,2024,1550,1.0,1787.0,474
25951,1768,1782,1.0,1775.0,-14
25952,1869,1862,1.0,1865.5,7
25953,1599,1657,0.0,1628.0,-58
25954,2207,2262,1.0,2234.5,-55
25955,1994,2076,1.0,2035.0,-82
25956,2118,1849,1.0,1983.5,269
25957,1812,2008,0.5,1910.0,-196
25958,2273,2017,1.0,2145.0,256
25959,1797,1982,0.0,1889.5,-185
25960,1915,1851,1.0,1883.0,64
25961,1481,1839,0.0,1660.0,-358
25962,1781,1890,1.0,1835.5,-109
25963,1763,1693,1.0,1728.0,70
25964,1989,1633,1.0,1811.0,356
25965,1660,1567,0.0,1613.5,93
25966,1487,1678,0.5,1582.5,-191
25967,2029,1421,0.0,1725.0,608
25968,1681,1860,0.0,1770.5,-179
25969,1607,1724,0.5,1665.5,-117
25970,1537,1737,0.5,1637.0,-200
25971,1464,1622,1.0,1543.0,-158
25972,1628,1840,0.0,1734.0,-212
25973,1798,1546,1.0,1672.0,252
25974,1472,1627,0.0,1549.5,-155
25975,1657,1305,1.0,1481.0,352
25976,1778,1844,1.0,1811.0,-66
25977,1680,1526,0.0,1603.0,154
25978,1762,1735,1.0,1748.5,27
25979,1838,1483,1.0,1660.5,355
25980,1454,1627,1.0,1540.5,-173
25981,1364,1579,1.0,1471.5,-215
25982,1723,1519,1.0,1621.0,204
25983,1530,1507,1.0,1518.5,23
25984,1820,1846,1.0,1833.0,-26
25985,1346,1541,1.0,1443.5,-195
25986,1677,1874,1.0,1775.5,-197
25987,1592,1663,0.0,1627.5,-71
25988,1410,1536,0.0,1473.0,-126
25989,1803,1676,0.0,1739.5,127
25990,1864,1540,0.0,1702.0,324
25991,1726,1811,1.0,1768.5,-85
25992,2052,1664,1.0,1858.0,388
25993,1454,1972,0.0,1713.0,-518
25994,1938,1762,1.0,1850.0,176
25995,2656,2586,1.0,2621.0,70
25996,2731,2723,0.5,2727.0,8
25997,2733,2671,0.5,2702.0,62
25998,2740,2724,1.0,2732.0,16
25999,2671,2740,0.5,2705.5,-69
26000,2723,2724,0.0,2723.5,-1
26001,2731,2733,0.5,2732.0,-2
26002,2733,2723,1.0,2728.0,10
26003,2740,2731,0.0,2735.5,9
26004,2724,2671,1.0,2697.5,53
26005,2671,2731,0.5,2701.0,-60
26006,2724,2733,1.0,2728.5,-9
26007,2740,2723,0.0,2731.5,17
26008,2733,2740,0.5,2736.5,-7
26009,2723,2671,0.5,2697.0,52
26010,2731,2724,0.5,2727.5,7
26011,2724,2740,0.0,2732.0,-16
26012,2723,2731,0.5,2727.0,-8
26013,2671,2733,0.0,2702.0,-62
26014,2710,2340,1.0,2525.0,370
26015,2326,2662,0.0,2494.0,-336
26016,2649,2323,1.0,2486.0,326
26017,2320,2639,0.0,2479.5,-319
26018,2631,2317,1.0,2474.0,314
26019,2313,2628,0.0,2470.5,-315
26020,2627,2311,1.0,2469.0,316
26021,2292,2622,0.0,2457.0,-330
26022,2619,2291,1.0,2455.0,328
26023,2280,2610,0.5,2445.0,-330
26024,2607,2247,1.0,2427.0,360
26025,2245,2586,0.0,2415.5,-341
26026,2582,2228,1.0,2405.0,354
26027,2208,2569,0.0,2388.5,-361
26028,2567,2200,1.0,2383.5,367
26029,2192,2567,0.0,2379.5,-375
26030,2562,2192,1.0,2377.0,370
26031,2149,2557,0.0,2353.0,-408
26032,2547,2136,1.0,2341.5,411
26033,2136,2544,0.0,2340.0,-408
26034,2544,2710,0.5,2627.0,-166
26035,2662,2531,0.5,2596.5,131
26036,2520,2649,0.0,2584.5,-129
26037,2639,2513,0.5,2576.0,126
26038,2511,2631,0.5,2571.0,-120
26039,2628,2498,1.0,2563.0,130
26040,2483,2627,0.0,2555.0,-144
26041,2622,2475,1.0,2548.5,147
26042,2467,2619,0.5,2543.0,-152
26043,2416,2607,0.5,2511.5,-191
26044,2586,2448,1.0,2517.0,138
26045,2405,2582,0.5,2493.5,-177
26046,2569,2421,0.5,2495.0,148
26047,2385,2567,0.0,2476.0,-182
26048,2567,2405,1.0,2486.0,162
26049,2361,2562,0.5,2461.5,-201
26050,2557,2397,0.0,2477.0,160
26051,2014,2547,0.0,2280.5,-533
26052,2610,2367,1.0,2488.5,243
26053,2436,2280,1.0,2358.0,156
26054,2649,2586,1.0,2617.5,63
26055,2567,2628,0.0,2597.5,-61
26056,2627,2567,0.5,2597.0,60
26057,2547,2622,0.5,2584.5,-75
26058,2397,2662,0.0,2529.5,-265
26059,2710,2511,0.5,2610.5,199
26060,2531,2639,0.5,2585.0,-108
26061,2631,2544,1.0,2587.5,87
26062,2619,2436,1.0,2527.5,183
26063,2421,2610,0.0,2515.5,-189
26064,2607,2467,1.0,2537.0,140
26065,2582,2416,1.0,2499.0,166
26066,2513,2569,0.5,2541.0,-56
26067,2562,2405,1.0,2483.5,157
26068,2557,2361,1.0,2459.0,196
26069,2317,2520,0.0,2418.5,-203
26070,2498,2311,1.0,2404.5,187
26071,2245,2483,0.5,2364.0,-238
26072,2475,2291,1.0,2383.0,184
26073,2448,2192,1.0,2320.0,256
26074,2628,2649,0.5,2638.5,-21
26075,2662,2607,0.5,2634.5,55
26076,2610,2631,1.0,2620.5,-21
26077,2582,2627,0.0,2604.5,-45
26078,2622,2562,0.0,2592.0,60
26079,2567,2619,0.0,2593.0,-52
26080,2710,2547,1.0,2628.5,163
26081,2639,2498,1.0,2568.5,141
26082,2586,2475,1.0,2530.5,111
26083,2569,2448,0.5,2508.5,121
26084,2397,2567,0.0,2482.0,-170
26085,2385,2557,1.0,2471.0,-172
26086,2004,2531,1.0,2267.5,-527
26087,2520,2367,1.0,2443.5,153
26088,1974,2513,0.5,2243.5,-539
26089,2511,2320,1.0,2415.5,191
26090,2544,2009,1.0,2276.5,535
26091,2483,2361,0.5,2422.0,122
26092,2467,2326,0.5,2396.5,141
26093,2436,2245,0.5,2340.5,191
26094,2649,2619,0.5,2634.0,30
26095,2562,2628,0.5,2595.0,-66
26096,2627,2610,0.5,2618.5,17
26097,2567,2710,0.5,2638.5,-143
26098,2520,2662,0.5,2591.0,-142
26099,2511,2639,0.5,2575.0,-128
26100,2607,2385,0.5,2496.0,222
26101,2004,2586,0.0,2295.0,-582
26102,2631,2405,1.0,2518.0,226
26103,2544,2622,0.0,2583.0,-78
26104,2513,2582,0.5,2547.5,-69
26105,2280,2569,0.0,2424.5,-289
26106,2448,2567,0.5,2507.5,-119
26107,2547,1974,0.5,2260.5,573
26108,2557,2340,1.0,2448.5,217
26109,2531,2326,0.5,2428.5,205
26110,2498,2320,1.0,2409.0,178
26111,2317,2483,0.0,2400.0,-166
26112,2475,2247,0.5,2361.0,228
26113,2245,2467,0.5,2356.0,-222
26114,2610,2649,0.5,2629.5,-39
26115,2628,2627,0.0,2627.5,1
26116,2619,2562,0.5,2590.5,57
26117,2586,2631,0.5,2608.5,-45
26118,2385,2710,0.5,2547.5,-325
26119,2662,2567,0.0,2614.5,95
26120,2639,2520,1.0,2579.5,119
26121,2622,2511,1.0,2566.5,111
26122,2569,2607,1.0,2588.0,-38
26123,2582,2448,1.0,2515.0,134
26124,2567,2397,0.5,2482.0,170
26125,2436,2557,0.5,2496.5,-121
26126,2361,2547,0.5,2454.0,-186
26127,2136,2513,0.5,2324.5,-377
26128,1974,2498,0.0,2236.0,-524
26129,2483,2004,1.0,2243.5,479
26130,2326,2544,0.0,2435.0,-218
26131,2291,2531,0.0,2411.0,-240
26132,2313,2475,0.0,2394.0,-162
26133,2467,2292,1.0,2379.5,175
26134,2155,2369,0.0,2262.0,-214
26135,2602,2619,1.0,2610.5,-17
26136,2630,2414,0.5,2522.0,216
26137,2440,2590,0.0,2515.0,-150
26138,2424,2479,0.0,2451.5,-55
26139,2347,2545,0.5,2446.0,-198
26140,2392,2455,0.5,2423.5,-63
26141,2365,2286,0.5,2325.5,79
26142,2352,2397,0.5,2374.5,-45
26143,2370,2382,0.5,2376.0,-12
26144,2311,2371,0.5,2341.0,-60
26145,2648,2368,1.0,2508.0,280
26146,2416,2425,1.0,2420.5,-9
26147,2590,2432,1.0,2511.0,158
26148,2423,2378,0.5,2400.5,45
26149,2497,2311,0.0,2404.0,186
26150,2333,2379,0.5,2356.0,-46
26151,2523,2216,1.0,2369.5,307
26152,2330,2380,1.0,2355.0,-50
26153,2295,2327,1.0,2311.0,-32
26154,2419,2555,0.5,2487.0,-136
26155,2435,2313,0.5,2374.0,122
26156,2303,2534,0.0,2418.5,-231
26157,2523,2568,0.0,2545.5,-45
26158,2448,2345,0.0,2396.5,103
26159,2340,2198,1.0,2269.0,142
26160,2129,2266,0.0,2197.5,-137
26161,2282,2387,0.5,2334.5,-105
26162,2185,2253,0.5,2219.0,-68
26163,2343,2013,1.0,2178.0,330
26164,2862,2741,1.0,2801.5,121
26165,2772,2813,1.0,2792.5,-41
26166,2423,2539,1.0,2481.0,-116
26167,2800,2767,1.0,2783.5,33
26168,2763,2809,0.0,2786.0,-46
26169,2794,2769,0.5,2781.5,25
26170,2784,2799,1.0,2791.5,-15
26171,2767,2799,1.0,2783.0,-32
26172,2769,2784,0.5,2776.5,-15
26173,2809,2794,0.5,2801.5,15
26174,2800,2763,0.5,2781.5,37
26175,2784,2809,0.5,2796.5,-25
26176,2799,2769,0.5,2784.0,30
26177,2763,2767,0.5,2765.0,-4
26178,2794,2800,0.0,2797.0,-6
26179,1967,2320,0.0,2143.5,-353
26180,2491,2387,0.5,2439.0,104
26181,2428,2448,0.0,2438.0,-20
26182,2586,2396,0.5,2491.0,190
26183,2336,2443,0.0,2389.5,-107
26184,2379,2372,0.5,2375.5,7
26185,2403,2473,0.5,2438.0,-70
26186,2300,2294,1.0,2297.0,6
26187,2224,2279,1.0,2251.5,-55
26188,2177,2399,0.5,2288.0,-222
26189,2279,2325,1.0,2302.0,-46
26190,2489,2468,0.0,2478.5,21
26191,2424,2591,0.5,2507.5,-167
26192,2341,2625,0.0,2483.0,-284
26193,2511,2233,1.0,2372.0,278
26194,2289,2411,1.0,2350.0,-122
26195,2358,2272,0.0,2315.0,86
26196,2248,2399,0.0,2323.5,-151
26197,2312,2206,0.0,2259.0,106
26198,2193,2405,0.0,2299.0,-212
26199,2285,2289,0.5,2287.0,-4
26200,2348,2400,0.5,2374.0,-52
26201,2446,2359,0.5,2402.5,87
26202,2405,2462,0.0,2433.5,-57
26203,2408,2180,1.0,2294.0,228
26204,2366,2408,0.0,2387.0,-42
26205,2402,2380,0.5,2391.0,22
26206,2516,2437,0.5,2476.5,79
26207,2514,2175,1.0,2344.5,339
26208,2526,2446,1.0,2486.0,80
26209,2342,2253,0.5,2297.5,89
26210,2574,2485,0.5,2529.5,89
26211,2422,2489,0.5,2455.5,-67
26212,2294,2140,1.0,2217.0,154
26213,2271,2403,0.0,2337.0,-132
26214,2387,2341,0.0,2364.0,46
26215,2295,2396,1.0,2345.5,-101
26216,2399,2335,0.5,2367.0,64
26217,2339,2428,1.0,2383.5,-89
26218,2336,2147,0.5,2241.5,189
26219,2347,2288,1.0,2317.5,59
26220,2169,2131,0.0,2150.0,38
26221,2794,2799,0.5,2796.5,-5
26222,2763,2769,0.5,2766.0,-6
26223,2800,2809,0.5,2804.5,-9
26224,2767,2784,0.0,2775.5,-17
26225,1741,2205,0.0,1973.0,-464
26226,2592,2628,1.0,2610.0,-36
26227,2577,2534,0.0,2555.5,43
26228,2551,2465,1.0,2508.0,86
26229,2363,2287,0.5,2325.0,76
26230,2234,2401,1.0,2317.5,-167
26231,2406,2331,0.0,2368.5,75
26232,2506,2371,0.0,2438.5,135
26233,2252,2359,0.5,2305.5,-107
26234,2250,2284,1.0,2267.0,-34
26235,2205,2230,0.0,2217.5,-25
26236,1953,2014,0.0,1983.5,-61
26237,2816,2656,1.0,2736.0,160
26238,2656,2814,0.5,2735.0,-158
26239,2808,2657,0.5,2732.5,151
26240,2649,2793,0.5,2721.0,-144
26241,2773,2659,1.0,2716.0,114
26242,2659,2777,0.5,2718.0,-118
26243,2771,2659,0.5,2715.0,112
26244,2660,2782,0.5,2721.0,-122
26245,2625,2717,0.0,2671.0,-92
26246,2636,2748,0.5,2692.0,-112
26247,2762,2662,1.0,2712.0,100
26248,2634,2758,0.5,2696.0,-124
26249,2511,2667,0.0,2589.0,-156
26250,2640,2737,1.0,2688.5,-97
26251,2742,2676,1.0,2709.0,66
26252,2678,2727,0.5,2702.5,-49
26253,2738,2655,0.5,2696.5,83
26254,2702,2705,0.5,2703.5,-3
26255,2736,2671,0.5,2703.5,65
26256,2675,2741,0.5,2708.0,-66
26257,2707,2620,1.0,2663.5,87
26258,2671,2721,0.5,2696.0,-50
26259,2726,2673,0.5,2699.5,53
26260,2628,2734,1.0,2681.0,-106
26261,2728,2634,0.5,2681.0,94
26262,2765,2661,0.5,2713.0,104
26263,2720,2700,0.5,2710.0,20
26264,2697,2725,0.5,2711.0,-28
26265,2744,2679,1.0,2711.5,65
26266,2616,2599,1.0,2607.5,17
26267,2622,2732,0.5,2677.0,-110
26268,2712,2599,0.5,2655.5,113
26269,2656,2814,0.5,2735.0,-158
26270,2793,2649,1.0,2721.0,144
26271,2771,2659,0.5,2715.0,112
26272,2636,2748,0.5,2692.0,-112
26273,2762,2662,0.5,2712.0,100
26274,2634,2758,0.5,2696.0,-124
26275,2742,2676,1.0,2709.0,66
26276,2727,2678,1.0,2702.5,49
26277,2655,2738,0.0,2696.5,-83
26278,2702,2705,0.5,2703.5,-3
26279,2736,2671,1.0,2703.5,65
26280,2671,2721,0.5,2696.0,-50
26281,2734,2628,0.5,2681.0,106
26282,2765,2661,0.0,2713.0,104
26283,2697,2725,0.5,2711.0,-28
26284,2814,2656,1.0,2735.0,158
26285,2649,2793,0.0,2721.0,-144
26286,2659,2771,0.5,2715.0,-112
26287,2748,2636,1.0,2692.0,112
26288,2662,2762,0.5,2712.0,-100
26289,2758,2634,0.5,2696.0,124
26290,2676,2742,1.0,2709.0,-66
26291,2678,2727,0.5,2702.5,-49
26292,2738,2655,1.0,2696.5,83
26293,2705,2702,0.5,2703.5,3
26294,2671,2736,0.5,2703.5,-65
26295,2721,2671,0.5,2696.0,50
26296,2628,2734,0.5,2681.0,-106
26297,2661,2765,1.0,2713.0,-104
26298,2725,2697,0.0,2711.0,28
26299,2659,2771,0.5,2715.0,-112
26300,2762,2662,1.0,2712.0,100
26301,2758,2634,1.0,2696.0,124
26302,2676,2742,0.0,2709.0,-66
26303,2705,2702,0.5,2703.5,3
26304,2671,2721,0.5,2696.0,-50
26305,2734,2628,0.0,2681.0,106
26306,2771,2659,1.0,2715.0,112
26307,2662,2762,0.0,2712.0,-100
26308,2634,2758,0.5,2696.0,-124
26309,2742,2676,0.0,2709.0,66
26310,2702,2705,0.5,2703.5,-3
26311,2721,2671,1.0,2696.0,50
26312,2628,2734,0.0,2681.0,-106
26313,2742,2676,0.5,2709.0,66
26314,2705,2702,0.5,2703.5,3
26315,2628,2734,0.0,2681.0,-106
26316,2676,2742,0.5,2709.0,-66
26317,2702,2705,0.0,2703.5,-3
26318,2734,2628,0.5,2681.0,106
26319,2742,2676,1.0,2709.0,66
26320,2816,2599,0.5,2707.5,217
26321,2705,2814,0.5,2759.5,-109
26322,2808,2616,1.0,2712.0,192
26323,2707,2793,0.5,2750.0,-86
26324,2773,2697,0.5,2735.0,76
26325,2720,2777,0.5,2748.5,-57
26326,2771,2717,0.0,2744.0,54
26327,2634,2782,0.5,2708.0,-148
26328,2661,2734,0.5,2697.5,-73
26329,2726,2748,0.5,2737.0,-22
26330,2762,2721,1.0,2741.5,41
26331,2744,2758,0.5,2751.0,-14
26332,2667,2741,0.5,2704.0,-74
26333,2736,2640,1.0,2688.0,96
26334,2742,2732,0.5,2737.0,10
26335,2738,2727,0.5,2732.5,11
26336,2599,2816,0.5,2707.5,-217
26337,2814,2705,0.5,2759.5,109
26338,2616,2808,0.5,2712.0,-192
26339,2793,2707,1.0,2750.0,86
26340,2697,2773,0.5,2735.0,-76
26341,2777,2720,0.5,2748.5,57
26342,2717,2771,1.0,2744.0,-54
26343,2782,2634,1.0,2708.0,148
26344,2734,2661,1.0,2697.5,73
26345,2748,2726,1.0,2737.0,22
26346,2721,2762,0.5,2741.5,-41
26347,2758,2744,0.5,2751.0,14
26348,2741,2667,1.0,2704.0,74
26349,2640,2736,0.5,2688.0,-96
26350,2732,2742,0.5,2737.0,-10
26351,2727,2738,0.5,2732.5,-11
26352,2816,2599,1.0,2707.5,217
26353,2814,2705,0.5,2759.5,109
26354,2773,2697,0.5,2735.0,76
26355,2777,2720,0.5,2748.5,57
26356,2758,2744,0.5,2751.0,14
26357,2732,2742,0.5,2737.0,-10
26358,2738,2727,0.5,2732.5,11
26359,2599,2816,0.5,2707.5,-217
26360,2705,2814,0.5,2759.5,-109
26361,2697,2773,0.0,2735.0,-76
26362,2720,2777,1.0,2748.5,-57
26363,2744,2758,0.5,2751.0,-14
26364,2742,2732,0.5,2737.0,10
26365,2727,2738,1.0,2732.5,-11
26366,2814,2705,1.0,2759.5,109
26367,2744,2758,1.0,2751.0,-14
26368,2742,2732,0.5,2737.0,10
26369,2705,2814,1.0,2759.5,-109
26370,2758,2744,0.0,2751.0,14
26371,2732,2742,0.5,2737.0,-10
26372,2705,2814,1.0,2759.5,-109
26373,2742,2732,1.0,2737.0,10
26374,2814,2705,1.0,2759.5,109
26375,2732,2742,0.0,2737.0,-10
26376,2705,2814,0.0,2759.5,-109
26377,2727,2816,1.0,2771.5,-89
26378,2814,2742,1.0,2778.0,72
26379,2736,2808,1.0,2772.0,-72
26380,2793,2741,0.5,2767.0,52
26381,2744,2773,0.5,2758.5,-29
26382,2720,2762,0.5,2741.0,-42
26383,2748,2717,0.5,2732.5,31
26384,2782,2734,1.0,2758.0,48
26385,2816,2727,0.5,2771.5,89
26386,2742,2814,0.5,2778.0,-72
26387,2808,2736,0.5,2772.0,72
26388,2741,2793,0.5,2767.0,-52
26389,2773,2744,0.0,2758.5,29
26390,2762,2720,0.5,2741.0,42
26391,2717,2748,0.5,2732.5,-31
26392,2734,2782,1.0,2758.0,-48
26393,2297,2333,0.5,2315.0,-36
26394,2496,2600,0.5,2548.0,-104
26395,2552,2484,1.0,2518.0,68
26396,2485,2368,0.5,2426.5,117
26397,2538,2391,1.0,2464.5,147
26398,2381,2362,0.5,2371.5,19
26399,2213,2374,0.0,2293.5,-161
26400,2319,2195,1.0,2257.0,124
26401,2374,2311,1.0,2342.5,63
26402,2315,1873,1.0,2094.0,442
26403,2393,2247,1.0,2320.0,146
26404,2338,1892,0.5,2115.0,446
26405,2548,2626,0.5,2587.0,-78
26406,2499,2010,1.0,2254.5,489
26407,2571,2367,1.0,2469.0,204
26408,2381,2325,1.0,2353.0,56
26409,2296,2417,0.5,2356.5,-121
26410,2309,2417,0.5,2363.0,-108
26411,2242,2381,1.0,2311.5,-139
26412,2202,2320,0.0,2261.0,-118
26413,2444,2404,0.5,2424.0,40
26414,2459,2578,0.5,2518.5,-119
26415,2511,2344,1.0,2427.5,167
26416,2428,2435,0.5,2431.5,-7
26417,2467,2373,1.0,2420.0,94
26418,2290,2266,0.5,2278.0,24
26419,2347,2159,0.0,2253.0,188
26420,2179,2202,1.0,2190.5,-23
26421,2200,2202,1.0,2201.0,-2
26422,2179,2219,0.0,2199.0,-40
26423,2480,2534,0.0,2507.0,-54
26424,2551,2352,1.0,2451.5,199
26425,2346,2506,0.5,2426.0,-160
26426,2502,2405,1.0,2453.5,97
26427,2386,2234,1.0,2310.0,152
26428,2283,2297,1.0,2290.0,-14
26429,2409,2018,1.0,2213.5,391
26430,2331,2447,0.5,2389.0,-116
26431,2264,2184,0.5,2224.0,80
26432,2359,2454,1.0,2406.5,-95
26433,2577,2402,1.0,2489.5,175
26434,2383,2363,1.0,2373.0,20
26435,2401,2493,0.5,2447.0,-92
26436,2384,2205,1.0,2294.5,179
26437,2465,2404,0.0,2434.5,61
26438,2368,2371,1.0,2369.5,-3
26439,2406,2364,1.0,2385.0,42
26440,2394,2006,1.0,2200.0,388
26441,2284,2324,1.0,2304.0,-40
26442,2286,2102,0.5,2194.0,184
26443,2199,2218,0.5,2208.5,-19
26444,2715,2562,1.0,2638.5,153
26445,2737,2496,0.5,2616.5,241
26446,2737,2675,0.0,2706.0,62
26447,2666,2493,0.5,2579.5,173
26448,2699,2678,1.0,2688.5,21
26449,2562,2699,0.5,2630.5,-137
26450,2496,2715,0.5,2605.5,-219
26451,2675,2737,0.5,2706.0,-62
26452,2493,2737,0.5,2615.0,-244
26453,2678,2666,0.5,2672.0,12
26454,2737,2493,1.0,2615.0,244
26455,2737,2678,1.0,2707.5,59
26456,2699,2666,0.5,2682.5,33
26457,2715,2675,1.0,2695.0,40
26458,2562,2496,0.0,2529.0,66
26459,2496,2699,0.5,2597.5,-203
26460,2675,2562,1.0,2618.5,113
26461,2493,2715,0.0,2604.0,-222
26462,2678,2737,0.5,2707.5,-59
26463,2666,2737,1.0,2701.5,-71
26464,2699,2737,1.0,2718.0,-38
26465,2737,2666,1.0,2701.5,71
26466,2715,2678,0.5,2696.5,37
26467,2562,2493,1.0,2527.5,69
26468,2496,2675,0.5,2585.5,-179
26469,2675,2699,1.0,2687.0,-24
26470,2493,2496,0.0,2494.5,-3
26471,2678,2562,1.0,2620.0,116
26472,2666,2715,1.0,2690.5,-49
26473,2737,2737,0.5,2737.0,0
26474,2671,2286,1.0,2478.5,385
26475,2277,2659,0.0,2468.0,-382
26476,2658,2272,1.0,2465.0,386
26477,2270,2638,0.0,2454.0,-368
26478,2628,2255,1.0,2441.5,373
26479,2248,2623,0.0,2435.5,-375
26480,2621,2221,1.0,2421.0,400
26481,2211,2611,0.0,2411.0,-400
26482,2609,2211,0.5,2410.0,398
26483,2207,2608,0.0,2407.5,-401
26484,2606,2206,1.0,2406.0,400
26485,2203,2600,0.5,2401.5,-397
26486,2600,2191,1.0,2395.5,409
26487,2191,2592,0.0,2391.5,-401
26488,2580,2158,1.0,2369.0,422
26489,2156,2579,0.0,2367.5,-423
26490,2570,2150,1.0,2360.0,420
26491,2147,2568,0.0,2357.5,-421
26492,2558,2140,1.0,2349.0,418
26493,2124,2558,0.0,2341.0,-434
26494,2659,2491,1.0,2575.0,168
26495,2473,2658,0.0,2565.5,-185
26496,2638,2471,1.0,2554.5,167
26497,2466,2628,0.0,2547.0,-162
26498,2623,2463,1.0,2543.0,160
26499,2463,2621,1.0,2542.0,-158
26500,2611,2444,1.0,2527.5,167
26501,2608,2437,1.0,2522.5,171
26502,2440,2606,0.5,2523.0,-166
26503,2422,2600,0.5,2511.0,-178
26504,2416,2593,0.5,2504.5,-177
26505,2592,2415,0.5,2503.5,177
26506,2411,2580,0.5,2495.5,-169
26507,2579,2407,1.0,2493.0,172
26508,2401,2570,0.0,2485.5,-169
26509,2568,2400,0.5,2484.0,168
26510,2380,2558,0.0,2469.0,-178
26511,2558,2358,1.0,2458.0,200
26512,2370,2546,0.0,2458.0,-176
26513,2570,2659,0.0,2614.5,-89
26514,2658,2558,1.0,2608.0,100
26515,2558,2638,0.0,2598.0,-80
26516,2628,2515,0.5,2571.5,113
26517,2546,2623,0.5,2584.5,-77
26518,2538,2611,0.0,2574.5,-73
26519,2502,2608,0.5,2555.0,-106
26520,2463,2579,0.5,2521.0,-116
26521,2671,2495,1.0,2583.0,176
26522,2606,2425,0.5,2515.5,181
26523,2440,2600,0.5,2520.0,-160
26524,2600,2416,1.0,2508.0,184
26525,2593,2422,1.0,2507.5,171
26526,2411,2592,0.0,2501.5,-181
26527,2580,2397,0.5,2488.5,183
26528,2415,2568,0.5,2491.5,-153
26529,2546,2354,1.0,2450.0,192
26530,2508,2211,0.5,2359.5,297
26531,2400,2497,0.0,2448.5,-97
26532,2621,2286,1.0,2453.5,335
26533,2659,2638,1.0,2648.5,21
26534,2611,2658,1.0,2634.5,-47
26535,2579,2671,0.5,2625.0,-92
26536,2546,2628,0.5,2587.0,-82
26537,2623,2546,0.0,2584.5,77
26538,2608,2497,0.5,2552.5,111
26539,2515,2600,0.5,2557.5,-85
26540,2593,2502,0.5,2547.5,91
26541,2592,2463,0.0,2527.5,129
26542,2621,2440,0.5,2530.5,181
26543,2437,2606,0.5,2521.5,-169
26544,2600,2415,1.0,2507.5,185
26545,2425,2580,0.0,2502.5,-155
26546,2397,2570,0.5,2483.5,-173
26547,2568,2407,1.0,2487.5,161
26548,2401,2558,0.5,2479.5,-157
26549,2558,2348,0.5,2453.0,210
26550,2370,2538,0.0,2454.0,-168
26551,2354,2508,0.5,2431.0,-154
26552,2337,2471,0.0,2404.0,-134
26553,2611,2659,1.0,2635.0,-48
26554,2546,2463,1.0,2504.5,83
26555,2671,2580,1.0,2625.5,91
26556,2658,2579,0.5,2618.5,79
26557,2638,2515,0.5,2576.5,123
26558,2628,2568,0.5,2598.0,60
26559,2538,2608,0.0,2573.0,-70
26560,2502,2600,0.5,2551.0,-98
26561,2600,2546,1.0,2573.0,54
26562,2497,2593,0.0,2545.0,-96
26563,2471,2623,1.0,2547.0,-152
26564,2411,2621,0.5,2516.0,-210
26565,2609,2437,1.0,2523.0,172
26566,2606,2416,0.5,2511.0,190
26567,2440,2592,1.0,2516.0,-152
26568,2570,2380,0.0,2475.0,190
26569,2558,2397,1.0,2477.5,161
26570,2400,2558,0.5,2479.0,-158
26571,2508,2401,0.5,2454.5,107
26572,2319,2495,1.0,2407.0,-176
26573,2546,2611,1.0,2578.5,-65
26574,2600,2671,1.0,2635.5,-71
26575,2659,2593,0.5,2626.0,66
26576,2608,2471,1.0,2539.5,137
26577,2515,2658,0.5,2586.5,-143
26578,2638,2502,0.5,2570.0,136
26579,2463,2628,0.5,2545.5,-165
26580,2463,2609,1.0,2536.0,-146
26581,2600,2444,1.0,2522.0,156
26582,2579,2440,0.5,2509.5,139
26583,2568,2380,1.0,2474.0,188
26584,2319,2558,0.0,2438.5,-239
26585,2466,2621,1.0,2543.5,-155
26586,2422,2606,0.0,2514.0,-184
26587,2580,2415,1.0,2497.5,165
26588,2558,2411,1.0,2484.5,147
26589,2416,2546,1.0,2481.0,-130
26590,2407,2538,0.0,2472.5,-131
26591,2020,2508,0.0,2264.0,-488
26592,2354,2497,0.5,2425.5,-143
26593,2608,2546,0.5,2577.0,62
26594,2611,2600,0.5,2605.5,11
26595,2568,2659,1.0,2613.5,-91
26596,2558,2600,0.0,2579.0,-42
26597,2593,2463,1.0,2528.0,130
26598,2671,2515,0.5,2593.0,156
26599,2658,2466,1.0,2562.0,192
26600,2508,2638,0.5,2573.0,-130
26601,2628,2416,1.0,2522.0,212
26602,2606,2463,1.0,2534.5,143
26603,2502,2580,0.0,2541.0,-78
26604,2471,2579,0.5,2525.0,-108
26605,2440,2558,0.0,2499.0,-118
26606,2538,2401,0.5,2469.5,137
26607,2400,2609,0.5,2504.5,-209
26608,2437,2623,0.5,2530.0,-186
26609,2570,2354,0.5,2462.0,216
26610,2497,2354,0.0,2425.5,143
26611,2348,2495,0.0,2421.5,-147
26612,2444,2319,0.5,2381.5,125
26613,2134,1921,1.0,2027.5,213
26614,2796,2720,1.0,2758.0,76
26615,2711,2785,0.5,2748.0,-74
26616,2785,2709,0.5,2747.0,76
26617,2709,2766,0.5,2737.5,-57
26618,2760,2692,0.0,2726.0,68
26619,2671,2759,0.5,2715.0,-88
26620,2751,2656,1.0,2703.5,95
26621,2651,2749,0.5,2700.0,-98
26622,2742,2628,0.5,2685.0,114
26623,2692,2796,0.0,2744.0,-104
26624,2785,2751,0.5,2768.0,34
26625,2628,2785,0.5,2706.5,-157
26626,2766,2711,1.0,2738.5,55
26627,2759,2709,0.5,2734.0,50
26628,2749,2671,0.5,2710.0,78
26629,2709,2742,0.5,2725.5,-33
26630,2720,2651,0.5,2685.5,69
26631,2656,2760,0.0,2708.0,-104
26632,2796,2766,0.5,2781.0,30
26633,2751,2759,0.5,2755.0,-8
26634,2742,2785,0.5,2763.5,-43
26635,2785,2692,1.0,2738.5,93
26636,2760,2628,0.5,2694.0,132
26637,2709,2749,0.5,2729.0,-40
26638,2651,2709,0.5,2680.0,-58
26639,2671,2720,0.5,2695.5,-49
26640,2711,2656,0.5,2683.5,55
26641,2599,2357,1.0,2478.0,242
26642,2547,2093,1.0,2320.0,454
26643,2084,2461,0.0,2272.5,-377
26644,2461,2077,0.0,2269.0,384
26645,2070,2458,0.0,2264.0,-388
26646,2440,2066,0.5,2253.0,374
26647,2059,2427,0.5,2243.0,-368
26648,2407,2056,1.0,2231.5,351
26649,2046,2371,0.5,2208.5,-325
26650,2346,2041,1.0,2193.5,305
26651,2038,2308,0.0,2173.0,-270
26652,2285,2033,0.0,2159.0,252
26653,2023,2273,0.0,2148.0,-250
26654,2271,2011,1.0,2141.0,260
26655,1999,2267,0.0,2133.0,-268
26656,2246,1998,0.5,2122.0,248
26657,1994,2238,0.5,2116.0,-244
26658,2227,1988,0.5,2107.5,239
26659,1976,2213,1.0,2094.5,-237
26660,2197,1973,0.5,2085.0,224
26661,1970,2156,1.0,2063.0,-186
26662,2267,2547,0.0,2407.0,-280
26663,2461,2271,0.5,2366.0,190
26664,2458,2136,1.0,2297.0,322
26665,2125,2407,0.0,2266.0,-282
26666,2077,2346,0.0,2211.5,-269
26667,2308,1976,0.0,2142.0,332
26668,2273,1970,1.0,2121.5,303
26669,2033,2440,0.5,2236.5,-407
26670,2427,2046,1.0,2236.5,381
26671,2371,1994,1.0,2182.5,377
26672,2066,2246,1.0,2156.0,-180
26673,2238,2059,1.0,2148.5,179
26674,1998,2227,1.0,2112.5,-229
26675,1988,2197,0.5,2092.5,-209
26676,1973,2461,0.0,2217.0,-488
26677,2041,2285,0.0,2163.0,-244
26678,2213,2038,1.0,2125.5,175
26679,2156,2023,0.5,2089.5,133
26680,2093,1999,0.0,2046.0,94
26681,2011,2084,1.0,2047.5,-73
26682,2547,2346,0.0,2446.5,201
26683,1976,2458,0.0,2217.0,-482
26684,2407,2273,0.0,2340.0,134
26685,2238,2461,0.0,2349.5,-223
26686,2066,2427,0.0,2246.5,-361
26687,2033,2371,0.0,2202.0,-338
26688,2271,1998,1.0,2134.5,273
26689,2461,2125,1.0,2293.0,336
26690,2440,2077,1.0,2258.5,363
26691,2136,2308,0.0,2222.0,-172
26692,2285,1988,0.5,2136.5,297
26693,2070,2267,0.0,2168.5,-197
26694,1970,2213,0.0,2091.5,-243
26695,2197,2011,1.0,2104.0,186
26696,1920,2246,0.0,2083.0,-326
26697,2227,2046,0.0,2136.5,181
26698,1994,2156,0.0,2075.0,-162
26699,2059,1973,1.0,2016.0,86
26700,2023,2093,0.0,2058.0,-70
26701,2084,2041,1.0,2062.5,43
26702,2346,2458,0.5,2402.0,-112
26703,2273,2461,0.0,2367.0,-188
26704,2427,2271,1.0,2349.0,156
26705,2371,2547,1.0,2459.0,-176
26706,2267,2461,0.0,2364.0,-194
26707,2213,2440,0.0,2326.5,-227
26708,1976,2407,1.0,2191.5,-431
26709,2308,2197,0.5,2252.5,111
26710,2046,2285,0.0,2165.5,-239
26711,2246,2059,0.5,2152.5,187
26712,1998,2238,0.5,2118.0,-240
26713,2156,2033,1.0,2094.5,123
26714,1988,2066,0.5,2027.0,-78
26715,2011,2136,0.5,2073.5,-125
26716,2125,2070,0.0,2097.5,55
26717,2093,1962,0.0,2027.5,131
26718,1999,2084,0.5,2041.5,-85
26719,2077,1920,1.0,1998.5,157
26720,2227,1970,1.0,2098.5,257
26721,2056,2023,0.0,2039.5,33
26722,2461,2427,0.5,2444.0,34
26723,2458,2371,0.5,2414.5,87
26724,2461,2346,0.0,2403.5,115
26725,2440,2273,1.0,2356.5,167
26726,2285,1976,0.5,2130.5,309
26727,2271,2308,0.0,2289.5,-37
26728,2197,2156,1.0,2176.5,41
26729,2547,2077,1.0,2312.0,470
26730,2407,1998,1.0,2202.5,409
26731,2066,2267,0.5,2166.5,-201
26732,2070,2246,1.0,2158.0,-176
26733,2238,1988,0.5,2113.0,250
26734,1962,2213,0.0,2087.5,-251
26735,2059,2136,1.0,2097.5,-77
26736,2023,2227,0.0,2125.0,-204
26737,2084,2046,1.0,2065.0,38
26738,2033,2011,1.0,2022.0,22
26739,2038,2125,0.0,2081.5,-87
26740,1970,2093,1.0,2031.5,-123
26741,1920,2041,1.0,1980.5,-121
26742,2241,2343,0.5,2292.0,-102
26743,2754,2734,0.5,2744.0,20
26744,2672,2759,0.0,2715.5,-87
26745,2706,2812,0.5,2759.0,-106
26746,2782,2777,1.0,2779.5,5
26747,2691,2719,0.0,2705.0,-28
26748,2789,2718,1.0,2753.5,71
26749,2777,2691,0.0,2734.0,86
26750,2734,2718,1.0,2726.0,16
26751,2719,2789,0.5,2754.0,-70
26752,2812,2782,1.0,2797.0,30
26753,2759,2706,0.5,2732.5,53
26754,2754,2672,0.5,2713.0,82
26755,2718,2719,0.5,2718.5,-1
26756,2706,2754,1.0,2730.0,-48
26757,2782,2759,1.0,2770.5,23
26758,2691,2812,0.5,2751.5,-121
26759,2789,2777,0.5,2783.0,12
26760,2672,2734,0.5,2703.0,-62
26761,2566,2607,0.5,2586.5,-41
26762,2710,2553,0.5,2631.5,157
26763,2430,2457,0.0,2443.5,-27
26764,2711,2593,0.0,2652.0,118
26765,2431,2567,0.0,2499.0,-136
26766,2637,2560,0.5,2598.5,77
26767,2677,2602,0.0,2639.5,75
26768,2607,2637,0.5,2622.0,-30
26769,2560,2677,1.0,2618.5,-117
26770,2593,2566,0.5,2579.5,27
26771,2431,2710,0.0,2570.5,-279
26772,2553,2430,1.0,2491.5,123
26773,2567,2602,0.5,2584.5,-35
26774,2457,2711,0.5,2584.0,-254
26775,2677,2607,1.0,2642.0,70
26776,2430,2431,1.0,2430.5,-1
26777,2711,2553,0.5,2632.0,158
26778,2602,2560,0.0,2581.0,42
26779,2637,2593,1.0,2615.0,44
26780,2566,2457,1.0,2511.5,109
26781,2710,2567,1.0,2638.5,143
26782,2457,2414,1.0,2435.5,43
26783,2816,2241,1.0,2528.5,575
26784,2252,2814,0.0,2533.0,-562
26785,2808,2330,1.0,2569.0,478
26786,2357,2793,0.5,2575.0,-436
26787,2773,2447,1.0,2610.0,326
26788,2419,2777,0.0,2598.0,-358
26789,2771,2428,0.5,2599.5,343
26790,2440,2782,0.0,2611.0,-342
26791,2765,2453,1.0,2609.0,312
26792,2491,2748,0.5,2619.5,-257
26793,2762,2495,1.0,2628.5,267
26794,2500,2758,0.5,2629.0,-258
26795,2741,2511,0.5,2626.0,230
26796,2517,2737,0.0,2627.0,-220
26797,2742,2528,0.5,2635.0,214
26798,2531,2727,0.0,2629.0,-196
26799,2738,2556,0.5,2647.0,182
26800,2563,2732,1.0,2647.5,-169
26801,2736,2569,1.0,2652.5,167
26802,2557,2741,0.5,2649.0,-184
26803,2744,2577,1.0,2660.5,167
26804,2583,2721,0.0,2652.0,-138
26805,2726,2596,1.0,2661.0,130
26806,2610,2734,0.0,2672.0,-124
26807,2728,2597,0.5,2662.5,131
26808,2606,2717,0.0,2661.5,-111
26809,2720,2606,1.0,2663.0,114
26810,2601,2725,0.5,2663.0,-124
26811,2707,2603,1.0,2655.0,104
26812,2599,2704,1.0,2651.5,-105
26813,2702,2597,0.5,2649.5,105
26814,2599,2692,1.0,2645.5,-93
26815,2712,2614,1.0,2663.0,98
26816,2621,2705,0.5,2663.0,-84
26817,2704,2616,0.5,2660.0,88
26818,2620,2699,1.0,2659.5,-79
26819,2697,2618,0.5,2657.5,79
26820,2631,2700,0.0,2665.5,-69
26821,2681,2625,0.5,2653.0,56
26822,2634,2689,1.0,2661.5,-55
26823,2680,2628,0.0,2654.0,52
26824,2633,2673,0.5,2653.0,-40
26825,2671,2626,0.5,2648.5,45
26826,2623,2679,0.5,2651.0,-56
26827,2675,2652,1.0,2663.5,23
26828,2632,2671,0.5,2651.5,-39
26829,2691,2622,0.0,2656.5,69
26830,2630,2655,0.0,2642.5,-25
26831,2678,2628,1.0,2653.0,50
26832,2635,2676,0.5,2655.5,-41
26833,2664,2640,0.0,2652.0,24
26834,2624,2667,0.5,2645.5,-43
26835,2634,2637,1.0,2635.5,-3
26836,2639,2662,0.5,2650.5,-23
26837,2678,2636,0.0,2657.0,42
26838,2651,2661,0.0,2656.0,-10
26839,2660,2643,0.5,2651.5,17
26840,2674,2659,0.5,2666.5,15
26841,2659,2651,0.5,2655.0,8
26842,2657,2659,0.5,2658.0,-2
26843,2649,2649,0.5,2649.0,0
26844,2657,2658,1.0,2657.5,-1
26845,2656,2661,1.0,2658.5,-5
26846,2656,2657,0.5,2656.5,-1
26847,2241,2816,0.0,2528.5,-575
26848,2814,2252,1.0,2533.0,562
26849,2330,2808,0.0,2569.0,-478
26850,2793,2357,1.0,2575.0,436
26851,2447,2773,0.0,2610.0,-326
26852,2777,2419,1.0,2598.0,358
26853,2428,2771,0.5,2599.5,-343
26854,2782,2440,0.5,2611.0,342
26855,2453,2765,0.0,2609.0,-312
26856,2748,2491,0.5,2619.5,257
26857,2495,2762,0.0,2628.5,-267
26858,2758,2500,0.5,2629.0,258
26859,2511,2741,0.5,2626.0,-230
26860,2737,2517,0.5,2627.0,220
26861,2528,2742,0.0,2635.0,-214
26862,2727,2531,0.5,2629.0,196
26863,2556,2738,0.5,2647.0,-182
26864,2732,2563,1.0,2647.5,169
26865,2569,2736,0.5,2652.5,-167
26866,2741,2557,1.0,2649.0,184
26867,2577,2744,0.5,2660.5,-167
26868,2721,2583,1.0,2652.0,138
26869,2596,2726,0.5,2661.0,-130
26870,2734,2610,0.5,2672.0,124
26871,2597,2728,0.5,2662.5,-131
26872,2717,2606,1.0,2661.5,111
26873,2606,2720,0.5,2663.0,-114
26874,2725,2601,0.5,2663.0,124
26875,2603,2707,0.5,2655.0,-104
26876,2704,2599,0.5,2651.5,105
26877,2597,2702,0.5,2649.5,-105
26878,2692,2599,1.0,2645.5,93
26879,2614,2712,1.0,2663.0,-98
26880,2705,2621,0.5,2663.0,84
26881,2616,2704,0.5,2660.0,-88
26882,2699,2620,0.5,2659.5,79
26883,2618,2697,0.0,2657.5,-79
26884,2700,2631,0.5,2665.5,69
26885,2625,2681,1.0,2653.0,-56
26886,2689,2634,1.0,2661.5,55
26887,2628,2680,0.5,2654.0,-52
26888,2673,2633,1.0,2653.0,40
26889,2626,2671,0.5,2648.5,-45
26890,2679,2623,0.5,2651.0,56
26891,2652,2675,0.5,2663.5,-23
26892,2671,2632,0.5,2651.5,39
26893,2622,2691,0.5,2656.5,-69
26894,2655,2630,0.5,2642.5,25
26895,2628,2678,0.5,2653.0,-50
26896,2676,2635,1.0,2655.5,41
26897,2640,2664,1.0,2652.0,-24
26898,2667,2624,1.0,2645.5,43
26899,2637,2634,0.5,2635.5,3
26900,2662,2639,0.5,2650.5,23
26901,2636,2678,1.0,2657.0,-42
26902,2661,2651,0.5,2656.0,10
26903,2643,2660,0.5,2651.5,-17
26904,2659,2674,0.5,2666.5,-15
26905,2651,2659,0.5,2655.0,-8
26906,2659,2657,0.5,2658.0,2
26907,2649,2649,0.5,2649.0,0
26908,2658,2657,0.5,2657.5,1
26909,2661,2656,0.5,2658.5,5
26910,2657,2656,0.5,2656.5,1
26911,2771,2428,0.5,2599.5,343
26912,2748,2491,1.0,2619.5,257
26913,2500,2758,0.0,2629.0,-258
26914,2511,2741,0.5,2626.0,-230
26915,2738,2556,1.0,2647.0,182
26916,2563,2732,0.5,2647.5,-169
26917,2597,2728,0.0,2662.5,-131
26918,2702,2597,1.0,2649.5,105
26919,2692,2599,0.0,2645.5,93
26920,2712,2614,0.5,2663.0,98
26921,2621,2705,0.0,2663.0,-84
26922,2704,2616,0.5,2660.0,88
26923,2689,2634,0.0,2661.5,55
26924,2626,2671,0.5,2648.5,-45
26925,2659,2651,1.0,2655.0,8
26926,2671,2632,1.0,2651.5,39
26927,2725,2601,1.0,2663.0,124
26928,2662,2639,1.0,2650.5,23
26929,2643,2660,0.0,2651.5,-17
26930,2659,2674,1.0,2666.5,-15
26931,2623,2679,0.5,2651.0,-56
26932,2657,2659,0.5,2658.0,-2
26933,2649,2649,0.5,2649.0,0
26934,2656,2657,1.0,2656.5,-1
26935,2428,2771,0.5,2599.5,-343
26936,2491,2748,1.0,2619.5,-257
26937,2758,2500,1.0,2629.0,258
26938,2741,2511,0.0,2626.0,230
26939,2556,2738,0.0,2647.0,-182
26940,2732,2563,1.0,2647.5,169
26941,2728,2597,1.0,2662.5,131
26942,2597,2702,0.0,2649.5,-105
26943,2599,2692,0.5,2645.5,-93
26944,2614,2712,0.0,2663.0,-98
26945,2705,2621,1.0,2663.0,84
26946,2616,2704,0.5,2660.0,-88
26947,2634,2689,1.0,2661.5,-55
26948,2671,2626,0.5,2648.5,45
26949,2651,2659,0.0,2655.0,-8
26950,2632,2671,0.5,2651.5,-39
26951,2601,2725,0.0,2663.0,-124
26952,2639,2662,0.5,2650.5,-23
26953,2660,2643,1.0,2651.5,17
26954,2674,2659,0.5,2666.5,15
26955,2679,2623,0.5,2651.0,56
26956,2659,2657,0.5,2658.0,2
26957,2649,2649,0.5,2649.0,0
26958,2657,2656,0.0,2656.5,1
26959,2428,2771,0.5,2599.5,-343
26960,2491,2748,0.5,2619.5,-257
26961,2704,2616,0.5,2660.0,88
26962,2671,2626,1.0,2648.5,45
26963,2679,2623,1.0,2651.0,56
26964,2659,2657,1.0,2658.0,2
26965,2649,2649,0.5,2649.0,0
26966,2771,2428,0.5,2599.5,343
26967,2748,2491,0.5,2619.5,257
26968,2616,2704,0.5,2660.0,-88
26969,2626,2671,0.0,2648.5,-45
26970,2623,2679,1.0,2651.0,-56
26971,2657,2659,0.5,2658.0,-2
26972,2649,2649,0.5,2649.0,0
26973,2771,2428,1.0,2599.5,343
26974,2748,2491,1.0,2619.5,257
26975,2704,2616,0.5,2660.0,88
26976,2623,2679,0.5,2651.0,-56
26977,2649,2649,0.5,2649.0,0
26978,2428,2771,0.0,2599.5,-343
26979,2491,2748,0.0,2619.5,-257
26980,2616,2704,1.0,2660.0,-88
26981,2679,2623,0.5,2651.0,56
26982,2649,2649,1.0,2649.0,0
26983,2623,2679,0.5,2651.0,-56
26984,2656,2816,0.5,2736.0,-160
26985,2814,2656,0.5,2735.0,158
26986,2657,2808,0.0,2732.5,-151
26987,2793,2649,0.5,2721.0,144
26988,2659,2773,0.0,2716.0,-114
26989,2777,2659,1.0,2718.0,118
26990,2659,2771,0.5,2715.0,-112
26991,2782,2660,1.0,2721.0,122
26992,2717,2625,1.0,2671.0,92
26993,2748,2636,0.5,2692.0,112
26994,2662,2762,1.0,2712.0,-100
26995,2758,2634,0.5,2696.0,124
26996,2667,2511,1.0,2589.0,156
26997,2737,2640,0.5,2688.5,97
26998,2676,2742,1.0,2709.0,-66
26999,2727,2678,0.5,2702.5,49
27000,2655,2738,0.5,2696.5,-83
27001,2705,2702,0.5,2703.5,3
27002,2671,2736,0.5,2703.5,-65
27003,2741,2675,1.0,2708.0,66
27004,2620,2707,0.5,2663.5,-87
27005,2721,2671,0.5,2696.0,50
27006,2673,2726,0.0,2699.5,-53
27007,2734,2628,1.0,2681.0,106
27008,2634,2728,1.0,2681.0,-94
27009,2661,2765,0.5,2713.0,-104
27010,2700,2720,0.0,2710.0,-20
27011,2725,2697,0.5,2711.0,28
27012,2679,2744,0.5,2711.5,-65
27013,2599,2616,0.5,2607.5,-17
27014,2732,2622,1.0,2677.0,110
27015,2599,2712,1.0,2655.5,-113
27016,2310,2356,0.5,2333.0,-46
27017,2816,2814,1.0,2815.0,2
27018,2731,2765,0.5,2748.0,-34
27019,2793,2779,0.5,2786.0,14
27020,2808,2853,0.0,2830.5,-45
27021,2771,2816,1.0,2793.5,-45
27022,2816,2816,0.5,2816.0,0
27023,2765,2793,0.5,2779.0,-28
27024,2853,2731,1.0,2792.0,122
27025,2779,2771,1.0,2775.0,8
27026,2814,2808,0.5,2811.0,6
27027,2771,2816,0.5,2793.5,-45
27028,2793,2853,0.5,2823.0,-60
27029,2779,2765,0.0,2772.0,14
27030,2731,2814,0.5,2772.5,-83
27031,2808,2816,0.5,2812.0,-8
27032,2816,2808,0.0,2812.0,8
27033,2765,2771,0.5,2768.0,-6
27034,2814,2793,0.5,2803.5,21
27035,2853,2779,1.0,2816.0,74
27036,2816,2731,0.5,2773.5,85
27037,2765,2853,0.5,2809.0,-88
27038,2731,2816,1.0,2773.5,-85
27039,2793,2816,0.5,2804.5,-23
27040,2779,2814,0.0,2796.5,-35
27041,2771,2808,1.0,2789.5,-37
27042,2814,2765,0.0,2789.5,49
27043,2853,2771,0.0,2812.0,82
27044,2816,2793,0.5,2804.5,23
27045,2808,2731,0.5,2769.5,77
27046,2816,2779,0.5,2797.5,37
27047,1399,1621,0.0,1510.0,-222
27048,2425,1801,1.0,2113.0,624
27049,1736,2458,0.0,2097.0,-722
27050,2416,1860,1.0,2138.0,556
27051,2088,2318,0.0,2203.0,-230
27052,2006,2439,0.0,2222.5,-433
27053,2410,1881,1.0,2145.5,529
27054,1846,2403,0.0,2124.5,-557
27055,2316,1927,1.0,2121.5,389
27056,1894,2505,0.0,2199.5,-611
27057,2408,1703,1.0,2055.5,705
27058,1766,2382,0.5,2074.0,-616
27059,2301,1781,1.0,2041.0,520
27060,2505,1895,1.0,2200.0,610
27061,1826,2307,0.0,2066.5,-481
27062,2306,1614,1.0,1960.0,692
27063,1699,2116,0.0,1907.5,-417
27064,1731,2418,0.0,2074.5,-687
27065,2356,1691,1.0,2023.5,665
27066,1681,2268,0.0,1974.5,-587
27067,2186,1678,0.5,1932.0,508
27068,2315,2080,1.0,2197.5,235
27069,1573,2296,0.0,1934.5,-723
27070,2161,1556,1.0,1858.5,605
27071,1516,2183,0.0,1849.5,-667
27072,2290,1675,1.0,1982.5,615
27073,1607,2217,0.0,1912.0,-610
27074,2117,1536,1.0,1826.5,581
27075,1515,1853,1.0,1684.0,-338
27076,1651,2406,0.5,2028.5,-755
27077,2436,1641,1.0,2038.5,795
27078,1634,2053,0.0,1843.5,-419
27079,1584,2384,0.0,1984.0,-800
27080,2340,1753,1.0,2046.5,587
27081,1564,2315,0.0,1939.5,-751
27082,1980,1578,1.0,1779.0,402
27083,2389,1452,1.0,1920.5,937
27084,1499,2200,0.0,1849.5,-701
27085,2090,1122,1.0,1606.0,968
27086,1458,2175,0.0,1816.5,-717
27087,2205,1392,1.0,1798.5,813
27088,1222,2066,0.0,1644.0,-844
27089,2230,1625,1.0,1927.5,605
27090,2031,2194,1.0,2112.5,-163
27091,2144,1699,0.0,1921.5,445
27092,2059,2178,1.0,2118.5,-119
27093,1574,1754,0.5,1664.0,-180
27094,1975,2282,0.0,2128.5,-307
27095,1870,1888,1.0,1879.0,-18
27096,2018,1983,0.5,2000.5,35
27097,1542,1931,1.0,1736.5,-389
27098,2064,1968,0.0,2016.0,96
27099,1909,1823,0.0,1866.0,86
27100,1969,2197,1.0,2083.0,-228
27101,1707,1779,1.0,1743.0,-72
27102,2406,2425,0.5,2415.5,-19
27103,2458,2436,1.0,2447.0,22
27104,2053,2416,0.0,2234.5,-363
27105,2318,1941,1.0,2129.5,377
27106,2439,2338,0.0,2388.5,101
27107,2290,2410,0.0,2350.0,-120
27108,2352,2217,1.0,2284.5,135
27109,2117,2316,0.5,2216.5,-199
27110,2505,2389,1.0,2447.0,116
27111,2200,2408,0.0,2304.0,-208
27112,2382,2090,1.0,2236.0,292
27113,2087,2301,1.0,2194.0,-214
27114,2175,2505,0.0,2340.0,-330
27115,2307,2263,1.0,2285.0,44
27116,2205,2306,0.0,2255.5,-101
27117,2260,2066,1.0,2163.0,194
27118,2418,2230,0.5,2324.0,188
27119,2194,2356,0.5,2275.0,-162
27120,2268,2031,1.0,2149.5,237
27121,1924,2186,0.5,2055.0,-262
27122,2197,2367,1.0,2282.0,-170
27123,2315,1969,1.0,2142.0,346
27124,1779,2161,1.0,1970.0,-382
27125,2183,1730,1.0,1956.5,453
27126,2384,2144,1.0,2264.0,240
27127,1934,2340,1.0,2137.0,-406
27128,2315,2178,0.0,2246.5,137
27129,2059,1980,1.0,2019.5,79
27130,2282,2064,0.0,2173.0,218
27131,1968,1975,1.0,1971.5,-7
27132,1888,1909,0.5,1898.5,-21
27133,1823,1870,1.0,1846.5,-47
27134,1983,2018,1.0,2000.5,-35
27135,1686,1982,1.0,1834.0,-296
27136,1675,1542,0.0,1608.5,133
27137,1881,2006,1.0,1943.5,-125
27138,1536,1607,0.0,1571.5,-71
27139,1793,1846,1.0,1819.5,-53
27140,1801,1515,1.0,1658.0,286
27141,1641,1651,0.5,1646.0,-10
27142,1860,1736,0.0,1798.0,124
27143,1323,1634,0.0,1478.5,-311
27144,1452,2088,0.0,1770.0,-636
27145,1703,1894,1.0,1798.5,-191
27146,1122,1499,0.0,1310.5,-377
27147,1895,1781,1.0,1838.0,114
27148,1392,1458,0.0,1425.0,-66
27149,1614,1826,1.0,1720.0,-212
27150,1625,1699,0.0,1662.0,-74
27151,1681,1691,1.0,1686.0,-10
27152,1253,1678,1.0,1465.5,-425
27153,2080,1573,1.0,1826.5,507
27154,1556,1516,0.5,1536.0,40
27155,1753,1584,0.5,1668.5,169
27156,1574,1564,0.5,1569.0,10
27157,2425,2418,0.5,2421.5,7
27158,2356,2458,0.0,2407.0,-102
27159,2416,2268,1.0,2342.0,148
27160,2238,2318,0.0,2278.0,-80
27161,2505,2439,1.0,2472.0,66
27162,2410,2307,0.0,2358.5,103
27163,2306,2403,0.0,2354.5,-97
27164,2352,2260,1.0,2306.0,92
27165,2064,2505,0.5,2284.5,-441
27166,2408,1968,1.0,2188.0,440
27167,1909,2382,0.5,2145.5,-473
27168,2301,1823,1.0,2062.0,478
27169,1934,2367,1.0,2150.5,-433
27170,2315,2178,1.0,2246.5,137
27171,2059,2296,1.0,2177.5,-237
27172,2183,1754,1.0,1968.5,429
27173,2018,2197,0.5,2107.5,-179
27174,1969,1982,1.0,1975.5,-13
27175,1931,1779,0.0,1855.0,152
27176,1707,1686,1.0,1696.5,21
27177,2340,2384,1.0,2362.0,-44
27178,1980,2315,1.0,2147.5,-335
27179,2338,1468,0.5,1903.0,870
27180,1881,2006,1.0,1943.5,-125
27181,2217,2290,1.0,2253.5,-73
27182,1927,1846,0.0,1886.5,81
27183,1894,1853,0.0,1873.5,41
27184,2436,2406,1.0,2421.0,30
27185,1766,1703,0.5,1734.5,63
27186,1941,2053,0.5,1997.0,-112
27187,2389,1781,1.0,2085.0,608
27188,1736,1801,0.0,1768.5,-65
27189,2090,2200,1.0,2145.0,-110
27190,2088,1860,0.5,1974.0,228
27191,1731,1814,0.0,1772.5,-83
27192,2205,2263,1.0,2234.0,-58
27193,1678,1691,0.0,1684.5,-13
27194,1919,2066,1.0,1992.5,-147
27195,2230,1253,0.0,1741.5,977
27196,1826,1895,0.5,1860.5,-69
27197,1924,2194,1.0,2059.0,-270
27198,1699,1614,1.0,1656.5,85
27199,1975,2282,1.0,2128.5,-307
27200,1870,1888,1.0,1879.0,-18
27201,1584,1753,0.0,1668.5,-169
27202,1564,1578,0.0,1571.0,-14
27203,2080,1573,0.0,1826.5,507
27204,1556,1516,0.5,1536.0,40
27205,1458,1675,0.0,1566.5,-217
27206,1607,1392,0.5,1499.5,215
27207,1222,1536,0.0,1379.0,-314
27208,1651,1452,1.0,1551.5,199
27209,1499,1641,0.0,1570.0,-142
27210,1634,1122,1.0,1378.0,512
27211,2505,2425,1.0,2465.0,80
27212,2458,2408,1.0,2433.0,50
27213,2382,2416,0.5,2399.0,-34
27214,2318,2301,0.0,2309.5,17
27215,2439,2144,1.0,2291.5,295
27216,1934,2403,0.0,2168.5,-469
27217,2352,2178,0.5,2265.0,174
27218,2059,2316,0.5,2187.5,-257
27219,2197,2505,0.0,2351.0,-308
27220,2307,1969,1.0,2138.0,338
27221,1779,2306,0.0,2042.5,-527
27222,2116,1730,1.0,1923.0,386
27223,2418,2406,0.0,2412.0,12
27224,2436,2356,0.5,2396.0,80
27225,2268,2053,1.0,2160.5,215
27226,1941,2238,1.0,2089.5,-297
27227,2367,2389,0.5,2378.0,-22
27228,2200,2315,0.0,2257.5,-115
27229,2296,2090,1.0,2193.0,206
27230,2087,2161,0.0,2124.0,-74
27231,2175,2338,0.5,2256.5,-163
27232,2290,2263,1.0,2276.5,27
27233,2205,2217,1.0,2211.0,-12
27234,2117,2066,0.5,2091.5,51
27235,2384,2064,0.0,2224.0,320
27236,1968,2340,1.0,2154.0,-372
27237,2315,1909,0.5,2112.0,406
27238,1605,1980,0.0,1792.5,-375
27239,1895,1983,1.0,1939.0,-88
27240,1982,1826,0.0,1904.0,156
27241,1614,1931,0.5,1772.5,-317
27242,1686,1699,0.0,1692.5,-13
27243,2282,1584,1.0,1933.0,698
27244,1753,1975,0.5,1864.0,-222
27245,1888,1564,0.0,1726.0,324
27246,1578,1870,0.0,1724.0,-292
27247,1731,2230,0.0,1980.5,-499
27248,2194,1691,1.0,1942.5,503
27249,1681,2031,0.0,1856.0,-350
27250,1924,1253,1.0,1588.5,671
27251,2006,2080,0.0,2043.0,-74
27252,1573,1881,0.0,1727.0,-308
27253,1927,1556,1.0,1741.5,371
27254,1516,1793,0.5,1654.5,-277
27255,1801,1736,0.0,1768.5,65
27256,1860,2088,0.0,1974.0,-228
27257,1675,1894,1.0,1784.5,-219
27258,1766,1607,1.0,1686.5,159
27259,1536,1781,0.5,1658.5,-245
27260,1765,1515,0.5,1640.0,250
27261,1641,1651,0.5,1646.0,-10
27262,1452,1625,0.0,1538.5,-173
27263,1122,1499,0.0,1310.5,-377
27264,2505,2505,0.5,2505.0,0
27265,2408,2307,1.0,2357.5,101
27266,2306,2382,0.5,2344.0,-76
27267,2301,2116,0.0,2208.5,185
27268,2425,2410,0.0,2417.5,15
27269,2403,2458,0.0,2430.5,-55
27270,2416,2352,1.0,2384.0,64
27271,2316,2318,0.5,2317.0,-2
27272,2064,2367,1.0,2215.5,-303
27273,2315,1968,0.0,2141.5,347
27274,1909,2296,0.0,2102.5,-387
27275,2161,1823,1.0,1992.0,338
27276,2406,1895,1.0,2150.5,511
27277,1826,2436,0.0,2131.0,-610
27278,2053,1614,1.0,1833.5,439
27279,1699,1941,0.0,1820.0,-242
27280,2338,2282,1.0,2310.0,56
27281,1975,2290,1.0,2132.5,-315
27282,2117,1888,0.5,2002.5,229
27283,1870,1853,0.5,1861.5,17
27284,2263,2175,1.0,2219.0,88
27285,1574,2205,0.0,1889.5,-631
27286,2144,2197,0.5,2170.5,-53
27287,1969,1934,1.0,1951.5,35
27288,2178,1779,1.0,1978.5,399
27289,1707,1754,0.5,1730.5,-47
27290,1801,2418,0.0,2109.5,-617
27291,2356,1736,1.0,2046.0,620
27292,1860,2268,0.0,2064.0,-408
27293,2186,2088,0.5,2137.0,98
27294,2230,2384,0.0,2307.0,-154
27295,2340,2194,0.5,2267.0,146
27296,2031,2315,0.0,2173.0,-284
27297,1980,1924,1.0,1952.0,56
27298,2389,2006,1.0,2197.5,383
27299,1881,2200,0.0,2040.5,-319
27300,2090,1846,1.0,1968.0,244
27301,1927,2087,0.0,2007.0,-160
27302,2018,1983,0.0,2000.5,35
27303,1468,1686,0.5,1577.0,-218
27304,1894,1703,0.0,1798.5,191
27305,1781,1765,0.0,1773.0,16
27306,1584,1753,0.0,1668.5,-169
27307,1542,1578,1.0,1560.0,-36
27308,1607,1675,0.5,1641.0,-68
27309,1691,1731,1.0,1711.0,-40
27310,1253,1678,1.0,1465.5,-425
27311,1651,2080,0.0,1865.5,-429
27312,1573,1641,1.0,1607.0,-68
27313,1634,1556,1.0,1595.0,78
27314,1516,1323,0.5,1419.5,193
27315,1625,1458,0.5,1541.5,167
27316,2505,2406,1.0,2455.5,99
27317,2436,2408,1.0,2422.0,28
27318,2382,2053,1.0,2217.5,329
27319,1941,2301,1.0,2121.0,-360
27320,2505,2425,0.0,2465.0,80
27321,2458,2307,1.0,2382.5,151
27322,2306,2416,0.0,2361.0,-110
27323,2318,2116,1.0,2217.0,202
27324,2439,2064,1.0,2251.5,375
27325,1968,2410,0.0,2189.0,-442
27326,2352,1909,1.0,2130.5,443
27327,1823,2316,0.5,2069.5,-493
27328,2367,2175,0.5,2271.0,192
27329,2263,2315,0.0,2289.0,-52
27330,2296,2205,0.0,2250.5,91
27331,2066,2183,0.5,2124.5,-117
27332,2418,2144,0.0,2281.0,274
27333,1934,2356,0.0,2145.0,-422
27334,2268,2178,0.5,2223.0,90
27335,2059,2186,1.0,2122.5,-127
27336,2197,2338,0.0,2267.5,-141
27337,2217,1969,0.0,2093.0,248
27338,1779,2117,0.0,1948.0,-338
27339,1853,1730,0.5,1791.5,123
27340,2384,2282,1.0,2333.0,102
27341,1975,2340,0.0,2157.5,-365
27342,2315,1888,0.5,2101.5,427
27343,1870,1980,0.0,1925.0,-110
27344,1895,2389,0.0,2142.0,-494
27345,2200,1826,1.0,2013.0,374
27346,1614,2090,0.0,1852.0,-476
27347,2087,1699,0.5,1893.0,388
27348,1584,2018,0.0,1801.0,-434
27349,1983,1753,1.0,1868.0,230
27350,1564,1982,1.0,1773.0,-418
27351,1931,1578,1.0,1754.5,353
27352,1766,1703,0.5,1734.5,63
27353,1765,1781,1.0,1773.0,-16
27354,2194,2031,0.0,2112.5,163
27355,1574,1699,1.0,1636.5,-125
27356,2006,1731,1.0,1868.5,275
27357,1681,1846,1.0,1763.5,-165
27358,1927,1678,1.0,1802.5,249
27359,1253,1793,0.0,1523.0,-540
27360,2080,1801,1.0,1940.5,279
27361,1736,1573,1.0,1654.5,163
27362,1556,1860,0.0,1708.0,-304
27363,2088,1516,1.0,1802.0,572
27364,1675,1536,0.5,1605.5,139
27365,1542,1392,1.0,1467.0,150
27366,1222,1651,1.0,1436.5,-429
27367,1634,1323,0.0,1478.5,311
27368,1625,1452,1.0,1538.5,173
27369,1499,1122,1.0,1310.5,377
27370,2439,2505,0.5,2472.0,-66
27371,2408,2410,1.0,2409.0,-2
27372,2403,2382,1.0,2392.5,21
27373,2301,2352,0.5,2326.5,-51
27374,2425,2367,0.5,2396.0,58
27375,2315,2458,0.5,2386.5,-143
27376,2416,2296,0.5,2356.0,120
27377,2161,2318,0.0,2239.5,-157
27378,2406,2338,0.0,2372.0,68
27379,2290,2436,0.0,2363.0,-146
27380,2053,2217,0.5,2135.0,-164
27381,2117,1941,1.0,2029.0,176
27382,2144,2505,0.5,2324.5,-361
27383,2307,1934,1.0,2120.5,373
27384,2178,2306,0.0,2242.0,-128
27385,2260,2059,1.0,2159.5,201
27386,2389,2384,0.0,2386.5,5
27387,2340,2200,0.5,2270.0,140
27388,2090,2315,1.0,2202.5,-225
27389,1980,2087,0.0,2033.5,-107
27390,2175,2064,1.0,2119.5,111
27391,1968,2263,1.0,2115.5,-295
27392,2205,1909,0.5,2057.0,296
27393,1823,1919,0.0,1871.0,-96
27394,2018,1894,0.0,1956.0,124
27395,1703,1983,1.0,1843.0,-280
27396,1931,1766,0.0,1848.5,165
27397,1781,1686,0.0,1733.5,95
27398,2197,2418,0.5,2307.5,-221
27399,2356,1969,1.0,2162.5,387
27400,1779,2268,0.0,2023.5,-489
27401,2238,1730,0.0,1984.0,508
27402,1801,2230,0.0,2015.5,-429
27403,2194,1736,1.0,1965.0,458
27404,1860,1924,0.0,1892.0,-64
27405,1699,2088,0.0,1893.5,-389
27406,2282,2006,1.0,2144.0,276
27407,1881,1975,1.0,1928.0,-94
27408,1888,1927,0.5,1907.5,-39
27409,1793,1870,0.0,1831.5,-77
27410,1895,1584,1.0,1739.5,311
27411,1753,1826,0.0,1789.5,-73
27412,1614,1564,0.5,1589.0,50
27413,1578,1699,0.0,1638.5,-121
27414,1731,1691,0.0,1711.0,40
27415,1681,1678,0.0,1679.5,3
27416,1641,1607,0.0,1624.0,34
27417,1536,1634,0.0,1585.0,-98
27418,1323,1515,0.5,1419.0,-192
27419,1458,1625,0.5,1541.5,-167
27420,1452,1222,0.0,1337.0,230
27421,1122,1499,0.0,1310.5,-377
27422,2338,2425,0.5,2381.5,-87
27423,2458,2290,1.0,2374.0,168
27424,2217,2416,0.0,2316.5,-199
27425,2318,2117,1.0,2217.5,201
27426,2505,2175,1.0,2340.0,330
27427,2263,2408,1.0,2335.5,-145
27428,2382,2205,0.5,2293.5,177
27429,2066,2301,0.5,2183.5,-235
27430,2389,2439,0.5,2414.0,-50
27431,2410,2200,0.5,2305.0,210
27432,2090,2403,0.0,2246.5,-313
27433,2352,2087,1.0,2219.5,265
27434,1894,2307,0.0,2100.5,-413
27435,2306,1703,0.5,2004.5,603
27436,1766,2260,0.0,2013.0,-494
27437,2116,1765,1.0,1940.5,351
27438,2384,2406,0.0,2395.0,-22
27439,2436,2340,0.0,2388.0,96
27440,2315,2053,1.0,2184.0,262
27441,1941,1980,0.0,1960.5,-39
27442,2418,1895,1.0,2156.5,523
27443,1826,2356,0.0,2091.0,-530
27444,2268,1614,1.0,1941.0,654
27445,1699,2186,0.0,1942.5,-487
27446,2367,2230,0.0,2298.5,137
27447,2194,2315,0.5,2254.5,-121
27448,2296,2031,1.0,2163.5,265
27449,1924,2183,0.5,2053.5,-259
27450,2282,2144,0.5,2213.0,138
27451,1934,1975,1.0,1954.5,-41
27452,1888,2059,1.0,1973.5,-171
27453,1754,1870,0.0,1812.0,-116
27454,2064,1968,0.0,2016.0,96
27455,1909,1574,1.0,1741.5,335
27456,1881,1605,1.0,1743.0,276
27457,1982,1983,1.0,1982.5,-1
27458,1927,1846,1.0,1886.5,81
27459,1686,1931,0.5,1808.5,-245
27460,1731,1793,0.5,1762.0,-62
27461,1779,1969,0.5,1874.0,-190
27462,1681,1691,1.0,1686.0,-10
27463,1730,1707,1.0,1718.5,23
27464,1736,1801,0.0,1768.5,-65
27465,2088,1860,1.0,1974.0,228
27466,1634,1651,1.0,1642.5,-17
27467,1573,2080,1.0,1826.5,-507
27468,1516,1556,0.5,1536.0,-40
27469,1392,1458,0.0,1425.0,-66
27470,1625,1222,0.0,1423.5,403
27471,1753,1584,1.0,1668.5,169
27472,1578,1564,1.0,1571.0,14
27473,1499,1452,0.0,1475.5,47
27474,2175,1122,0.5,1648.5,1053
27475,2458,2425,1.0,2441.5,33
27476,2205,2263,0.5,2234.0,-58
27477,2318,2416,1.0,2367.0,-98
27478,2439,2066,1.0,2252.5,373
27479,2356,2418,0.0,2387.0,-62
27480,2403,2410,0.0,2406.5,-7
27481,2238,2268,0.0,2253.0,-30
27482,2505,2352,1.0,2428.5,153
27483,1975,2282,0.5,2128.5,-307
27484,2382,2408,1.0,2395.0,-26
27485,1870,1888,0.0,1879.0,-18
27486,2505,2301,1.0,2403.0,204
27487,2200,2389,0.5,2294.5,-189
27488,2306,2307,1.0,2306.5,-1
27489,2087,2090,0.0,2088.5,-3
27490,2338,2260,0.0,2299.0,78
27491,2340,2384,1.0,2362.0,-44
27492,2217,2290,0.5,2253.5,-73
27493,1980,2315,1.0,2147.5,-335
27494,2406,2117,1.0,2261.5,289
27495,2315,2367,0.5,2341.0,-52
27496,2053,2436,0.0,2244.5,-383
27497,2183,2296,0.5,2239.5,-113
27498,2230,1941,1.0,2085.5,289
27499,1968,2064,1.0,2016.0,-96
27500,1924,2031,1.0,1977.5,-107
27501,1605,1909,0.5,1757.0,-304
27502,2144,1699,1.0,1921.5,445
27503,1766,1703,0.0,1734.5,63
27504,2178,1934,1.0,2056.0,244
27505,1765,1781,0.0,1773.0,-16
27506,1895,2059,1.0,1977.0,-164
27507,1614,1826,1.0,1720.0,-212
27508,2197,1699,1.0,1948.0,498
27509,1881,2006,1.0,1943.5,-125
27510,1779,1969,0.5,1874.0,-190
27511,1793,1927,0.0,1860.0,-134
27512,2018,1730,1.0,1874.0,288
27513,1931,1982,1.0,1956.5,-51
27514,1651,1686,1.0,1668.5,-35
27515,1691,1731,0.0,1711.0,-40
27516,1634,1641,0.0,1637.5,-7
27517,1253,1681,1.0,1467.0,-428
27518,1584,2080,0.0,1832.0,-496
27519,1573,1753,0.0,1663.0,-180
27520,1564,1556,1.0,1560.0,8
27521,1516,1578,0.0,1547.0,-62
27522,1801,1736,0.0,1768.5,65
27523,1860,2088,0.0,1974.0,-228
27524,1675,1625,1.0,1650.0,50
27525,1515,1536,1.0,1525.5,-21
27526,1458,1452,1.0,1455.0,6
27527,1499,1392,0.0,1445.5,107
27528,1222,1122,1.0,1172.0,100
27529,2105,2182,0.5,2143.5,-77
27530,2677,2363,1.0,2520.0,314
27531,2170,2555,0.0,2362.5,-385
27532,2534,2642,0.5,2588.0,-108
27533,2223,2523,0.0,2373.0,-300
27534,2492,2020,1.0,2256.0,472
27535,2204,2340,0.5,2272.0,-136
27536,2345,2314,0.5,2329.5,31
27537,2214,2282,0.0,2248.0,-68
27538,2266,2257,0.0,2261.5,9
27539,2244,2253,0.0,2248.5,-9
27540,2311,1995,1.0,2153.0,316
27541,2313,2330,1.0,2321.5,-17
27542,2432,2151,1.0,2291.5,281
27543,2419,2416,1.0,2417.5,3
27544,2368,2387,1.0,2377.5,-19
27545,2147,2423,0.0,2285.0,-276
27546,2303,2295,1.0,2299.0,8
27547,2139,2129,1.0,2134.0,10
27548,2198,2333,1.0,2265.5,-135
27549,2619,2497,0.5,2558.0,122
27550,2648,2790,0.5,2719.0,-142
27551,2576,2493,1.0,2534.5,83
27552,2425,2590,0.0,2507.5,-165
27553,2545,2378,0.5,2461.5,167
27554,2379,2352,1.0,2365.5,27
27555,2392,2349,1.0,2370.5,43
27556,2327,2382,0.5,2354.5,-55
27557,2424,2324,0.0,2374.0,100
27558,2380,2286,0.5,2333.0,94
27559,2305,2440,0.5,2372.5,-135
27560,2414,2337,1.0,2375.5,77
27561,2201,2455,0.0,2328.0,-254
27562,2479,2209,1.0,2344.0,270
27563,2379,2371,0.0,2375.0,8
27564,2397,2206,1.0,2301.5,191
27565,2107,2365,0.0,2236.0,-258
27566,2370,2216,0.0,2293.0,154
27567,2082,2347,0.5,2214.5,-265
27568,1803,1947,1.0,1875.0,-144
27569,2592,2518,0.5,2555.0,74
27570,2566,2411,0.5,2488.5,155
27571,2440,2521,0.5,2480.5,-81
27572,2352,2259,1.0,2305.5,93
27573,2215,2503,0.0,2359.0,-288
27574,2617,2170,1.0,2393.5,447
27575,2361,2261,0.5,2311.0,100
27576,2384,2318,1.0,2351.0,66
27577,2334,2365,1.0,2349.5,-31
27578,2316,2382,0.0,2349.0,-66
27579,2616,2317,1.0,2466.5,299
27580,2436,2377,1.0,2406.5,59
27581,2378,2400,0.0,2389.0,-22
27582,2441,2586,0.5,2513.5,-145
27583,2490,2370,1.0,2430.0,120
27584,2425,2509,0.5,2467.0,-84
27585,2319,2204,1.0,2261.5,115
27586,2302,2292,0.0,2297.0,10
27587,2386,2111,0.0,2248.5,275
27588,2315,2415,0.5,2365.0,-100
27589,2425,2449,0.5,2437.0,-24
27590,2780,2822,0.5,2801.0,-42
27591,2842,2777,1.0,2809.5,65
27592,2767,2766,1.0,2766.5,1
27593,2768,2801,0.5,2784.5,-33
27594,2773,2779,0.5,2776.0,-6
27595,2224,2117,1.0,2170.5,107
27596,2764,2810,0.0,2787.0,-46
27597,2872,2740,1.0,2806.0,132
27598,2809,2757,1.0,2783.0,52
27599,2793,2747,0.5,2770.0,46
27600,2747,2809,1.0,2778.0,-62
27601,2757,2740,0.5,2748.5,17
27602,2764,2872,0.5,2818.0,-108
27603,2810,2793,1.0,2801.5,17
27604,2740,2747,0.5,2743.5,-7
27605,2809,2810,0.0,2809.5,-1
27606,2793,2764,0.5,2778.5,29
27607,2872,2757,0.0,2814.5,115
27608,2793,2872,0.0,2832.5,-79
27609,2764,2809,0.5,2786.5,-45
27610,2810,2740,0.5,2775.0,70
27611,2747,2757,1.0,2752.0,-10
27612,2809,2793,1.0,2801.0,16
27613,2872,2747,0.0,2809.5,125
27614,2757,2810,1.0,2783.5,-53
27615,2740,2764,0.5,2752.0,-24
27616,2226,2109,0.5,2167.5,117
27617,2727,2862,0.0,2794.5,-135
27618,2666,2667,0.5,2666.5,-1
27619,2744,2715,0.5,2729.5,29
27620,2784,2732,1.0,2758.0,52
27621,2862,2734,1.0,2798.0,128
27622,2762,2757,0.5,2759.5,5
27623,2820,2673,0.5,2746.5,147
27624,2797,2727,1.0,2762.0,70
27625,2715,2862,0.5,2788.5,-147
27626,2732,2762,0.5,2747.0,-30
27627,2757,2744,0.5,2750.5,13
27628,2666,2784,0.0,2725.0,-118
27629,2727,2820,0.0,2773.5,-93
27630,2734,2797,0.5,2765.5,-63
27631,2667,2673,1.0,2670.0,-6
27632,2673,2727,1.0,2700.0,-54
27633,2797,2715,0.5,2756.0,82
27634,2762,2666,1.0,2714.0,96
27635,2862,2757,0.5,2809.5,105
27636,2744,2732,0.0,2738.0,12
27637,2784,2667,1.0,2725.5,117
27638,2820,2734,0.5,2777.0,86
27639,2666,2744,1.0,2705.0,-78
27640,2734,2673,0.5,2703.5,61
27641,2757,2797,0.5,2777.0,-40
27642,2732,2862,0.5,2797.0,-130
27643,2784,2762,1.0,2773.0,22
27644,2715,2820,0.5,2767.5,-105
27645,2667,2727,0.5,2697.0,-60
27646,2673,2715,0.5,2694.0,-42
27647,2820,2757,0.0,2788.5,63
27648,2762,2667,1.0,2714.5,95
27649,2862,2666,0.5,2764.0,196
27650,2744,2784,0.5,2764.0,-40
27651,2797,2732,0.0,2764.5,65
27652,2727,2734,1.0,2730.5,-7
27653,2517,2613,0.5,2565.0,-96
27654,2615,2675,0.5,2645.0,-60
27655,2538,2652,0.5,2595.0,-114
27656,2563,2593,0.5,2578.0,-30
27657,2511,2352,1.0,2431.5,159
27658,2603,2729,0.0,2666.0,-126
27659,2608,2291,0.5,2449.5,317
27660,2652,2511,0.5,2581.5,141
27661,2291,2538,0.5,2414.5,-247
27662,2729,2608,0.5,2668.5,121
27663,2675,2613,1.0,2644.0,62
27664,2615,2563,1.0,2589.0,52
27665,2352,2517,0.5,2434.5,-165
27666,2593,2603,0.0,2598.0,-10
27667,2603,2615,1.0,2609.0,-12
27668,2613,2352,0.5,2482.5,261
27669,2563,2675,0.0,2619.0,-112
27670,2538,2729,0.5,2633.5,-191
27671,2517,2652,0.0,2584.5,-135
27672,2608,2593,1.0,2600.5,15
27673,2511,2291,0.5,2401.0,220
27674,2291,2517,0.5,2404.0,-226
27675,2593,2538,0.0,2565.5,55
27676,2652,2613,1.0,2632.5,39
27677,2675,2352,1.0,2513.5,323
27678,2729,2511,0.5,2620.0,218
27679,2563,2603,0.0,2583.0,-40
27680,2615,2608,1.0,2611.5,7
27681,2511,2593,1.0,2552.0,-82
27682,2613,2291,1.0,2452.0,322
27683,2538,2615,0.0,2576.5,-77
27684,2517,2729,0.0,2623.0,-212
27685,2603,2675,0.5,2639.0,-72
27686,2352,2652,0.0,2502.0,-300
27687,2608,2563,0.5,2585.5,45
27688,2185,2260,0.5,2222.5,-75
27689,2429,2565,0.5,2497.0,-136
27690,2502,2606,0.0,2554.0,-104
27691,2357,2453,0.5,2405.0,-96
27692,2398,1847,1.0,2122.5,551
27693,2533,2444,0.5,2488.5,89
27694,2415,2118,1.0,2266.5,297
27695,2318,2343,0.5,2330.5,-25
27696,2317,2054,1.0,2185.5,263
27697,2234,2297,1.0,2265.5,-63
27698,1728,2318,0.0,2023.0,-590
27699,2808,2840,0.5,2824.0,-32
27700,2785,2773,0.5,2779.0,12
27701,2766,2780,0.5,2773.0,-14
27702,2653,2695,0.5,2674.0,-42
27703,2755,2702,1.0,2728.5,53
27704,2750,2767,0.5,2758.5,-17
27705,2736,2706,0.5,2721.0,30
27706,2840,2750,1.0,2795.0,90
27707,2773,2808,0.5,2790.5,-35
27708,2702,2785,0.5,2743.5,-83
27709,2767,2736,0.5,2751.5,31
27710,2695,2755,0.0,2725.0,-60
27711,2780,2706,0.5,2743.0,74
27712,2766,2653,1.0,2709.5,113
27713,2736,2840,0.5,2788.0,-104
27714,2750,2773,0.5,2761.5,-23
27715,2706,2767,1.0,2736.5,-61
27716,2653,2780,0.5,2716.5,-127
27717,2755,2766,0.5,2760.5,-11
27718,2808,2702,1.0,2755.0,106
27719,2785,2695,1.0,2740.0,90
27720,2665,2642,0.5,2653.5,23
27721,2370,2612,0.5,2491.0,-242
27722,2667,2499,0.5,2583.0,168
27723,2584,2603,0.5,2593.5,-19
27724,2608,2467,1.0,2537.5,141
27725,2697,2667,1.0,2682.0,30
27726,2612,2605,1.0,2608.5,7
27727,2467,2697,0.0,2582.0,-230
27728,2642,2605,0.5,2623.5,37
27729,2603,2608,0.5,2605.5,-5
27730,2667,2612,1.0,2639.5,55
27731,2499,2584,0.5,2541.5,-85
27732,2612,2667,0.0,2639.5,-55
27733,2665,2370,1.0,2517.5,295
27734,2605,2667,0.5,2636.0,-62
27735,2608,2499,0.0,2553.5,109
27736,2612,2467,0.0,2539.5,145
27737,2667,2665,1.0,2666.0,2
27738,2697,2603,1.0,2650.0,94
27739,2370,2642,0.0,2506.0,-272
27740,2584,2612,0.0,2598.0,-28
27741,2312,2156,0.0,2234.0,156
27742,2801,2772,1.0,2786.5,29
27743,2877,2768,0.5,2822.5,109
27744,2787,2805,0.5,2796.0,-18
27745,2768,2801,0.0,2784.5,-33
27746,2877,2787,1.0,2832.0,90
27747,2772,2805,0.5,2788.5,-33
27748,2801,2877,0.5,2839.0,-76
27749,2805,2768,0.5,2786.5,37
27750,2787,2772,0.0,2779.5,15
27751,2801,2787,0.5,2794.0,14
27752,2877,2805,0.5,2841.0,72
27753,2768,2772,0.5,2770.0,-4
27754,2805,2801,0.5,2803.0,4
27755,2772,2877,0.5,2824.5,-105
27756,2787,2768,0.5,2777.5,19
27757,2367,2259,1.0,2313.0,108
27758,2715,2699,0.5,2707.0,16
27759,2562,2737,0.5,2649.5,-175
27760,2496,2737,0.5,2616.5,-241
27761,2675,2666,0.0,2670.5,9
27762,2493,2678,0.0,2585.5,-185
27763,2737,2666,1.0,2701.5,71
27764,2675,2626,1.0,2650.5,49
27765,2529,2562,1.0,2545.5,-33
27766,2737,2428,1.0,2582.5,309
27767,2666,2737,1.0,2701.5,-71
27768,2626,2675,0.5,2650.5,-49
27769,2562,2529,0.0,2545.5,33
27770,2428,2737,0.5,2582.5,-309
27771,2737,2666,1.0,2701.5,71
27772,2737,2675,1.0,2706.0,62
27773,2737,2529,1.0,2633.0,208
27774,2675,2737,0.5,2706.0,-62
27775,2529,2737,0.0,2633.0,-208
27776,2737,2737,1.0,2737.0,0
27777,2737,2737,0.5,2737.0,0
27778,1562,2023,0.5,1792.5,-461
27779,2672,2718,1.0,2695.0,-46
27780,2754,2719,1.0,2736.5,35
27781,2759,2777,1.0,2768.0,-18
27782,2734,2812,0.5,2773.0,-78
27783,2782,2691,1.0,2736.5,91
27784,2706,2789,1.0,2747.5,-83
27785,2789,2782,0.5,2785.5,7
27786,2691,2734,0.5,2712.5,-43
27787,2718,2706,0.0,2712.0,12
27788,2812,2759,1.0,2785.5,53
27789,2777,2754,0.5,2765.5,23
27790,2719,2672,1.0,2695.5,47
27791,2672,2777,0.0,2724.5,-105
27792,2706,2719,0.5,2712.5,-13
27793,2754,2812,0.0,2783.0,-58
27794,2734,2759,0.5,2746.5,-25
27795,2782,2718,0.0,2750.0,64
27796,2691,2789,0.0,2740.0,-98
27797,2718,2691,1.0,2704.5,27
27798,2777,2706,1.0,2741.5,71
27799,2789,2734,0.5,2761.5,55
27800,2812,2672,0.0,2742.0,140
27801,2759,2754,0.5,2756.5,5
27802,2719,2782,0.5,2750.5,-63
27803,2607,2553,1.0,2580.0,54
27804,2602,2710,1.0,2656.0,-108
27805,2560,2431,0.5,2495.5,129
27806,2637,2711,1.0,2674.0,-74
27807,2566,2567,0.5,2566.5,-1
27808,2677,2430,1.0,2553.5,247
27809,2593,2457,1.0,2525.0,136
27810,2431,2607,0.0,2519.0,-176
27811,2553,2593,1.0,2573.0,-40
27812,2566,2637,0.5,2601.5,-71
27813,2710,2560,1.0,2635.0,150
27814,2711,2677,0.5,2694.0,34
27815,2567,2457,0.5,2512.0,110
27816,2430,2602,0.0,2516.0,-172
27817,2607,2710,0.5,2658.5,-103
27818,2637,2567,1.0,2602.0,70
27819,2602,2711,0.0,2656.5,-109
27820,2457,2553,0.0,2505.0,-96
27821,2560,2430,1.0,2495.0,130
27822,2593,2431,1.0,2512.0,162
27823,2677,2566,1.0,2621.5,111
27824,2430,2607,0.5,2518.5,-177
27825,2711,2560,0.5,2635.5,151
27826,2431,2457,1.0,2444.0,-26
27827,2637,2677,1.0,2657.0,-40
27828,2710,2593,0.0,2651.5,117
27829,2566,2602,1.0,2584.0,-36
27830,2567,2553,0.5,2560.0,14
27831,2607,2711,0.5,2659.0,-104
27832,2553,2431,1.0,2492.0,122
27833,2560,2566,0.5,2563.0,-6
27834,2457,2710,0.5,2583.5,-253
27835,2602,2637,0.5,2619.5,-35
27836,2677,2567,1.0,2622.0,110
27837,2593,2430,1.0,2511.5,163
27838,2099,2164,1.0,2131.5,-65
27839,2447,2383,1.0,2415.0,64
27840,2368,2480,0.5,2424.0,-112
27841,2297,2402,1.0,2349.5,-105
27842,2493,2622,0.5,2557.5,-129
27843,2346,2292,0.5,2319.0,54
27844,2404,2454,0.5,2429.0,-50
27845,2352,2286,1.0,2319.0,66
27846,2384,2405,0.0,2394.5,-21
27847,2386,2135,1.0,2260.5,251
27848,2364,2409,1.0,2386.5,-45
27849,2000,2174,0.0,2087.0,-174
27850,2785,2796,0.5,2790.5,-11
27851,2766,2751,1.0,2758.5,15
27852,2785,2671,0.5,2728.0,114
27853,2709,2760,0.5,2734.5,-51
27854,2759,2651,0.5,2705.0,108
27855,2749,2742,0.5,2745.5,7
27856,2628,2709,0.5,2668.5,-81
27857,2720,2711,1.0,2715.5,9
27858,2692,2656,0.5,2674.0,36
27859,2766,2785,0.5,2775.5,-19
27860,2796,2785,0.5,2790.5,11
27861,2760,2749,0.5,2754.5,11
27862,2742,2759,1.0,2750.5,-17
27863,2751,2628,1.0,2689.5,123
27864,2709,2720,0.5,2714.5,-11
27865,2671,2709,0.0,2690.0,-38
27866,2656,2651,0.5,2653.5,5
27867,2711,2692,0.5,2701.5,19
27868,2751,2796,0.5,2773.5,-45
27869,2709,2766,0.5,2737.5,-57
27870,2785,2742,0.5,2763.5,43
27871,2785,2709,0.5,2747.0,76
27872,2651,2760,0.5,2705.5,-109
27873,2749,2720,1.0,2734.5,29
27874,2692,2671,1.0,2681.5,21
27875,2759,2711,0.5,2735.0,48
27876,2628,2656,0.5,2642.0,-28
27877,2796,2709,0.5,2752.5,87
27878,2766,2749,0.5,2757.5,17
27879,2742,2751,0.5,2746.5,-9
27880,2760,2785,0.5,2772.5,-25
27881,2692,2785,0.5,2738.5,-93
27882,2709,2651,0.5,2680.0,58
27883,2720,2759,1.0,2739.5,-39
27884,2711,2628,0.5,2669.5,83
27885,2656,2671,1.0,2663.5,-15
27886,2749,2796,0.5,2772.5,-47
27887,2742,2766,1.0,2754.0,-24
27888,2709,2751,0.5,2730.0,-42
27889,2785,2785,0.5,2785.0,0
27890,2720,2760,0.5,2740.0,-40
27891,2651,2692,0.5,2671.5,-41
27892,2656,2709,0.5,2682.5,-53
27893,2628,2759,0.0,2693.5,-131
27894,2671,2711,0.5,2691.0,-40
27895,2796,2742,0.5,2769.0,54
27896,2785,2751,0.5,2768.0,34
27897,2709,2749,0.5,2729.0,-40
27898,2766,2651,1.0,2708.5,115
27899,2760,2785,1.0,2772.5,-25
27900,2692,2720,0.5,2706.0,-28
27901,2709,2711,0.5,2710.0,-2
27902,2759,2656,1.0,2707.5,103
27903,2671,2628,0.5,2649.5,43
27904,2567,2442,1.0,2504.5,125
27905,2556,2556,0.0,2556.0,0
27906,2574,2549,1.0,2561.5,25
27907,2582,2560,0.5,2571.0,22
27908,2556,2560,0.5,2558.0,-4
27909,2582,2549,0.5,2565.5,33
27910,2574,2556,0.5,2565.0,18
27911,2574,2556,0.5,2565.0,18
27912,2556,2582,0.5,2569.0,-26
27913,2549,2560,0.5,2554.5,-11
27914,2556,2549,0.0,2552.5,7
27915,2560,2556,0.5,2558.0,4
27916,2582,2574,0.5,2578.0,8
27917,2582,2556,1.0,2569.0,26
27918,2574,2560,0.5,2567.0,14
27919,2556,2549,0.5,2552.5,7
27920,2556,2556,0.5,2556.0,0
27921,2549,2574,0.5,2561.5,-25
27922,2560,2582,0.5,2571.0,-22
27923,2052,1712,1.0,1882.0,340
27924,2807,2791,0.5,2799.0,16
27925,2822,2792,0.5,2807.0,30
27926,2773,2783,0.5,2778.0,-10
27927,2809,2810,1.0,2809.5,-1
27928,2742,2749,0.5,2745.5,-7
27929,2791,2773,0.5,2782.0,18
27930,2749,2822,0.5,2785.5,-73
27931,2792,2809,0.0,2800.5,-17
27932,2783,2742,1.0,2762.5,41
27933,2810,2807,0.5,2808.5,3
27934,2783,2791,0.5,2787.0,-8
27935,2809,2749,0.5,2779.0,60
27936,2742,2822,0.5,2782.0,-80
27937,2807,2792,0.5,2799.5,15
27938,2773,2810,1.0,2791.5,-37
27939,2822,2809,1.0,2815.5,13
27940,2791,2742,1.0,2766.5,49
27941,2810,2783,0.5,2796.5,27
27942,2792,2773,0.5,2782.5,19
27943,2749,2807,1.0,2778.0,-58
27944,1897,1811,1.0,1854.0,86
27945,2713,2837,1.0,2775.0,-124
27946,2684,2778,0.5,2731.0,-94
27947,2739,2472,0.0,2605.5,267
27948,2599,2770,1.0,2684.5,-171
27949,2778,2684,1.0,2731.0,94
27950,2472,2739,0.5,2605.5,-267
27951,2770,2599,1.0,2684.5,171
27952,2837,2713,1.0,2775.0,124
27953,2837,2713,0.0,2775.0,124
27954,2599,2770,0.0,2684.5,-171
27955,2778,2770,1.0,2774.0,8
27956,2713,2472,1.0,2592.5,241
27957,2472,2713,0.5,2592.5,-241
27958,2770,2778,0.0,2774.0,-8
27959,2713,2778,0.5,2745.5,-65
27960,2778,2713,1.0,2745.5,65
27961,2837,2778,0.5,2807.5,59
27962,2739,2713,1.0,2726.0,26
27963,2770,2696,0.0,2733.0,74
27964,2480,2617,0.5,2548.5,-137
27965,1944,2686,0.0,2315.0,-742
27966,2714,2061,1.0,2387.5,653
27967,1989,2630,0.0,2309.5,-641
27968,2686,2237,1.0,2461.5,449
27969,2143,2641,0.0,2392.0,-498
27970,1961,2714,0.0,2337.5,-753
27971,2663,2150,1.0,2406.5,513
27972,2385,2686,0.0,2535.5,-301
27973,2641,2321,1.0,2481.0,320
27974,2714,2501,0.5,2607.5,213
27975,2473,2663,0.0,2568.0,-190
27976,2686,2543,0.5,2614.5,143
27977,2573,2641,0.5,2607.0,-68
27978,2663,2570,1.0,2616.5,93
27979,2478,2691,0.0,2584.5,-213
27980,2356,2663,0.0,2509.5,-307
27981,2691,2630,1.0,2660.5,61
27982,2559,2686,0.0,2622.5,-127
27983,2641,2543,0.0,2592.0,98
27984,2663,2691,0.5,2677.0,-28
27985,2686,2653,0.0,2669.5,33
27986,2543,2714,0.5,2628.5,-171
27987,2630,2473,1.0,2551.5,157
27988,2653,2663,0.5,2658.0,-10
27989,2691,2543,0.5,2617.0,148
27990,2714,2478,1.0,2596.0,236
27991,2570,2630,1.0,2600.0,-60
27992,2663,2714,0.5,2688.5,-51
27993,2691,2570,0.5,2630.5,121
27994,2456,2653,0.5,2554.5,-197
27995,2528,2686,1.0,2607.0,-158
27996,2691,2570,1.0,2630.5,121
27997,2543,2646,0.0,2594.5,-103
27998,2714,2663,1.0,2688.5,51
27999,2653,2528,1.0,2590.5,125
28000,2570,2691,1.0,2630.5,-121
28001,2646,2543,0.0,2594.5,103
28002,2663,2714,0.0,2688.5,-51
28003,2528,2653,0.0,2590.5,-125
28004,2646,2543,0.0,2594.5,103
28005,2570,2691,0.0,2630.5,-121
28006,2691,2570,1.0,2630.5,121
28007,2543,2646,0.5,2594.5,-103
28008,2691,2543,1.0,2617.0,148
28009,2653,2714,0.0,2683.5,-61
28010,2543,2691,0.5,2617.0,-148
28011,2714,2653,0.5,2683.5,61
28012,2714,2691,0.0,2702.5,23
28013,2691,2714,1.0,2702.5,-23
28014,2093,1955,1.0,2024.0,138
28015,2614,2599,0.5,2606.5,15
28016,2533,2617,0.5,2575.0,-84
28017,2518,2420,1.0,2469.0,98
28018,2502,2566,0.5,2534.0,-64
28019,2503,2565,0.0,2534.0,-62
28020,2367,2384,0.0,2375.5,-17
28021,2521,2234,1.0,2377.5,287
28022,2392,2352,1.0,2372.0,40
28023,2365,2118,1.0,2241.5,247
28024,2357,2261,1.0,2309.0,96
28025,2509,2421,0.0,2465.0,88
28026,2202,2490,0.0,2346.0,-288
28027,2482,2276,1.0,2379.0,206
28028,2509,2415,1.0,2462.0,94
28029,2386,2474,0.0,2430.0,-88
28030,2400,2378,1.0,2389.0,22
28031,2377,2419,0.0,2398.0,-42
28032,2230,2319,0.5,2274.5,-89
28033,2289,2179,1.0,2234.0,110
28034,2256,2292,0.5,2274.0,-36
28035,2363,2617,1.0,2490.0,-254
28036,2566,2243,1.0,2404.5,323
28037,2264,2518,0.0,2391.0,-254
28038,2370,2323,0.0,2346.5,47
28039,2235,2365,0.0,2300.0,-130
28040,2384,2102,0.5,2243.0,282
28041,2261,2376,1.0,2318.5,-115
28042,2109,2185,0.0,2147.0,-76
28043,2316,2187,1.0,2251.5,129
28044,2599,1972,1.0,2285.5,627
28045,2372,2398,0.5,2385.0,-26
28046,2565,2533,1.0,2549.0,32
28047,2420,2449,1.0,2434.5,-29
28048,2234,2367,1.0,2300.5,-133
28049,2294,2312,0.5,2303.0,-18
28050,2339,2502,1.0,2420.5,-163
28051,2250,2152,0.5,2201.0,98
28052,2357,2318,1.0,2337.5,39
28053,2211,2166,0.5,2188.5,45
28054,2425,2118,0.5,2271.5,307
28055,2506,2314,0.5,2410.0,192
28056,2400,2615,0.5,2507.5,-215
28057,2432,2298,0.5,2365.0,134
28058,2317,2441,0.5,2379.0,-124
28059,2248,2362,1.0,2305.0,-114
28060,2204,2436,0.5,2320.0,-232
28061,2370,2301,1.0,2335.5,69
28062,2168,2164,0.0,2166.0,4
28063,2203,2298,0.5,2250.5,-95
28064,2795,2315,0.5,2555.0,480
28065,2727,2747,0.5,2737.0,-20
28066,2785,2786,0.5,2785.5,-1
28067,2710,2724,0.5,2717.0,-14
28068,2772,2773,0.5,2772.5,-1
28069,2696,2710,0.5,2703.0,-14
28070,2751,2755,0.0,2753.0,-4
28071,2633,2652,0.5,2642.5,-19
28072,2750,2750,0.5,2750.0,0
28073,2652,2621,0.5,2636.5,31
28074,2786,2795,0.5,2790.5,-9
28075,2747,2710,0.5,2728.5,37
28076,2773,2785,1.0,2779.0,-12
28077,2724,2727,0.5,2725.5,-3
28078,2755,2772,0.5,2763.5,-17
28079,2750,2633,0.5,2691.5,117
28080,2710,2696,0.5,2703.0,14
28081,2621,2750,0.0,2685.5,-129
28082,2652,2751,0.0,2701.5,-99
28083,2795,2773,0.5,2784.0,22
28084,2696,2724,0.5,2710.0,-28
28085,2785,2786,0.5,2785.5,-1
28086,2772,2710,1.0,2741.0,62
28087,2750,2747,0.0,2748.5,3
28088,2751,2755,0.0,2753.0,-4
28089,2710,2633,0.5,2671.5,77
28090,2727,2750,0.0,2738.5,-23
28091,2773,2621,0.5,2697.0,152
28092,2633,2755,0.0,2694.0,-122
28093,2750,2772,0.5,2761.0,-22
28094,2786,2795,0.5,2790.5,-9
28095,2621,2652,0.5,2636.5,-31
28096,2724,2785,0.5,2754.5,-61
28097,2710,2696,0.0,2703.0,14
28098,2747,2710,0.0,2728.5,37
28099,2727,2751,0.5,2739.0,-24
28100,1979,1998,0.0,1988.5,-19
28101,2739,2737,0.5,2738.0,2
28102,2753,2709,0.5,2731.0,44
28103,2693,2725,1.0,2709.0,-32
28104,2717,2647,0.5,2682.0,70
28105,2755,2652,0.5,2703.5,103
28106,2599,2611,0.5,2605.0,-12
28107,2674,2591,0.5,2632.5,83
28108,2561,2592,0.0,2576.5,-31
28109,2650,2808,0.5,2729.0,-158
28110,2789,2662,1.0,2725.5,127
28111,2537,2782,0.0,2659.5,-245
28112,2674,2548,0.5,2611.0,126
28113,2761,2752,0.0,2756.5,9
28114,2671,2722,0.5,2696.5,-51
28115,2696,2669,0.0,2682.5,27
28116,2640,2688,0.5,2664.0,-48
28117,2602,2742,0.5,2672.0,-140
28118,2651,2622,0.5,2636.5,29
28119,2558,2591,0.0,2574.5,-33
28120,2540,2526,1.0,2533.0,14
28121,2716,2665,0.0,2690.5,51
28122,2601,2630,1.0,2615.5,-29
28123,2580,2575,0.0,2577.5,5
28124,2497,2566,0.5,2531.5,-69
28125,2446,2635,0.0,2540.5,-189
28126,2652,2492,1.0,2572.0,160
28127,2513,2616,0.5,2564.5,-103
28128,2524,2444,0.5,2484.0,80
28129,2769,2661,1.0,2715.0,108
28130,2603,2808,0.5,2705.5,-205
28131,2740,2451,1.0,2595.5,289
28132,2431,2754,0.5,2592.5,-323
28133,2648,2736,0.5,2692.0,-88
28134,2675,2584,1.0,2629.5,91
28135,2543,2646,1.0,2594.5,-103
28136,2681,2437,0.5,2559.0,244
28137,2720,2675,1.0,2697.5,45
28138,2617,2623,1.0,2620.0,-6
28139,2581,2512,0.0,2546.5,69
28140,2582,2553,1.0,2567.5,29
28141,2673,2752,1.0,2712.5,-79
28142,2640,2651,0.0,2645.5,-11
28143,2628,2684,0.5,2656.0,-56
28144,2614,2404,1.0,2509.0,210
28145,2641,2618,0.5,2629.5,23
28146,2595,2545,0.5,2570.0,50
28147,2523,2524,0.0,2523.5,-1
28148,2572,2491,0.5,2531.5,81
28149,2618,2813,0.0,2715.5,-195
28150,2617,2641,0.0,2629.0,-24
28151,2470,2635,1.0,2552.5,-165
28152,2623,2496,0.5,2559.5,127
28153,2723,2738,0.5,2730.5,-15
28154,2671,2633,0.5,2652.0,38
28155,2448,2635,0.0,2541.5,-187
28156,2666,2486,1.0,2576.0,180
28157,2535,2543,0.5,2539.0,-8
28158,2567,2526,1.0,2546.5,41
28159,2522,2568,1.0,2545.0,-46
28160,2459,2515,0.5,2487.0,-56
28161,2431,2687,0.0,2559.0,-256
28162,2654,2488,1.0,2571.0,166
28163,2512,2626,0.0,2569.0,-114
28164,2640,2439,0.5,2539.5,201
28165,2612,2453,1.0,2532.5,159
28166,2406,2552,0.0,2479.0,-146
28167,2625,2401,1.0,2513.0,224
28168,2338,2577,0.0,2457.5,-239
28169,2637,2631,0.5,2634.0,6
28170,2601,2444,0.5,2522.5,157
28171,2439,2571,0.5,2505.0,-132
28172,2565,2345,1.0,2455.0,220
28173,2616,2604,0.5,2610.0,12
28174,2513,2523,1.0,2518.0,-10
28175,2509,2594,0.0,2551.5,-85
28176,2542,2499,1.0,2520.5,43
28177,2473,2547,0.0,2510.0,-74
28178,2545,2501,1.0,2523.0,44
28179,2368,2442,1.0,2405.0,-74
28180,2430,2283,1.0,2356.5,147
28181,2857,2558,1.0,2707.5,299
28182,2398,2651,0.5,2524.5,-253
28183,2570,2373,0.5,2471.5,197
28184,2282,2537,0.0,2409.5,-255
28185,2590,2650,0.0,2620.0,-60
28186,2436,2606,0.0,2521.0,-170
28187,2585,2378,1.0,2481.5,207
28188,2434,2536,0.5,2485.0,-102
28189,2628,2554,0.5,2591.0,74
28190,2546,2377,1.0,2461.5,169
28191,2310,2508,0.0,2409.0,-198
28192,2439,2054,1.0,2246.5,385
28193,2560,2371,1.0,2465.5,189
28194,2416,2492,0.5,2454.0,-76
28195,2447,2350,1.0,2398.5,97
28196,2247,2455,0.0,2351.0,-208
28197,2511,2550,0.5,2530.5,-39
28198,2521,2458,0.5,2489.5,63
28199,2413,2427,1.0,2420.0,-14
28200,2418,2379,0.5,2398.5,39
28201,2534,2668,0.5,2601.0,-134
28202,2623,2517,1.0,2570.0,106
28203,2448,2608,0.5,2528.0,-160
28204,2584,2457,1.0,2520.5,127
28205,2548,2566,0.5,2557.0,-18
28206,2566,2499,1.0,2532.5,67
28207,2484,2478,1.0,2481.0,6
28208,2463,2464,1.0,2463.5,-1
28209,2580,2458,0.0,2519.0,122
28210,2328,2458,0.0,2393.0,-130
28211,2468,2295,1.0,2381.5,173
28212,2233,2447,0.0,2340.0,-214
28213,2490,2768,0.0,2629.0,-278
28214,2585,2489,1.0,2537.0,96
28215,2510,2518,0.5,2514.0,-8
28216,2548,2465,0.5,2506.5,83
28217,2638,2484,0.5,2561.0,154
28218,2503,2609,0.0,2556.0,-106
28219,2499,2288,1.0,2393.5,211
28220,2265,2519,0.0,2392.0,-254
28221,2215,2642,0.0,2428.5,-427
28222,2583,2166,1.0,2374.5,417
28223,2158,2505,0.5,2331.5,-347
28224,2432,2119,1.0,2275.5,313
28225,2411,2555,0.5,2483.0,-144
28226,2475,2321,0.5,2398.0,154
28227,2327,2445,0.5,2386.0,-118
28228,2459,1860,1.0,2159.5,599
28229,2546,2493,0.5,2519.5,53
28230,2280,2345,1.0,2312.5,-65
28231,2239,2241,0.0,2240.0,-2
28232,2184,2187,0.0,2185.5,-3
28233,2583,2042,1.0,2312.5,541
28234,1979,2582,0.0,2280.5,-603
28235,2450,2082,1.0,2266.0,368
28236,2012,2431,0.0,2221.5,-419
28237,2687,2455,0.5,2571.0,232
28238,2454,2619,0.5,2536.5,-165
28239,2630,2434,1.0,2532.0,196
28240,2393,2605,0.0,2499.0,-212
28241,2573,2007,1.0,2290.0,566
28242,2169,2448,0.0,2308.5,-279
28243,2430,1994,1.0,2212.0,436
28244,1894,2478,0.0,2186.0,-584
28245,2391,2565,0.0,2478.0,-174
28246,2519,2481,0.5,2500.0,38
28247,2387,2434,1.0,2410.5,-47
28248,2351,2272,1.0,2311.5,79
28249,2475,2390,1.0,2432.5,85
28250,2433,2374,0.0,2403.5,59
28251,2348,2350,0.0,2349.0,-2
28252,2223,2267,0.0,2245.0,-44
28253,2488,2334,1.0,2411.0,154
28254,2111,2351,0.5,2231.0,-240
28255,2239,2343,1.0,2291.0,-104
28256,2405,2088,0.0,2246.5,317
28257,2387,2406,0.0,2396.5,-19
28258,2187,2363,0.5,2275.0,-176
28259,2323,2294,0.0,2308.5,29
28260,2531,2114,0.5,2322.5,417
28261,2316,2415,0.0,2365.5,-99
28262,2513,2550,1.0,2531.5,-37
28263,2322,2374,0.5,2348.0,-52
28264,2439,2458,1.0,2448.5,-19
28265,2289,2407,1.0,2348.0,-118
28266,2326,2273,1.0,2299.5,53
28267,2031,2148,0.5,2089.5,-117
28268,2422,2259,0.5,2340.5,163
28269,2441,2451,1.0,2446.0,-10
28270,2335,2342,0.5,2338.5,-7
28271,2401,2219,0.5,2310.0,182
28272,2398,2240,0.0,2319.0,158
28273,2212,2610,0.0,2411.0,-398
28274,2223,2340,0.5,2281.5,-117
28275,2119,2150,0.5,2134.5,-31
28276,2439,2100,1.0,2269.5,339
28277,2366,2487,1.0,2426.5,-121
28278,2058,2150,1.0,2104.0,-92
28279,2328,2343,1.0,2335.5,-15
28280,2312,2060,0.0,2186.0,252
28281,2219,2348,0.5,2283.5,-129
28282,2341,2309,1.0,2325.0,32
28283,2194,2188,1.0,2191.0,6
28284,2238,2217,0.5,2227.5,21
28285,2434,2453,1.0,2443.5,-19
28286,2161,2117,0.0,2139.0,44
28287,2230,2279,1.0,2254.5,-49
28288,2354,2074,0.5,2214.0,280
28289,2253,2245,1.0,2249.0,8
28290,2142,2260,0.0,2201.0,-118
28291,2373,2294,1.0,2333.5,79
28292,2314,2123,1.0,2218.5,191
28293,2034,2190,0.5,2112.0,-156
28294,2308,2255,1.0,2281.5,53
28295,2339,2345,1.0,2342.0,-6
28296,2076,2176,0.0,2126.0,-100
28297,2126,2215,1.0,2170.5,-89
28298,1726,1766,0.5,1746.0,-40
28299,2285,1904,0.5,2094.5,381
28300,2392,2318,1.0,2355.0,74
28301,2235,2248,0.5,2241.5,-13
28302,2174,2239,0.0,2206.5,-65
28303,2384,2205,0.5,2294.5,179
28304,2053,2297,1.0,2175.0,-244
28305,2232,2301,1.0,2266.5,-69
28306,2036,2092,1.0,2064.0,-56
28307,2060,2173,0.0,2116.5,-113
28308,2047,2204,1.0,2125.5,-157
28309,2065,2058,0.5,2061.5,7
28310,1612,1970,0.0,1791.0,-358
28311,2293,1983,0.0,2138.0,310
28312,1991,2216,0.5,2103.5,-225
28313,2004,2168,1.0,2086.0,-164
28314,1917,1831,0.5,1874.0,86
28315,2396,2034,1.0,2215.0,362
28316,1993,2227,0.5,2110.0,-234
28317,2127,2082,0.5,2104.5,45
28318,2037,2122,0.5,2079.5,-85
28319,2216,1970,0.0,2093.0,246
28320,1992,2109,1.0,2050.5,-117
28321,2183,1914,1.0,2048.5,269
28322,1889,2167,0.0,2028.0,-278
28323,2373,2161,0.0,2267.0,212
28324,2251,2190,1.0,2220.5,61
28325,2137,2302,0.0,2219.5,-165
28326,2361,2202,1.0,2281.5,159
28327,2145,1655,1.0,1900.0,490
28328,2097,2119,0.0,2108.0,-22
28329,1929,2069,0.5,1999.0,-140
28330,1624,1893,1.0,1758.5,-269
28331,2120,2183,1.0,2151.5,-63
28332,2199,2020,0.5,2109.5,179
28333,2052,2116,1.0,2084.0,-64
28334,2060,2107,0.0,2083.5,-47
28335,2172,2099,1.0,2135.5,73
28336,2034,2151,1.0,2092.5,-117
28337,2057,2013,0.0,2035.0,44
28338,2017,2017,1.0,2017.0,0
28339,2238,1842,1.0,2040.0,396
28340,1825,1918,0.0,1871.5,-93
28341,1950,1867,1.0,1908.5,83
28342,1987,2111,0.0,2049.0,-124
28343,2170,2388,1.0,2279.0,-218
28344,2269,1997,0.5,2133.0,272
28345,2009,2229,0.5,2119.0,-220
28346,2134,1842,1.0,1988.0,292
28347,2115,2192,0.0,2153.5,-77
28348,1900,1880,1.0,1890.0,20
28349,1918,1890,1.0,1904.0,28
28350,2129,2254,1.0,2191.5,-125
28351,2096,1944,0.0,2020.0,152
28352,1868,2153,0.0,2010.5,-285
28353,2259,2104,0.0,2181.5,155
28354,2336,2482,0.0,2409.0,-146
28355,2503,2334,1.0,2418.5,169
28356,2259,2142,1.0,2200.5,117
28357,2153,2272,0.5,2212.5,-119
28358,1606,1712,1.0,1659.0,-106
28359,1750,1567,0.0,1658.5,183
28360,1798,1768,0.5,1783.0,30
28361,1899,2305,0.0,2102.0,-406
28362,2285,2077,0.5,2181.0,208
28363,2116,2044,0.0,2080.0,72
28364,1911,1956,0.0,1933.5,-45
28365,2056,1840,0.0,1948.0,216
28366,1880,2002,0.0,1941.0,-122
28367,2315,2269,0.0,2292.0,46
28368,2149,2276,0.5,2212.5,-127
28369,2274,2099,0.5,2186.5,175
28370,2016,2208,0.5,2112.0,-192
28371,2257,2003,1.0,2130.0,254
28372,2119,2248,0.5,2183.5,-129
28373,2196,1972,1.0,2084.0,224
28374,1988,2203,0.0,2095.5,-215
28375,1960,1796,1.0,1878.0,164
28376,1852,1915,0.5,1883.5,-63
28377,1671,2063,1.0,1867.0,-392
28378,2032,1625,1.0,1828.5,407
28379,2087,1692,1.0,1889.5,395
28380,1850,1999,0.5,1924.5,-149
28381,1976,1971,0.0,1973.5,5
28382,1995,2234,0.0,2114.5,-239
28383,2270,2337,1.0,2303.5,-67
28384,1939,1851,0.0,1895.0,88
28385,2189,2298,1.0,2243.5,-109
28386,2234,2261,0.0,2247.5,-27
28387,2251,2131,1.0,2191.0,120
28388,2018,2096,0.5,2057.0,-78
28389,2095,1861,0.5,1978.0,234
28390,1889,1787,0.0,1838.0,102
28391,1781,1670,1.0,1725.5,111
28392,1676,1764,0.0,1720.0,-88
28393,1964,1932,1.0,1948.0,32
28394,2044,1675,0.0,1859.5,369
28395,1908,1914,0.0,1911.0,-6
28396,2060,1977,1.0,2018.5,83
28397,1663,2128,0.5,1895.5,-465
28398,2000,1754,0.5,1877.0,246
28399,1736,1956,1.0,1846.0,-220
28400,1857,1685,0.0,1771.0,172
28401,2014,1923,0.0,1968.5,91
28402,1877,1966,1.0,1921.5,-89
28403,1909,1723,1.0,1816.0,186
28404,1800,1940,0.5,1870.0,-140
28405,2013,2036,1.0,2024.5,-23
28406,2024,1986,0.5,2005.0,38
28407,1812,1912,1.0,1862.0,-100
28408,1878,1656,1.0,1767.0,222
28409,1516,1855,0.0,1685.5,-339
28410,1880,1592,1.0,1736.0,288
28411,1447,1853,0.0,1650.0,-406
28412,1692,1301,1.0,1496.5,391
28413,2054,1758,1.0,1906.0,296
28414,1850,1782,0.0,1816.0,68
28415,1732,2011,1.0,1871.5,-279
28416,1793,1678,1.0,1735.5,115
28417,1713,1768,1.0,1740.5,-55
28418,1798,1322,0.0,1560.0,476
28419,1610,1677,0.0,1643.5,-67
28420,2398,1730,1.0,2064.0,668
28421,2339,2354,1.0,2346.5,-15
28422,2322,2402,1.0,2362.0,-80
28423,2272,2192,1.0,2232.0,80
28424,2752,2347,0.5,2549.5,405
28425,2611,2755,0.0,2683.0,-144
28426,2669,2671,0.5,2670.0,-2
28427,2592,2674,0.5,2633.0,-82
28428,2808,2640,1.0,2724.0,168
28429,2709,2739,0.5,2724.0,-30
28430,2782,2789,0.5,2785.5,-7
28431,2675,2693,0.5,2684.0,-18
28432,2742,2679,0.5,2710.5,63
28433,2609,2665,0.5,2637.0,-56
28434,2591,2651,0.5,2621.0,-60
28435,2575,2601,0.5,2588.0,-26
28436,2601,2519,0.5,2560.0,82
28437,2722,2761,0.5,2741.5,-39
28438,2555,2571,1.0,2563.0,-16
28439,2688,2696,1.0,2692.0,-8
28440,2675,2565,0.5,2620.0,110
28441,2599,2652,0.5,2625.5,-53
28442,2582,2617,1.0,2599.5,-35
28443,2547,2591,0.5,2569.0,-44
28444,2687,2430,0.5,2558.5,257
28445,2808,2769,1.0,2788.5,39
28446,2626,2654,0.5,2640.0,-28
28447,2740,2731,1.0,2735.5,9
28448,2737,2618,0.0,2677.5,119
28449,2585,2606,0.0,2595.5,-21
28450,2746,2753,1.0,2749.5,-7
28451,2536,2595,0.5,2565.5,-59
28452,2618,2717,1.0,2667.5,-99
28453,2552,2612,0.0,2582.0,-60
28454,2524,2595,0.5,2559.5,-71
28455,2577,2625,1.0,2601.0,-48
28456,2574,2572,0.5,2573.0,2
28457,2652,2635,0.5,2643.5,17
28458,2545,2547,0.5,2546.0,-2
28459,2565,2616,0.5,2590.5,-51
28460,2604,2430,1.0,2517.0,174
28461,2651,2673,1.0,2662.0,-22
28462,2594,2513,0.0,2553.5,81
28463,2476,2628,0.5,2552.0,-152
28464,2554,2542,0.5,2548.0,12
28465,2671,2665,1.0,2668.0,6
28466,2508,2546,0.0,2527.0,-38
28467,2666,2635,0.5,2650.5,31
28468,2857,2444,0.5,2650.5,413
28469,2492,2560,0.5,2526.0,-68
28470,2570,2651,0.5,2610.5,-81
28471,2455,2447,0.5,2451.0,8
28472,2736,2537,0.5,2636.5,199
28473,2641,2618,0.5,2629.5,23
28474,2681,2675,0.0,2678.0,6
28475,2496,2470,0.0,2483.0,26
28476,2585,2639,0.0,2612.0,-54
28477,2622,2602,1.0,2612.0,20
28478,2548,2518,0.5,2533.0,30
28479,2526,2562,1.0,2544.0,-36
28480,2566,2458,0.5,2512.0,108
28481,2584,2648,0.5,2616.0,-64
28482,2478,2566,1.0,2522.0,-88
28483,2489,2543,0.5,2516.0,-54
28484,2638,2463,0.5,2550.5,175
28485,2662,2650,0.0,2656.0,12
28486,2499,2609,1.0,2554.0,-110
28487,2548,2537,1.0,2542.5,11
28488,2595,2519,0.5,2557.0,76
28489,2623,2668,0.5,2645.5,-45
28490,2522,2535,0.0,2528.5,-13
28491,2584,2622,0.5,2603.0,-38
28492,2583,2515,1.0,2549.0,68
28493,2458,2580,0.0,2519.0,-122
28494,2567,2543,0.5,2555.0,24
28495,2447,2468,0.0,2457.5,-21
28496,2511,2459,1.0,2485.0,52
28497,2630,2662,1.0,2646.0,-32
28498,2444,2458,0.0,2451.0,-14
28499,2566,2580,0.5,2573.0,-14
28500,2446,2413,0.5,2429.5,33
28501,2583,2696,0.5,2639.5,-113
28502,2513,2492,0.5,2502.5,21
28503,2450,2582,0.0,2516.0,-132
28504,2453,2444,0.0,2448.5,9
28505,2640,2752,1.0,2696.0,-112
28506,2279,2340,0.0,2309.5,-61
28507,2585,2614,1.0,2599.5,-29
28508,2813,2230,1.0,2521.5,583
28509,2215,2339,0.0,2277.0,-124
28510,2635,2617,1.0,2626.0,18
28511,1904,2051,0.0,1977.5,-147
28512,2661,2664,1.0,2662.5,-3
28513,2545,2641,1.0,2593.0,-96
28514,2431,2603,0.5,2517.0,-172
28515,2491,2516,1.0,2503.5,-25
28516,2453,2419,0.5,2436.0,34
28517,2623,2720,1.0,2671.5,-97
28518,2401,2406,0.0,2403.5,-5
28519,2581,2636,1.0,2608.5,-55
28520,2473,2338,0.0,2405.5,135
28521,2444,2637,0.0,2540.5,-193
28522,2407,2501,0.5,2454.0,-94
28523,2233,2439,1.0,2336.0,-206
28524,2642,2368,0.5,2505.0,274
28525,2437,2565,0.0,2501.0,-128
28526,2505,2583,0.5,2544.0,-78
28527,2351,2519,0.5,2435.0,-168
28528,2555,2432,1.0,2493.5,123
28529,2329,2475,0.5,2402.0,-146
28530,2475,2559,1.0,2517.0,-84
28531,2267,2348,0.0,2307.5,-81
28532,2371,2445,0.0,2408.0,-74
28533,2633,2723,0.5,2678.0,-90
28534,2350,2416,0.5,2383.0,-66
28535,2448,2435,1.0,2441.5,13
28536,2439,2177,0.0,2308.0,262
28537,2619,2687,1.0,2653.0,-68
28538,2326,2320,0.0,2323.0,6
28539,2553,2630,0.5,2591.5,-77
28540,2628,2259,1.0,2443.5,369
28541,2488,2431,0.0,2459.5,57
28542,2310,2377,0.0,2343.5,-67
28543,2439,2512,1.0,2475.5,-73
28544,2634,2291,0.0,2462.5,343
28545,2550,2531,0.5,2540.5,19
28546,2523,2616,1.0,2569.5,-93
28547,2482,2513,1.0,2497.5,-31
28548,2451,2509,1.0,2480.0,-58
28549,2340,2280,1.0,2310.0,60
28550,2401,2441,0.5,2421.0,-40
28551,2184,2241,1.0,2212.5,-57
28552,2558,2049,0.5,2303.5,509
28553,2363,2405,0.5,2384.0,-42
28554,2373,2401,1.0,2387.0,-28
28555,2187,2200,1.0,2193.5,-13
28556,2436,2282,1.0,2359.0,154
28557,2253,2209,0.5,2231.0,44
28558,2434,2378,1.0,2406.0,56
28559,2373,2294,1.0,2333.5,79
28560,2348,2245,0.5,2296.5,103
28561,2276,2351,0.5,2313.5,-75
28562,2219,2175,0.0,2197.0,44
28563,2088,2239,0.0,2163.5,-151
28564,2506,2188,0.0,2347.0,318
28565,2573,2697,0.0,2635.0,-124
28566,2308,2314,0.5,2311.0,-6
28567,2478,2448,1.0,2463.0,30
28568,2297,2345,0.0,2321.0,-48
28569,2499,2548,1.0,2523.5,-49
28570,2036,2053,0.0,2044.5,-17
28571,2484,2486,1.0,2485.0,-2
28572,2550,2023,0.0,2286.5,527
28573,2517,2534,0.5,2525.5,-17
28574,2427,2521,0.5,2474.0,-94
28575,2448,2482,0.0,2465.0,-34
28576,2458,2418,0.5,2438.0,40
28577,2340,2398,1.0,2369.0,-58
28578,2233,2328,1.0,2280.5,-95
28579,2108,2223,0.0,2165.5,-115
28580,2396,2181,1.0,2288.5,215
28581,2366,2367,0.0,2366.5,-1
28582,2227,2239,0.5,2233.0,-12
28583,2328,2343,0.5,2335.5,-15
28584,2484,2127,0.0,2305.5,357
28585,2436,2610,0.5,2523.0,-174
28586,2432,2503,1.0,2467.5,-71
28587,2119,2150,1.0,2134.5,-31
28588,2099,2265,0.0,2182.0,-166
28589,2510,2489,0.0,2499.5,21
28590,2013,2071,0.0,2042.0,-58
28591,2427,2465,1.0,2446.0,-38
28592,2251,2017,0.5,2134.0,234
28593,2392,2318,0.0,2355.0,74
28594,2361,2302,1.0,2331.5,59
28595,2114,2239,0.0,2176.5,-125
28596,2238,2236,1.0,2237.0,2
28597,2119,2145,0.5,2132.0,-26
28598,1950,2025,0.5,1987.5,-75
28599,2150,1929,0.0,2039.5,221
28600,2120,2111,0.0,2115.5,9
28601,2169,2439,0.0,2304.0,-270
28602,2052,2020,1.0,2036.0,32
28603,2058,2150,1.0,2104.0,-92
28604,2216,2107,0.0,2161.5,109
28605,2111,2334,1.0,2222.5,-223
28606,1991,2343,0.5,2167.0,-352
28607,2422,1917,1.0,2169.5,505
28608,1979,2042,0.5,2010.5,-63
28609,2335,2342,0.5,2338.5,-7
28610,2082,2027,0.0,2054.5,55
28611,2390,2178,1.0,2284.0,212
28612,1567,1606,0.0,1586.5,-39
28613,2127,2350,0.5,2238.5,-223
28614,2169,2223,0.0,2196.0,-54
28615,2312,2348,1.0,2330.0,-36
28616,1963,1994,0.0,1978.5,-31
28617,2217,2341,1.0,2279.0,-124
28618,1951,1894,0.0,1922.5,57
28619,2294,2406,1.0,2350.0,-112
28620,1992,1970,0.0,1981.0,22
28621,2323,2331,1.0,2327.0,-8
28622,2305,1889,1.0,2097.0,416
28623,2216,2199,0.5,2207.5,17
28624,2208,2285,1.0,2246.5,-77
28625,2167,2183,0.5,2175.0,-16
28626,2164,2027,0.0,2095.5,137
28627,2415,2564,0.5,2489.5,-149
28628,2034,2190,0.5,2112.0,-156
28629,2322,2316,0.0,2319.0,6
28630,2407,2164,1.0,2285.5,243
28631,2251,2261,1.0,2256.0,-10
28632,2148,2289,1.0,2218.5,-141
28633,2025,2096,0.0,2060.5,-71
28634,2384,2031,1.0,2207.5,353
28635,1999,2087,0.0,2043.0,-88
28636,2232,2301,0.0,2266.5,-69
28637,2234,1850,1.0,2042.0,384
28638,1960,2173,0.0,2066.5,-213
28639,2239,2345,0.5,2292.0,-106
28640,1671,1782,0.0,1726.5,-111
28641,2067,2187,0.5,2127.0,-120
28642,2556,1625,1.0,2090.5,931
28643,1944,1933,0.0,1938.5,11
28644,2321,2411,1.0,2366.0,-90
28645,2104,1868,0.5,1986.0,236
28646,2391,2327,1.0,2359.0,64
28647,1900,2192,0.0,2046.0,-292
28648,2387,2481,1.0,2434.0,-94
28649,2030,1890,0.0,1960.0,140
28650,2170,2214,1.0,2192.0,-44
28651,2166,2215,0.0,2190.5,-49
28652,2009,1997,0.0,2003.0,12
28653,2154,2158,0.0,2156.0,-4
28654,2176,1842,0.5,2009.0,334
28655,2168,2293,0.0,2230.5,-125
28656,1766,2076,0.0,1921.0,-310
28657,2337,1726,1.0,2031.5,611
28658,2142,2260,0.0,2201.0,-118
28659,2270,2289,0.5,2279.5,-19
28660,2123,2026,0.5,2074.5,97
28661,2482,2298,1.0,2390.0,184
28662,2248,2257,0.0,2252.5,-9
28663,2153,2503,1.0,2328.0,-350
28664,2203,2196,0.0,2199.5,7
28665,2455,2107,1.0,2281.0,348
28666,2117,2238,0.5,2177.5,-121
28667,2434,2454,1.0,2444.0,-20
28668,2146,2161,0.5,2153.5,-15
28669,2269,2315,1.0,2292.0,-46
28670,1787,1943,0.0,1865.0,-156
28671,2099,2166,1.0,2132.5,-67
28672,1764,1781,0.0,1772.5,-17
28673,2034,2016,0.5,2025.0,18
28674,2065,2058,1.0,2061.5,7
28675,2037,2082,0.0,2059.5,-45
28676,1983,2172,0.0,2077.5,-189
28677,2190,1879,0.5,2034.5,311
28678,1675,1964,0.0,1819.5,-289
28679,2100,2137,1.0,2118.5,-37
28680,1841,1908,0.0,1874.5,-67
28681,2013,2202,0.0,2107.5,-189
28682,1956,2116,0.5,2036.0,-160
28683,1812,1986,1.0,1899.0,-174
28684,2002,2056,1.0,2029.0,-54
28685,1655,1717,0.5,1686.0,-62
28686,1754,1663,0.0,1708.5,91
28687,1715,2069,0.5,1892.0,-354
28688,1685,1736,0.0,1710.5,-51
28689,2388,1624,1.0,2006.0,764
28690,2128,2183,0.0,2155.5,-55
28691,2229,2269,1.0,2249.0,-40
28692,2116,2199,0.0,2157.5,-83
28693,1923,2134,0.0,2028.5,-211
28694,2068,2151,0.0,2109.5,-83
28695,1723,1877,0.0,1800.0,-154
28696,2017,2057,0.5,2037.0,-40
28697,1842,1800,0.0,1821.0,42
28698,1867,1825,1.0,1846.0,42
28699,2050,1869,0.0,1959.5,181
28700,2044,1992,1.0,2018.0,52
28701,1914,2044,0.5,1979.0,-130
28702,1880,1911,0.5,1895.5,-31
28703,1750,2060,0.0,1905.0,-310
28704,1880,2115,1.0,1997.5,-235
28705,1798,1768,1.0,1783.0,30
28706,1758,1651,0.5,1704.5,107
28707,2018,2234,1.0,2126.0,-216
28708,1782,1850,0.5,1816.0,-68
28709,2340,1732,0.0,2036.0,608
28710,2276,2315,0.0,2295.5,-39
28711,2259,2334,0.0,2296.5,-75
28712,2208,2274,1.0,2241.0,-66
28713,1924,2272,1.0,2098.0,-348
28714,1889,1861,0.0,1875.0,28
28715,2003,1670,0.5,1836.5,333
28716,2096,2254,0.5,2175.0,-158
28717,2119,1930,0.0,2024.5,189
28718,2259,2153,0.0,2206.0,106
28719,1796,1988,0.5,1892.0,-192
28720,2049,1852,1.0,1950.5,197
28721,2063,1971,1.0,2017.0,92
28722,1976,2032,0.0,2004.0,-56
28723,1855,1995,1.0,1925.0,-140
28724,1851,1880,0.0,1865.5,-29
28725,1853,1939,0.0,1896.0,-86
28726,2000,1692,0.0,1846.0,308
28727,1576,2205,0.0,1890.5,-629
28728,1956,1963,1.0,1959.5,-7
28729,1560,1952,0.5,1756.0,-392
28730,1966,1857,0.5,1911.5,109
28731,1870,1793,1.0,1831.5,77
28732,1940,1909,0.0,1924.5,31
28733,1713,1768,0.0,1740.5,-55
28734,2036,1785,1.0,1910.5,251
28735,1912,2024,1.0,1968.0,-112
28736,2054,1878,1.0,1966.0,176
28737,1592,1516,0.5,1554.0,76
28738,1301,1447,0.0,1374.0,-146
28739,2354,2011,1.0,2182.5,343
28740,2248,2285,1.0,2266.5,-37
28741,2192,2339,0.5,2265.5,-147
28742,2205,2235,1.0,2220.0,-30
28743,2070,2209,0.5,2139.5,-139
28744,2402,2398,1.0,2400.0,4
28745,1970,2047,0.0,2008.5,-77
28746,2347,2322,1.0,2334.5,25
28747,1677,1798,1.0,1737.5,-121
28748,2752,1610,0.5,2181.0,1142
28749,2789,2808,1.0,2798.5,-19
28750,2669,2671,0.0,2670.0,-2
28751,2679,2782,1.0,2730.5,-103
28752,2673,2640,0.5,2656.5,33
28753,2674,2755,0.0,2714.5,-81
28754,2628,2651,0.5,2639.5,-23
28755,2592,2640,0.0,2616.0,-48
28756,2769,2476,1.0,2622.5,293
28757,2651,2742,0.0,2696.5,-91
28758,2740,2731,1.0,2735.5,9
28759,2540,2591,0.5,2565.5,-51
28760,2668,2754,0.5,2711.0,-86
28761,2722,2761,1.0,2741.5,-39
28762,2622,2623,0.0,2622.5,-1
28763,2688,2666,1.0,2677.0,22
28764,2665,2584,1.0,2624.5,81
28765,2595,2618,0.5,2606.5,-23
28766,2601,2609,1.0,2605.0,-8
28767,2554,2524,0.5,2539.0,30
28768,2738,2575,1.0,2656.5,163
28769,2753,2737,0.5,2745.0,16
28770,2671,2665,0.5,2668.0,6
28771,2746,2725,0.0,2735.5,21
28772,2739,2666,0.0,2702.5,73
28773,2617,2675,0.5,2646.0,-58
28774,2675,2693,1.0,2684.0,-18
28775,2582,2512,0.0,2547.0,70
28776,2635,2647,0.0,2641.0,-12
28777,2651,2857,0.5,2754.0,-206
28778,2616,2652,0.5,2634.0,-36
28779,2537,2570,0.5,2553.5,-33
28780,2566,2524,1.0,2545.0,42
28781,2492,2446,0.5,2469.0,46
28782,2478,2566,1.0,2522.0,-88
28783,2444,2513,0.0,2478.5,-69
28784,2602,2463,0.5,2532.5,139
28785,2662,2716,0.5,2689.0,-54
28786,2558,2622,0.5,2590.0,-64
28787,2580,2630,0.0,2605.0,-50
28788,2574,2562,0.0,2568.0,12
28789,2571,2631,0.5,2601.0,-60
28790,2442,2547,0.5,2494.5,-105
28791,2565,2555,1.0,2560.0,10
28792,2560,2430,0.5,2495.0,130
28793,2543,2583,1.0,2563.0,-40
28794,2447,2492,1.0,2469.5,-45
28795,2568,2567,1.0,2567.5,1
28796,2618,2455,0.0,2536.5,163
28797,2609,2638,0.0,2623.5,-29
28798,2470,2641,0.0,2555.5,-171
28799,2410,2519,0.5,2464.5,-109
28800,2652,2318,0.5,2485.0,334
28801,2654,2687,1.0,2670.5,-33
28802,2561,2599,0.5,2580.0,-38
28803,2640,2626,0.0,2633.0,14
28804,2752,2547,0.0,2649.5,205
28805,2559,2555,0.0,2557.0,4
28806,2684,2640,1.0,2662.0,44
28807,2445,2475,0.0,2460.0,-30
28808,2531,2614,0.0,2572.5,-83
28809,2675,2736,1.0,2705.5,-61
28810,2482,2550,0.5,2516.0,-68
28811,2639,2646,0.5,2642.5,-7
28812,2697,2458,1.0,2577.5,239
28813,2635,2617,0.5,2626.0,18
28814,2448,2573,0.0,2510.5,-125
28815,2623,2664,0.5,2643.5,-41
28816,2720,2430,0.5,2575.0,290
28817,2545,2641,0.5,2593.0,-96
28818,2636,2623,1.0,2629.5,13
28819,2516,2523,0.5,2519.5,-7
28820,2612,2581,0.5,2596.5,31
28821,2436,2650,1.0,2543.0,-214
28822,2625,2509,1.0,2567.0,116
28823,2434,2378,0.5,2406.0,56
28824,2637,2577,1.0,2607.0,60
28825,2513,2604,0.5,2558.5,-91
28826,2439,2444,0.0,2441.5,-5
28827,2476,2594,0.0,2535.0,-118
28828,2723,2233,1.0,2478.0,490
28829,2583,2642,0.5,2612.5,-59
28830,2448,2633,1.0,2540.5,-185
28831,2432,2505,0.5,2468.5,-73
28832,2590,2486,0.5,2538.0,104
28833,2619,2687,0.5,2653.0,-68
28834,2585,2606,0.5,2595.5,-21
28835,2605,2630,0.5,2617.5,-25
28836,2493,2595,0.5,2544.0,-102
28837,2546,2554,1.0,2550.0,-8
28838,2340,2280,0.0,2310.0,60
28839,2439,2508,1.0,2473.5,-69
28840,2548,2184,1.0,2366.0,364
28841,2295,2328,0.0,2311.5,-33
28842,2486,2499,1.0,2492.5,-13
28843,2181,2233,0.0,2207.0,-52
28844,2431,2484,1.0,2457.5,-53
28845,2662,2650,1.0,2656.0,12
28846,2413,2512,0.0,2462.5,-99
28847,2459,2548,1.0,2503.5,-89
28848,2610,2439,1.0,2524.5,171
28849,2526,2595,0.5,2560.5,-69
28850,2212,2436,0.0,2324.0,-224
28851,2515,2522,1.0,2518.5,-7
28852,2648,2119,0.5,2383.5,529
28853,2377,2628,0.0,2502.5,-251
28854,2489,2584,1.0,2536.5,-95
28855,2291,2310,0.0,2300.5,-19
28856,2585,2437,1.0,2511.0,148
28857,2398,2401,1.0,2399.5,-3
28858,2548,2518,0.0,2533.0,30
28859,2282,2373,0.0,2327.5,-91
28860,2161,2458,0.0,2309.5,-297
28861,2458,2511,1.0,2484.5,-53
28862,2361,2302,0.0,2331.5,59
28863,2379,2413,1.0,2396.0,-34
28864,2458,2236,0.0,2347.0,222
28865,1918,2238,0.0,2078.0,-320
28866,2447,2468,0.5,2457.5,-21
28867,2111,2025,0.0,2068.0,86
28868,2351,2354,0.5,2352.5,-3
28869,2363,2405,1.0,2384.0,-42
28870,2239,2276,1.0,2257.5,-37
28871,2114,2187,1.0,2150.5,-73
28872,2490,2088,1.0,2289.0,402
28873,2248,2285,0.0,2266.5,-37
28874,2465,2510,1.0,2487.5,-45
28875,1909,2205,0.0,2057.0,-296
28876,2696,2427,1.0,2561.5,269
28877,2175,2348,0.0,2261.5,-173
28878,2582,2583,1.0,2582.5,-1
28879,2194,2219,0.0,2206.5,-25
28880,2334,2431,0.5,2382.5,-97
28881,2616,2634,1.0,2625.0,-18
28882,2343,2018,0.0,2180.5,325
28883,2499,2523,1.0,2511.0,-24
28884,2482,2473,0.5,2477.5,9
28885,2501,2503,0.5,2502.0,-2
28886,2153,2407,0.0,2280.0,-254
28887,2283,2107,1.0,2195.0,176
28888,2534,2506,0.5,2520.0,28
28889,2255,2517,0.5,2386.0,-262
28890,2482,2308,1.0,2395.0,174
28891,2345,2457,0.0,2401.0,-112
28892,2390,2439,1.0,2414.5,-49
28893,2273,2433,0.0,2353.0,-160
28894,2350,2326,1.0,2338.0,24
28895,2259,2223,0.0,2241.0,36
28896,2348,2371,0.0,2359.5,-23
28897,2416,2312,0.5,2364.0,104
28898,2309,2247,0.0,2278.0,62
28899,2177,2341,0.5,2259.0,-164
28900,2407,2550,0.0,2478.5,-143
28901,2427,2289,1.0,2358.0,138
28902,2148,2418,0.0,2283.0,-270
28903,1574,2031,0.0,1802.5,-457
28904,2337,2661,1.0,2499.0,-324
28905,2603,2289,1.0,2446.0,314
28906,2270,2451,1.0,2360.5,-181
28907,2431,2298,0.5,2364.5,133
28908,2565,2339,1.0,2452.0,226
28909,2215,2437,0.0,2326.0,-222
28910,2434,2051,1.0,2242.5,383
28911,1904,2351,0.0,2127.5,-447
28912,2453,2422,1.0,2437.5,31
28913,2342,2434,0.0,2388.0,-92
28914,2340,2335,0.0,2337.5,5
28915,2240,2279,1.0,2259.5,-39
28916,2485,2481,0.5,2483.0,4
28917,2387,2453,0.0,2420.0,-66
28918,2406,2272,1.0,2339.0,134
28919,2214,2401,0.0,2307.5,-187
28920,2293,2556,0.0,2424.5,-263
28921,2411,2168,1.0,2289.5,243
28922,2004,2321,0.0,2162.5,-317
28923,2327,1927,1.0,2127.0,400
28924,2209,2475,0.0,2342.0,-266
28925,2329,2245,1.0,2287.0,84
28926,2253,2348,0.0,2300.5,-95
28927,2267,2373,0.0,2320.0,-106
28928,2546,2285,1.0,2415.5,261
28929,2208,2239,0.0,2223.5,-31
28930,2187,2077,1.0,2132.0,110
28931,2027,2067,1.0,2047.0,-40
28932,2406,2451,1.0,2428.5,-45
28933,2441,2387,1.0,2414.0,54
28934,2294,2401,0.5,2347.5,-107
28935,2049,2323,1.0,2186.0,-274
28936,2297,2120,1.0,2208.5,177
28937,2020,2053,1.0,2036.5,-33
28938,2092,2015,0.5,2053.5,77
28939,2052,2036,1.0,2044.0,16
28940,2439,2269,0.0,2354.0,170
28941,2166,2169,1.0,2167.5,-3
28942,2058,2149,1.0,2103.5,-91
28943,2016,2060,1.0,2038.0,-44
28944,2455,2170,1.0,2312.5,285
28945,1997,2434,0.5,2215.5,-437
28946,2393,2009,1.0,2201.0,384
28947,1842,2315,0.5,2078.5,-473
28948,2487,2070,1.0,2278.5,417
28949,2204,2367,0.5,2285.5,-163
28950,2366,2047,1.0,2206.5,319
28951,1970,2343,0.0,2156.5,-373
28952,2060,2116,0.0,2088.0,-56
28953,2000,2058,0.0,2029.0,-58
28954,2065,1956,0.5,2010.5,109
28955,2002,2172,0.5,2087.0,-170
28956,2172,2384,0.0,2278.0,-212
28957,2301,2151,1.0,2226.0,150
28958,2068,2232,0.5,2150.0,-164
28959,2173,2017,1.0,2095.0,156
28960,2145,2398,0.0,2271.5,-253
28961,2340,2119,0.5,2229.5,221
28962,1929,2223,0.0,2076.0,-294
28963,2100,1893,1.0,1996.5,207
28964,2564,1842,1.0,2203.0,722
28965,1825,2415,0.0,2120.0,-590
28966,2316,1987,1.0,2151.5,329
28967,1869,2374,0.0,2121.5,-505
28968,2164,2484,0.0,2324.0,-320
28969,2503,2190,1.0,2346.5,313
28970,2164,2432,0.0,2298.0,-268
28971,1992,2034,0.0,2013.0,-42
28972,2071,2044,1.0,2057.5,27
28973,1840,2013,0.0,1926.5,-173
28974,2017,1880,1.0,1948.5,137
28975,2318,2373,0.5,2345.5,-55
28976,2190,2392,1.0,2291.0,-202
28977,2239,2137,0.0,2188.0,102
28978,2202,2174,1.0,2188.0,28
28979,2087,1655,1.0,1871.0,432
28980,2097,1999,1.0,2048.0,98
28981,1850,2069,0.0,1959.5,-219
28982,1624,2234,0.0,1929.0,-610
28983,1951,2216,0.0,2083.5,-265
28984,1992,1970,0.0,1981.0,22
28985,1917,1991,0.0,1954.0,-74
28986,2199,1914,0.5,2056.5,285
28987,2161,2117,0.0,2139.0,44
28988,2109,2216,0.0,2162.5,-107
28989,2074,2146,0.5,2110.0,-72
28990,2215,2167,1.0,2191.0,48
28991,2169,2007,1.0,2088.0,162
28992,2119,2158,1.0,2138.5,-39
28993,1894,1963,0.0,1928.5,-69
28994,1899,2154,1.0,2026.5,-255
28995,1915,1960,0.0,1937.5,-45
28996,1625,1782,0.0,1703.5,-157
28997,2115,1852,1.0,1983.5,263
28998,2063,1880,1.0,1971.5,183
28999,1918,2032,1.0,1975.0,-114
29000,2176,1855,1.0,2015.5,321
29001,1880,2076,1.0,1978.0,-196
29002,1766,1853,0.0,1809.5,-87
29003,1692,1726,1.0,1709.0,-34
29004,2261,2315,0.5,2288.0,-54
29005,2276,2251,0.0,2263.5,25
29006,2096,2274,0.0,2185.0,-178
29007,2208,2094,0.0,2151.0,114
29008,2354,2257,0.5,2305.5,97
29009,2248,2142,0.5,2195.0,106
29010,2026,2196,1.0,2111.0,-170
29011,2203,2123,1.0,2163.0,80
29012,1979,2129,0.5,2054.0,-150
29013,1933,2027,0.0,1980.0,-94
29014,2082,1868,1.0,1975.0,214
29015,2104,2012,0.0,2058.0,92
29016,1606,2095,1.0,1850.5,-489
29017,1943,1567,1.0,1755.0,376
29018,1781,1787,0.0,1784.0,-6
29019,2192,2234,1.0,2213.0,-42
29020,2131,1900,0.0,2015.5,231
29021,2030,2018,0.0,2024.0,12
29022,2254,1861,1.0,2057.5,393
29023,1986,2013,0.0,1999.5,-27
29024,2153,2096,1.0,2124.5,57
29025,1717,1812,0.0,1764.5,-95
29026,2128,2259,1.0,2193.5,-131
29027,1993,2034,1.0,2013.5,-41
29028,2116,2199,1.0,2157.5,-83
29029,1879,2037,0.0,1958.0,-158
29030,1793,2060,0.0,1926.5,-267
29031,1723,1877,1.0,1800.0,-154
29032,1768,1870,1.0,1819.0,-102
29033,1561,1800,0.5,1680.5,-239
29034,1663,1713,0.0,1688.0,-50
29035,1932,2050,1.0,1991.0,-118
29036,1685,1736,1.0,1710.5,-51
29037,2060,1914,1.0,1987.0,146
29038,2128,1668,1.0,1898.0,460
29039,2024,2036,0.0,2030.0,-12
29040,1963,2000,1.0,1981.5,-37
29041,1878,1912,0.5,1895.0,-34
29042,1760,1956,0.0,1858.0,-196
29043,1930,2003,1.0,1966.5,-73
29044,1988,1972,1.0,1980.0,16
29045,1675,2340,0.0,2007.5,-665
29046,2336,1908,1.0,2122.0,428
29047,1841,2334,1.0,2087.5,-493
29048,2259,1977,1.0,2118.0,282
29049,1692,1758,0.5,1725.0,-66
29050,1850,2049,0.5,1949.5,-199
29051,1971,1732,0.5,1851.5,239
29052,1662,1976,1.0,1819.0,-314
29053,1798,1924,0.0,1861.0,-126
29054,1861,1677,1.0,1769.0,184
29055,1610,1889,0.5,1749.5,-279
29056,1676,1730,0.0,1703.0,-54
29057,1995,2054,0.0,2024.5,-59
29058,2011,1939,1.0,1975.0,72
29059,1678,1712,0.0,1695.0,-34
29060,1750,1768,0.0,1759.0,-18
29061,2205,1966,1.0,2085.5,239
29062,1909,1576,1.0,1742.5,333
29063,1952,1940,0.5,1946.0,12
29064,1785,1560,1.0,1672.5,225
29065,1592,1615,0.0,1603.5,-23
29066,2388,2354,0.0,2371.0,34
29067,2339,2269,0.5,2304.0,70
29068,2229,2192,0.0,2210.5,37
29069,2209,2134,0.5,2171.5,75
29070,2398,2396,0.0,2397.0,2
29071,2239,2402,1.0,2320.5,-163
29072,2322,2227,0.0,2274.5,95
29073,2127,2283,0.0,2205.0,-156
29074,2769,2808,0.5,2788.5,-39
29075,2789,2808,0.5,2798.5,-19
29076,2740,2782,0.0,2761.0,-42
29077,2674,2754,0.0,2714.0,-80
29078,2665,2709,1.0,2687.0,-44
29079,2693,2609,1.0,2651.0,84
29080,2601,2675,0.0,2638.0,-74
29081,2647,2575,1.0,2611.0,72
29082,2738,2752,0.5,2745.0,-14
29083,2671,2665,0.5,2668.0,6
29084,2635,2669,0.5,2652.0,-34
29085,2640,2666,1.0,2653.0,-26
29086,2761,2673,0.5,2717.0,88
29087,2651,2722,0.5,2686.5,-71
29088,2666,2628,0.5,2647.0,38
29089,2476,2688,0.0,2582.0,-212
29090,2583,2566,0.5,2574.5,17
29091,2566,2543,0.5,2554.5,23
29092,2568,2478,0.5,2523.0,90
29093,2463,2459,0.5,2461.0,4
29094,2631,2602,1.0,2616.5,29
29095,2622,2601,1.0,2611.5,21
29096,2555,2558,0.0,2556.5,-3
29097,2562,2565,0.0,2563.5,-3
29098,2857,2638,1.0,2747.5,219
29099,2609,2651,1.0,2630.0,-42
29100,2570,2499,1.0,2534.5,71
29101,2519,2537,0.0,2528.0,-18
29102,2675,2723,0.5,2699.0,-48
29103,2633,2617,0.5,2625.0,16
29104,2512,2435,0.5,2473.5,77
29105,2448,2582,0.5,2515.0,-134
29106,2755,2720,0.5,2737.5,35
29107,2623,2611,0.0,2617.0,12
29108,2640,2636,1.0,2638.0,4
29109,2581,2592,1.0,2586.5,-11
29110,2753,2752,0.5,2752.5,1
29111,2640,2725,0.5,2682.5,-85
29112,2746,2684,0.0,2715.0,62
29113,2585,2717,0.5,2651.0,-132
29114,2742,2736,0.5,2739.0,6
29115,2675,2651,0.0,2663.0,24
29116,2540,2646,0.5,2593.0,-106
29117,2681,2519,0.5,2600.0,162
29118,2554,2637,0.0,2595.5,-83
29119,2444,2546,0.0,2495.0,-102
29120,2508,2439,1.0,2473.5,69
29121,2233,2444,0.0,2338.5,-211
29122,2635,2618,0.5,2626.5,17
29123,2595,2652,0.5,2623.5,-57
29124,2616,2572,0.5,2594.0,44
29125,2554,2565,0.0,2559.5,-11
29126,2580,2612,0.5,2596.0,-32
29127,2552,2468,0.5,2510.0,84
29128,2447,2625,0.0,2536.0,-178
29129,2577,2354,1.0,2465.5,223
29130,2652,2590,1.0,2621.0,62
29131,2606,2591,1.0,2598.5,15
29132,2561,2595,1.0,2578.0,-34
29133,2536,2547,0.5,2541.5,-11
29134,2618,2648,0.5,2633.0,-30
29135,2584,2641,1.0,2612.5,-57
29136,2470,2543,0.0,2506.5,-73
29137,2437,2496,1.0,2466.5,-59
29138,2650,2490,1.0,2570.0,160
29139,2489,2662,0.0,2575.5,-173
29140,2548,2465,1.0,2506.5,83
29141,2427,2459,0.0,2443.0,-32
29142,2716,2560,1.0,2638.0,156
29143,2447,2662,1.0,2554.5,-215
29144,2630,2455,1.0,2542.5,175
29145,2408,2566,0.5,2487.0,-158
29146,2548,2574,0.5,2561.0,-26
29147,2545,2499,1.0,2522.0,46
29148,2484,2442,0.5,2463.0,42
29149,2430,2464,0.5,2447.0,-34
29150,2813,2687,1.0,2750.0,126
29151,2654,2635,0.5,2644.5,19
29152,2664,2626,1.0,2645.0,38
29153,2618,2623,0.5,2620.5,-5
29154,2650,2511,0.5,2580.5,139
29155,2458,2436,0.5,2447.0,22
29156,2434,2444,0.5,2439.0,-10
29157,2413,2245,1.0,2329.0,168
29158,2595,2446,0.5,2520.5,149
29159,2492,2535,0.0,2513.5,-43
29160,2526,2444,1.0,2485.0,82
29161,2402,2522,0.0,2462.0,-120
29162,2687,2668,1.0,2677.5,19
29163,2608,2619,0.5,2613.5,-11
29164,2630,2622,1.0,2626.0,8
29165,2584,2605,0.5,2594.5,-21
29166,2396,2697,0.0,2546.5,-301
29167,2573,2239,1.0,2406.0,334
29168,2227,2430,0.0,2328.5,-203
29169,2478,2122,0.5,2300.0,356
29170,2405,2696,0.0,2550.5,-291
29171,2583,2363,1.0,2473.0,220
29172,2187,2450,0.0,2318.5,-263
29173,2431,2114,1.0,2272.5,317
29174,2545,2493,1.0,2519.0,52
29175,2280,2523,0.5,2401.5,-243
29176,2516,2340,0.0,2428.0,176
29177,2241,2491,0.0,2366.0,-250
29178,2513,2269,1.0,2391.0,244
29179,2166,2594,0.0,2380.0,-428
29180,2542,2099,1.0,2320.5,443
29181,2016,2476,0.0,2246.0,-460
29182,2634,2585,1.0,2609.5,49
29183,2518,2616,0.5,2567.0,-98
29184,2523,2548,0.5,2535.5,-25
29185,2458,2499,0.5,2478.5,-41
29186,2583,2546,0.0,2564.5,37
29187,2345,2505,0.5,2425.0,-160
29188,2460,2239,1.0,2349.5,221
29189,2187,2432,1.0,2309.5,-245
29190,2555,2120,1.0,2337.5,435
29191,2015,2475,0.0,2245.0,-460
29192,2445,2052,1.0,2248.5,393
29193,2107,2459,0.0,2283.0,-352
29194,2475,2473,0.5,2474.0,2
29195,2501,2329,1.0,2415.0,172
29196,2374,2368,0.5,2371.0,6
29197,2283,2348,0.0,2315.5,-65
29198,2556,2534,0.5,2545.0,22
29199,2482,2411,0.5,2446.5,71
29200,2321,2448,0.5,2384.5,-127
29201,2457,2327,1.0,2392.0,130
29202,2451,2531,1.0,2491.0,-80
29203,2513,2441,1.0,2477.0,72
29204,2219,2482,0.0,2350.5,-263
29205,2458,2401,1.0,2429.5,57
29206,2371,2390,0.0,2380.5,-19
29207,2433,2416,0.5,2424.5,17
29208,2350,2350,1.0,2350.0,0
29209,2223,2247,0.5,2235.0,-24
29210,2550,2337,1.0,2443.5,213
29211,2289,2521,0.0,2405.0,-232
29212,2427,2298,1.0,2362.5,129
29213,2189,2418,0.5,2303.5,-229
29214,2558,2485,0.5,2521.5,73
29215,2453,2398,1.0,2425.5,55
29216,2373,2406,0.0,2389.5,-33
29217,2401,2282,0.5,2341.5,119
29218,2565,2455,0.5,2510.0,110
29219,2454,2437,0.5,2445.5,17
29220,2519,2434,0.5,2476.5,85
29221,2393,2434,0.0,2413.5,-41
29222,2488,2453,0.0,2470.5,35
29223,2434,2351,0.5,2392.5,83
29224,2276,2340,0.5,2308.0,-64
29225,2230,2239,0.5,2234.5,-9
29226,2238,2488,0.0,2363.0,-250
29227,2512,1918,1.0,2215.0,594
29228,2025,2413,0.0,2219.0,-388
29229,2439,2111,1.0,2275.0,328
29230,2458,2564,0.5,2511.0,-106
29231,2415,2295,1.0,2355.0,120
29232,2233,2316,0.0,2274.5,-83
29233,2374,2181,1.0,2277.5,193
29234,2487,2251,1.0,2369.0,236
29235,2302,2366,0.5,2334.0,-64
29236,2343,2361,1.0,2352.0,-18
29237,2236,2328,0.0,2282.0,-92
29238,2398,2422,0.5,2410.0,-24
29239,2342,2340,0.0,2341.0,2
29240,2223,2335,0.0,2279.0,-112
29241,2240,2100,0.5,2170.0,140
29242,2348,2436,0.0,2392.0,-88
29243,2212,2175,1.0,2193.5,37
29244,2219,2150,0.0,2184.5,69
29245,2119,2194,0.5,2156.5,-75
29246,2190,2384,0.0,2287.0,-194
29247,2301,2137,0.0,2219.0,164
29248,2100,2232,0.0,2166.0,-132
29249,2173,2202,0.0,2187.5,-29
29250,2484,2628,0.0,2556.0,-144
29251,2377,2503,0.5,2440.0,-126
29252,2432,2291,0.5,2361.5,141
29253,2054,2288,0.0,2171.0,-234
29254,2506,2439,0.5,2472.5,67
29255,2169,2314,0.0,2241.5,-145
29256,2255,2058,0.5,2156.5,197
29257,2060,2308,0.0,2184.0,-248
29258,2339,2661,0.0,2500.0,-322
29259,2603,2215,1.0,2409.0,388
29260,2126,2431,0.0,2278.5,-305
29261,2419,1904,1.0,2161.5,515
29262,2348,2482,0.0,2415.0,-134
29263,2503,2312,0.0,2407.5,191
29264,2341,2142,1.0,2241.5,199
29265,2153,2217,1.0,2185.0,-64
29266,2406,2320,0.5,2363.0,86
29267,2273,2294,0.0,2283.5,-21
29268,2331,2326,0.0,2328.5,5
29269,2259,2323,0.0,2291.0,-64
29270,2170,2407,1.0,2288.5,-237
29271,2289,1997,0.0,2143.0,292
29272,2009,2148,1.0,2078.5,-139
29273,2031,1842,0.5,1936.5,189
29274,2305,2060,1.0,2182.5,245
29275,2058,2285,0.5,2171.5,-227
29276,2077,2065,0.0,2071.0,12
29277,2172,2027,0.5,2099.5,145
29278,2116,2245,0.0,2180.5,-129
29279,2253,2000,1.0,2126.5,253
29280,1956,2294,0.0,2125.0,-338
29281,2373,2056,1.0,2214.5,317
29282,2391,1606,1.0,1998.5,785
29283,1567,2481,0.5,2024.0,-914
29284,2387,2272,0.5,2329.5,115
29285,2087,1850,1.0,1968.5,237
29286,1655,2293,0.0,1974.0,-638
29287,2168,2097,0.5,2132.5,71
29288,2069,2004,1.0,2036.5,65
29289,2334,1624,1.0,1979.0,710
29290,2166,2215,0.0,2190.5,-49
29291,2018,2111,0.5,2064.5,-93
29292,2119,2158,0.0,2138.5,-39
29293,2042,2343,0.0,2192.5,-301
29294,2053,2297,0.5,2175.0,-244
29295,2082,2027,1.0,2054.5,55
29296,2023,2092,0.0,2057.5,-69
29297,1855,2012,0.0,1933.5,-157
29298,1900,2192,1.0,2046.0,-292
29299,1853,1880,0.0,1866.5,-27
29300,1861,1890,0.5,1875.5,-29
29301,2261,1692,0.0,1976.5,569
29302,2269,2388,1.0,2328.5,-119
29303,2094,2251,1.0,2172.5,-157
29304,2175,2134,1.0,2154.5,41
29305,2199,2025,0.5,2112.0,174
29306,2260,2354,0.5,2307.0,-94
29307,2183,2216,1.0,2199.5,-33
29308,2123,2026,1.0,2074.5,97
29309,2216,2167,0.0,2191.5,49
29310,2204,2070,0.5,2137.0,134
29311,1991,1970,1.0,1980.5,21
29312,1612,1831,0.0,1721.5,-219
29313,2050,2183,0.0,2116.5,-133
29314,2128,1932,1.0,2030.0,196
29315,2044,2116,0.0,2080.0,-72
29316,2060,2060,0.0,2060.0,0
29317,2115,2164,0.0,2139.5,-49
29318,2034,1880,0.5,1957.0,154
29319,1918,2164,0.5,2041.0,-246
29320,2145,1951,1.0,2048.0,194
29321,1970,2119,0.5,2044.5,-149
29322,1929,1914,1.0,1921.5,15
29323,1889,2150,0.0,2019.5,-261
29324,2254,2128,1.0,2191.0,126
29325,1963,2096,0.0,2029.5,-133
29326,2153,1956,1.0,2054.5,197
29327,1857,2259,0.0,2058.0,-402
29328,2238,1796,1.0,2017.0,442
29329,1852,2161,0.0,2006.5,-309
29330,2146,2063,0.0,2104.5,83
29331,2032,2074,0.0,2053.0,-42
29332,2257,1923,1.0,2090.0,334
29333,1723,2248,0.0,1985.5,-525
29334,2203,1800,1.0,2001.5,403
29335,1561,1992,0.5,1776.5,-431
29336,2003,1825,0.5,1914.0,178
29337,1867,1930,0.0,1898.5,-63
29338,1972,1987,0.5,1979.5,-15
29339,1869,1988,0.0,1928.5,-119
29340,2318,2172,1.0,2245.0,146
29341,2151,2239,1.0,2195.0,-88
29342,2174,2068,0.0,2121.0,106
29343,2057,2114,1.0,2085.5,-57
29344,2340,1992,1.0,2166.0,348
29345,2044,2336,0.0,2190.0,-292
29346,2334,1911,0.5,2122.5,423
29347,1840,2259,1.0,2049.5,-419
29348,2234,1924,0.5,2079.0,310
29349,1861,2131,0.5,1996.0,-270
29350,1879,1670,1.0,1774.5,209
29351,1960,2176,0.0,2068.0,-216
29352,2076,1915,1.0,1995.5,161
29353,1782,1766,1.0,1774.0,16
29354,1726,1671,1.0,1698.5,55
29355,2315,1758,1.0,2036.5,557
29356,1850,2276,0.0,2063.0,-426
29357,2274,1782,1.0,2028.0,492
29358,1662,2208,0.0,1935.0,-546
29359,2129,2054,1.0,2091.5,75
29360,1944,1933,1.0,1938.5,11
29361,2011,1868,0.0,1939.5,143
29362,2095,2169,0.0,2132.0,-74
29363,1994,1943,1.0,1968.5,51
29364,1787,1963,0.0,1875.0,-176
29365,1894,1781,1.0,1837.5,113
29366,1712,2014,0.0,1863.0,-302
29367,1966,1750,1.0,1858.0,216
29368,1768,1909,0.0,1838.5,-141
29369,1785,1651,0.0,1718.0,134
29370,2034,2013,0.0,2023.5,21
29371,1986,1993,0.5,1989.5,-7
29372,2082,1812,1.0,1947.0,270
29373,1656,1879,0.5,1767.5,-223
29374,1760,1754,1.0,1757.0,6
29375,1736,1685,0.0,1710.5,51
29376,1516,1793,1.0,1654.5,-277
29377,1870,1592,0.5,1731.0,278
29378,1615,1713,0.0,1664.0,-98
29379,1322,1447,0.5,1384.5,-125
29380,2036,1964,0.5,2000.0,72
29381,1675,2024,0.5,1849.5,-349
29382,1912,1841,0.0,1876.5,71
29383,1977,1878,0.5,1927.5,99
29384,1692,1995,0.0,1843.5,-303
29385,1851,2049,0.5,1950.0,-198
29386,1971,1939,0.5,1955.0,32
29387,1678,1976,0.0,1827.0,-298
29388,1610,1677,1.0,1643.5,-67
29389,1730,2205,0.0,1967.5,-475
29390,1576,1952,0.0,1764.0,-376
29391,2034,2354,0.0,2194.0,-320
29392,2339,2071,1.0,2205.0,268
29393,2013,2192,1.0,2102.5,-179
29394,2272,2017,1.0,2144.5,255
29395,2285,2398,1.0,2341.5,-113
29396,2402,2248,0.0,2325.0,154
29397,2235,2347,1.0,2291.0,-112
29398,2283,1909,1.0,2096.0,374
29399,2739,2752,0.5,2745.5,-13
29400,2671,2709,0.5,2690.0,-38
29401,2693,2669,0.5,2681.0,24
29402,2640,2675,0.0,2657.5,-35
29403,2808,2857,0.5,2832.5,-49
29404,2651,2789,0.0,2720.0,-138
29405,2782,2570,0.5,2676.0,212
29406,2537,2679,0.0,2608.0,-142
29407,2566,2738,0.5,2652.0,-172
29408,2665,2566,0.5,2615.5,99
29409,2478,2671,1.0,2574.5,-193
29410,2635,2463,1.0,2549.0,172
29411,2761,2769,0.5,2765.0,-8
29412,2808,2722,1.0,2765.0,86
29413,2666,2731,0.5,2698.5,-65
29414,2754,2696,1.0,2725.0,58
29415,2673,2602,1.0,2637.5,71
29416,2622,2651,0.5,2636.5,-29
29417,2628,2558,0.5,2593.0,70
29418,2526,2476,1.0,2501.0,50
29419,2755,2742,0.5,2748.5,13
29420,2651,2611,1.0,2631.0,40
29421,2674,2591,0.5,2632.5,83
29422,2519,2640,0.5,2579.5,-121
29423,2752,2665,0.0,2708.5,87
29424,2609,2640,1.0,2624.5,-31
29425,2684,2575,1.0,2629.5,109
29426,2497,2614,0.5,2555.5,-117
29427,2583,2554,1.0,2568.5,29
29428,2546,2567,1.0,2556.5,-21
29429,2568,2508,0.5,2538.0,60
29430,2439,2459,0.5,2449.0,-20
29431,2631,2635,0.5,2633.0,-4
29432,2652,2571,0.5,2611.5,81
29433,2555,2616,0.5,2585.5,-61
29434,2565,2565,0.5,2565.0,0
29435,2675,2595,0.5,2635.0,80
29436,2535,2617,0.0,2576.0,-82
29437,2582,2526,1.0,2554.0,56
29438,2515,2430,0.0,2472.5,85
29439,2723,2612,1.0,2667.5,111
29440,2552,2633,0.5,2592.5,-81
29441,2448,2625,0.5,2536.5,-177
29442,2577,2486,0.5,2531.5,91
29443,2648,2650,0.5,2649.0,-2
29444,2662,2584,0.5,2623.0,78
29445,2543,2548,1.0,2545.5,-5
29446,2459,2489,0.0,2474.0,-30
29447,2813,2652,0.5,2732.5,161
29448,2599,2617,1.0,2608.0,-18
29449,2664,2561,1.0,2612.5,103
29450,2547,2623,0.5,2585.0,-76
29451,2697,2716,0.5,2706.5,-19
29452,2662,2573,0.5,2617.5,89
29453,2448,2630,0.5,2539.0,-182
29454,2566,2478,1.0,2522.0,88
29455,2511,2574,0.5,2542.5,-63
29456,2547,2444,0.5,2495.5,103
29457,2413,2545,1.0,2479.0,-132
29458,2442,2379,1.0,2410.5,63
29459,2638,2687,1.0,2662.5,-49
29460,2619,2609,0.0,2614.0,10
29461,2499,2630,0.5,2564.5,-131
29462,2605,2410,1.0,2507.5,195
29463,2546,2737,0.0,2641.5,-191
29464,2753,2345,1.0,2549.0,408
29465,2239,2725,0.0,2482.0,-486
29466,2717,2187,1.0,2452.0,530
29467,2736,2637,1.0,2686.5,99
29468,2444,2675,1.0,2559.5,-231
29469,2646,2345,1.0,2495.5,301
29470,2233,2639,0.0,2436.0,-406
29471,2720,2696,1.0,2708.0,24
29472,2583,2623,0.5,2603.0,-40
29473,2636,2582,0.5,2609.0,54
29474,2450,2581,1.0,2515.5,-131
29475,2550,2604,0.5,2577.0,-54
29476,2513,2513,0.5,2513.0,0
29477,2482,2542,1.0,2512.0,-60
29478,2476,2458,0.0,2467.0,18
29479,2618,2555,0.5,2586.5,63
29480,2559,2595,0.5,2577.0,-36
29481,2524,2475,0.5,2499.5,49
29482,2459,2572,0.5,2515.5,-113
29483,2641,2634,0.5,2637.5,7
29484,2616,2545,1.0,2580.5,71
29485,2523,2509,0.5,2516.0,14
29486,2499,2491,1.0,2495.0,8
29487,2485,2550,0.5,2517.5,-65
29488,2521,2453,1.0,2487.0,68
29489,2406,2427,1.0,2416.5,-21
29490,2418,2401,0.5,2409.5,17
29491,2534,2437,0.0,2485.5,97
29492,2519,2482,1.0,2500.5,37
29493,2448,2434,0.5,2441.0,14
29494,2351,2457,0.5,2404.0,-106
29495,2687,2580,0.5,2633.5,107
29496,2458,2654,0.5,2556.0,-196
29497,2640,2468,1.0,2554.0,172
29498,2354,2618,0.0,2486.0,-264
29499,2606,2560,0.0,2583.0,46
29500,2492,2585,0.0,2538.5,-93
29501,2595,2447,0.0,2521.0,148
29502,2408,2536,0.0,2472.0,-128
29503,2501,2548,0.5,2524.5,-47
29504,2486,2407,0.0,2446.5,79
29505,2368,2484,0.5,2426.0,-116
29506,2464,2283,0.5,2373.5,181
29507,2668,2431,0.5,2549.5,237
29508,2512,2623,1.0,2567.5,-111
29509,2608,2413,1.0,2510.5,195
29510,2439,2584,0.0,2511.5,-145
29511,2650,2371,0.5,2510.5,279
29512,2416,2436,0.0,2426.0,-20
29513,2378,2350,0.5,2364.0,28
29514,2247,2434,0.0,2340.5,-187
29515,2390,2618,0.0,2504.0,-228
29516,2641,2433,1.0,2537.0,208
29517,2350,2496,0.0,2423.0,-146
29518,2318,2127,1.0,2222.5,191
29519,2285,2487,0.5,2386.0,-202
29520,2367,2235,1.0,2301.0,132
29521,2205,2366,1.0,2285.5,-161
29522,2328,1909,1.0,2118.5,419
29523,2490,2453,1.0,2471.5,37
29524,2434,2489,1.0,2461.5,-55
29525,2510,2279,1.0,2394.5,231
29526,2230,2465,0.0,2347.5,-235
29527,2564,2475,1.0,2519.5,89
29528,2329,2415,0.5,2372.0,-86
29529,2316,2374,0.0,2345.0,-58
29530,2267,2374,0.0,2320.5,-107
29531,2446,2396,1.0,2421.0,50
29532,2239,2513,0.0,2376.0,-274
29533,2444,2227,1.0,2335.5,217
29534,2122,2402,0.5,2262.0,-280
29535,2405,2583,0.0,2494.0,-178
29536,2505,2363,0.5,2434.0,142
29537,2200,2460,0.0,2330.0,-260
29538,2432,2114,1.0,2273.0,318
29539,2209,2585,0.0,2397.0,-376
29540,2518,2245,1.0,2381.5,273
29541,2253,2548,0.0,2400.5,-295
29542,2458,2294,0.0,2376.0,164
29543,2451,2506,0.0,2478.5,-55
29544,2314,2441,1.0,2377.5,-127
29545,2219,2255,0.0,2237.0,-36
29546,2308,2401,0.5,2354.5,-93
29547,2120,2280,0.5,2200.0,-160
29548,2340,2020,1.0,2180.0,320
29549,2015,2241,0.5,2128.0,-226
29550,2184,2052,1.0,2118.0,132
29551,2422,1655,1.0,2038.5,767
29552,2097,2342,1.0,2219.5,-245
29553,2240,1715,1.0,1977.5,525
29554,1624,2178,0.5,1901.0,-554
29555,2661,1899,1.0,2280.0,762
29556,2451,2603,1.0,2527.0,-152
29557,2384,2419,1.0,2401.5,-35
29558,1979,2042,0.0,2010.5,-63
29559,2232,2301,1.0,2266.5,-69
29560,2012,2027,0.5,2019.5,-15
29561,2556,2173,1.0,2364.5,383
29562,2137,2373,0.0,2255.0,-236
29563,2321,2411,1.0,2366.0,-90
29564,2202,2100,0.5,2151.0,102
29565,2170,2327,0.5,2248.5,-157
29566,2387,2391,0.5,2389.0,-4
29567,2009,1997,1.0,2003.0,12
29568,2214,2272,1.0,2243.0,-58
29569,1900,1842,0.0,1871.0,58
29570,2223,2340,0.0,2281.5,-117
29571,2030,1890,0.0,1960.0,140
29572,2108,2100,1.0,2104.0,8
29573,2628,1861,1.0,2244.5,767
29574,2401,2558,0.0,2479.5,-157
29575,2310,2377,0.0,2343.5,-67
29576,2282,2373,1.0,2327.5,-91
29577,2337,2291,0.5,2314.0,46
29578,2432,2484,1.0,2458.0,-52
29579,2298,2270,0.0,2284.0,28
29580,2265,2288,1.0,2276.5,-23
29581,2455,2189,1.0,2322.0,266
29582,2111,2334,0.0,2222.5,-223
29583,2434,2454,1.0,2444.0,-20
29584,2343,2018,0.5,2180.5,325
29585,2269,2315,0.5,2292.0,-46
29586,2387,2406,1.0,2396.5,-19
29587,2149,2166,0.5,2157.5,-17
29588,2323,2294,1.0,2308.5,29
29589,2482,2099,0.0,2290.5,383
29590,2351,2488,0.5,2419.5,-137
29591,2142,2503,0.0,2322.5,-361
29592,2239,2276,1.0,2257.5,-37
29593,2269,2153,0.5,2211.0,116
29594,1930,2003,0.5,1966.5,-73
29595,2134,2229,0.0,2181.5,-95
29596,1988,1972,0.0,1980.0,16
29597,2458,2175,0.5,2316.5,283
29598,2312,2348,0.0,2330.0,-36
29599,2295,2328,0.0,2311.5,-33
29600,2341,2309,0.5,2325.0,32
29601,2060,2181,0.5,2120.5,-121
29602,2128,2183,0.0,2155.5,-55
29603,2065,2058,1.0,2061.5,7
29604,2116,2199,0.0,2157.5,-83
29605,2161,1983,1.0,2072.0,178
29606,2096,2254,0.0,2175.0,-158
29607,2302,2251,0.5,2276.5,51
29608,2259,2153,1.0,2206.0,106
29609,2238,2236,0.5,2237.0,2
29610,2034,2099,0.0,2066.5,-65
29611,2161,2117,0.0,2139.0,44
29612,2017,2013,1.0,2015.0,4
29613,2151,2074,0.5,2112.5,77
29614,2057,2068,1.0,2062.5,-11
29615,1917,1831,0.0,1874.0,86
29616,2348,2017,1.0,2182.5,331
29617,1918,2238,0.0,2078.0,-320
29618,2188,2219,1.0,2203.5,-31
29619,2111,1950,0.0,2030.5,161
29620,2257,2194,1.0,2225.5,63
29621,2119,2145,0.0,2132.0,-26
29622,2196,2248,1.0,2222.0,-52
29623,2150,1929,0.0,2039.5,221
29624,2407,2203,1.0,2305.0,204
29625,2092,2297,0.0,2194.5,-205
29626,2148,2289,1.0,2218.5,-141
29627,2023,2036,0.5,2029.5,-13
29628,2439,2031,0.5,2235.0,408
29629,2215,2339,0.0,2277.0,-124
29630,2273,2320,1.0,2296.5,-47
29631,2126,2051,1.0,2088.5,75
29632,2129,2326,1.0,2227.5,-197
29633,2109,2216,1.0,2162.5,-107
29634,1868,1944,0.0,1906.0,-76
29635,2167,2183,1.0,2175.0,-16
29636,2439,2104,0.0,2271.5,335
29637,2336,2340,1.0,2338.0,-4
29638,2058,2150,0.0,2104.0,-92
29639,2272,2334,1.0,2303.0,-62
29640,2354,2060,1.0,2207.0,294
29641,2166,2215,0.5,2190.5,-49
29642,2142,2260,0.5,2201.0,-118
29643,2119,2158,0.5,2138.5,-39
29644,2176,2123,1.0,2149.5,53
29645,1880,2115,0.0,1997.5,-235
29646,1766,2076,0.5,1921.0,-310
29647,2293,1726,0.0,2009.5,567
29648,2276,2315,0.5,2295.5,-39
29649,2208,2274,1.0,2241.0,-66
29650,2087,1927,0.0,2007.0,160
29651,1956,2116,0.0,2036.0,-160
29652,1850,1999,0.5,1924.5,-149
29653,2002,2056,0.0,2029.0,-54
29654,2164,2234,1.0,2199.0,-70
29655,1880,1855,0.0,1867.5,25
29656,2034,2190,1.0,2112.0,-156
29657,1692,1853,1.0,1772.5,-161
29658,2169,2261,1.0,2215.0,-92
29659,2251,1994,1.0,2122.5,257
29660,1963,2096,0.5,2029.5,-133
29661,2094,1894,1.0,1994.0,200
29662,1606,2131,0.0,1868.5,-525
29663,2018,1567,0.0,1792.5,451
29664,2014,1879,1.0,1946.5,135
29665,1754,1663,0.0,1708.5,91
29666,1909,1966,1.0,1937.5,-57
29667,1685,1736,0.0,1710.5,-51
29668,2070,1940,0.0,2005.0,130
29669,2000,2128,0.0,2064.0,-128
29670,2047,2204,1.0,2125.5,-157
29671,1857,1956,0.0,1906.5,-99
29672,2044,1970,1.0,2007.0,74
29673,1970,1951,0.5,1960.5,19
29674,1840,1911,1.0,1875.5,-71
29675,1914,1992,0.5,1953.0,-78
29676,1852,1880,1.0,1866.0,-28
29677,2044,1932,1.0,1988.0,112
29678,2032,2063,1.0,2047.5,-31
29679,2060,1914,0.5,1987.0,146
29680,1842,2392,0.0,2117.0,-550
29681,2239,1825,1.0,2032.0,414
29682,1987,2174,0.0,2080.5,-187
29683,2114,1869,0.0,1991.5,245
29684,1877,1964,1.0,1920.5,-87
29685,1675,1723,1.0,1699.0,-48
29686,1800,1908,0.5,1854.0,-108
29687,1841,1561,1.0,1701.0,280
29688,2054,2034,0.5,2044.0,20
29689,1993,2082,0.0,2037.5,-89
29690,1758,1960,0.5,1859.0,-202
29691,1915,1782,0.0,1848.5,133
29692,1732,1782,0.0,1757.0,-50
29693,1671,1662,0.5,1666.5,9
29694,1924,1516,0.0,1720.0,408
29695,1615,1889,0.5,1752.0,-274
29696,1670,1447,1.0,1558.5,223
29697,1301,1676,0.0,1488.5,-375
29698,1793,2095,0.0,1944.0,-302
29699,1943,1870,0.0,1906.5,73
29700,1713,1787,0.0,1750.0,-74
29701,1781,1322,1.0,1551.5,459
29702,2013,1712,1.0,1862.5,301
29703,1768,1986,0.0,1877.0,-218
29704,1812,1798,1.0,1805.0,14
29705,1651,1656,0.0,1653.5,-5
29706,2049,1952,0.5,2000.5,97
29707,1976,1971,1.0,1973.5,5
29708,1995,1560,0.0,1777.5,435
29709,1677,1798,0.0,1737.5,-121
29710,1939,1851,1.0,1895.0,88
29711,1730,1610,1.0,1670.0,120
29712,2036,1760,1.0,1898.0,276
29713,2354,1678,0.0,2016.0,676
29714,2436,2610,1.0,2523.0,-174
29715,2192,2339,0.5,2265.5,-147
29716,2150,2212,0.0,2181.0,-62
29717,2398,2272,1.0,2335.0,126
29718,2208,2305,0.0,2256.5,-97
29719,2347,2322,0.0,2334.5,25
29720,2027,2077,1.0,2052.0,-50
29721,2665,2283,0.5,2474.0,382
29722,2789,2808,0.0,2798.5,-19
29723,2601,2609,0.0,2605.0,-8
29724,2679,2782,1.0,2730.5,-103
29725,2742,2497,0.0,2619.5,245
29726,2709,2739,0.5,2724.0,-30
29727,2591,2651,0.5,2621.0,-60
29728,2647,2693,1.0,2670.0,-46
29729,2752,2540,1.0,2646.0,212
29730,2808,2769,1.0,2788.5,39
29731,2669,2671,0.5,2670.0,-2
29732,2754,2740,0.5,2747.0,14
29733,2738,2640,0.5,2689.0,98
29734,2666,2761,1.0,2713.5,-95
29735,2635,2665,1.0,2650.0,-30
29736,2688,2696,0.0,2692.0,-8
29737,2673,2666,1.0,2669.5,7
29738,2617,2675,1.0,2646.0,-58
29739,2628,2651,0.0,2639.5,-23
29740,2582,2512,1.0,2547.0,70
29741,2857,2404,1.0,2630.5,453
29742,2566,2566,0.5,2566.0,0
29743,2570,2651,1.0,2610.5,-81
29744,2463,2478,0.0,2470.5,-15
29745,2648,2537,0.0,2592.5,111
29746,2543,2583,0.5,2563.0,-40
29747,2543,2584,1.0,2563.5,-41
29748,2459,2568,1.0,2513.5,-109
29749,2602,2489,0.5,2545.5,113
29750,2633,2723,0.5,2678.0,-90
29751,2558,2622,1.0,2590.0,-64
29752,2448,2435,0.0,2441.5,13
29753,2716,2526,1.0,2621.0,190
29754,2601,2631,0.5,2616.0,-30
29755,2630,2662,0.5,2646.0,-32
29756,2565,2571,1.0,2568.0,-6
29757,2554,2580,0.5,2567.0,-26
29758,2609,2638,1.0,2623.5,-29
29759,2508,2546,0.5,2527.0,-38
29760,2519,2499,0.5,2509.0,20
29761,2737,2444,0.5,2590.5,293
29762,2591,2599,0.5,2595.0,-8
29763,2725,2753,1.0,2739.0,-28
29764,2547,2561,1.0,2554.0,-14
29765,2640,2746,0.5,2693.0,-106
29766,2611,2755,0.5,2683.0,-144
29767,2614,2684,1.0,2649.0,-70
29768,2640,2674,0.5,2657.0,-34
29769,2635,2585,0.5,2610.0,50
29770,2437,2565,0.0,2501.0,-128
29771,2616,2652,1.0,2634.0,-36
29772,2351,2519,0.5,2435.0,-168
29773,2574,2565,0.5,2569.5,9
29774,2646,2736,0.5,2691.0,-90
29775,2442,2547,0.5,2494.5,-105
29776,2639,2681,1.0,2660.0,-42
29777,2531,2430,0.0,2480.5,101
29778,2617,2813,1.0,2715.0,-196
29779,2482,2550,0.5,2516.0,-68
29780,2664,2635,0.5,2649.5,29
29781,2634,2458,1.0,2546.0,176
29782,2458,2511,0.5,2484.5,-53
29783,2523,2616,0.5,2569.5,-93
29784,2379,2444,1.0,2411.5,-65
29785,2612,2509,1.0,2560.5,103
29786,2662,2650,0.5,2656.0,12
29787,2625,2552,0.5,2588.5,73
29788,2548,2537,1.0,2542.5,11
29789,2473,2577,0.0,2525.0,-104
29790,2623,2720,1.0,2671.5,-97
29791,2407,2501,0.0,2454.0,-94
29792,2553,2636,1.0,2594.5,-83
29793,2696,2368,0.5,2532.0,328
29794,2626,2687,1.0,2656.5,-61
29795,2582,2583,1.0,2582.5,-1
29796,2618,2640,0.0,2629.0,-22
29797,2687,2450,1.0,2568.5,237
29798,2415,2564,1.0,2489.5,-149
29799,2630,2619,1.0,2624.5,11
29800,2322,2374,1.0,2348.0,-52
29801,2618,2553,1.0,2585.5,65
29802,2535,2595,0.5,2565.0,-60
29803,2496,2641,1.0,2568.5,-145
29804,2515,2522,0.5,2518.5,-7
29805,2618,2318,0.0,2468.0,300
29806,2436,2650,0.0,2543.0,-214
29807,2524,2595,1.0,2559.5,-71
29808,2245,2434,0.5,2339.5,-189
29809,2550,2554,0.0,2552.0,-4
29810,2608,2668,1.0,2638.0,-60
29811,2427,2521,0.0,2474.0,-94
29812,2584,2622,1.0,2603.0,-38
29813,2610,2418,0.5,2514.0,192
29814,2559,2555,1.0,2557.0,4
29815,2212,2436,0.0,2324.0,-224
29816,2459,2475,0.5,2467.0,-16
29817,2487,2119,0.5,2303.0,368
29818,2573,2697,1.0,2635.0,-124
29819,2343,2367,0.5,2355.0,-24
29820,2430,2448,1.0,2439.0,-18
29821,2490,2328,0.0,2409.0,162
29822,2453,2485,1.0,2469.0,-32
29823,2510,2489,0.0,2499.5,21
29824,2401,2406,0.0,2403.5,-5
29825,2604,2465,0.5,2534.5,139
29826,2513,2492,0.5,2502.5,21
29827,2594,2513,1.0,2553.5,81
29828,2402,2444,0.0,2423.0,-42
29829,2637,2542,0.5,2589.5,95
29830,2583,2642,1.0,2612.5,-59
29831,2439,2444,1.0,2441.5,-5
29832,2432,2460,1.0,2446.0,-28
29833,2560,2233,1.0,2396.5,327
29834,2454,2455,0.0,2454.5,-1
29835,2447,2492,1.0,2469.5,-45
29836,2315,2393,0.0,2354.0,-78
29837,2590,2455,0.5,2522.5,135
29838,2545,2641,0.0,2593.0,-96
29839,2585,2606,1.0,2595.5,-21
29840,2491,2516,0.5,2503.5,-25
29841,2422,2536,1.0,2479.0,-114
29842,2517,2534,1.0,2525.5,-17
29843,2240,2335,0.5,2287.5,-95
29844,2457,2448,1.0,2452.5,9
29845,2585,2178,0.5,2381.5,407
29846,2255,2506,0.0,2380.5,-251
29847,2548,2518,1.0,2533.0,30
29848,2345,2308,1.0,2326.5,37
29849,2493,2458,0.0,2475.5,35
29850,2411,2556,0.0,2483.5,-145
29851,2241,2340,0.5,2290.5,-99
29852,2327,2321,0.5,2324.0,6
29853,2384,2184,0.0,2284.0,200
29854,2345,2546,0.5,2445.5,-201
29855,2232,2301,1.0,2266.5,-69
29856,2067,2187,0.0,2127.0,-120
29857,2503,2173,1.0,2338.0,330
29858,2603,2661,0.5,2632.0,-58
29859,2288,2432,0.0,2360.0,-144
29860,2419,2431,0.0,2425.0,-12
29861,2398,2265,0.0,2331.5,133
29862,2387,2406,1.0,2396.5,-19
29863,2100,2340,0.0,2220.0,-240
29864,2323,2294,1.0,2308.5,29
29865,2548,2108,0.0,2328.0,440
29866,2377,2628,0.5,2502.5,-251
29867,2484,2486,1.0,2485.0,-2
29868,2291,2310,0.0,2300.5,-19
29869,2431,2464,1.0,2447.5,-33
29870,2329,2475,0.0,2402.0,-146
29871,2512,2488,0.5,2500.0,24
29872,2348,2374,0.0,2361.0,-26
29873,2580,2413,1.0,2496.5,167
29874,2251,2161,0.5,2206.0,90
29875,2468,2458,1.0,2463.0,10
29876,2361,2302,1.0,2331.5,59
29877,2488,2447,1.0,2467.5,41
29878,2248,2285,0.0,2266.5,-37
29879,2276,2351,0.0,2313.5,-75
29880,2205,2235,0.5,2220.0,-30
29881,2453,2239,0.0,2346.0,214
29882,2433,2390,1.0,2411.5,43
29883,2279,2434,0.0,2356.5,-155
29884,2223,2350,0.0,2286.5,-127
29885,2391,2230,1.0,2310.5,161
29886,2151,2172,0.0,2161.5,-21
29887,2387,2481,1.0,2434.0,-94
29888,2017,2057,0.0,2037.0,-40
29889,2371,2272,0.0,2321.5,99
29890,2363,2405,0.5,2384.0,-42
29891,2247,2350,0.0,2298.5,-103
29892,2187,2200,0.0,2193.5,-13
29893,2396,2177,0.0,2286.5,219
29894,2248,2257,1.0,2252.5,-9
29895,2227,2239,1.0,2233.0,-12
29896,2203,2196,1.0,2199.5,7
29897,2060,2127,0.0,2093.5,-67
29898,2219,2175,1.0,2197.0,44
29899,2065,2058,0.5,2061.5,7
29900,2194,2188,0.0,2191.0,6
29901,2099,1983,0.0,2041.0,116
29902,1997,2170,0.5,2083.5,-173
29903,2071,2034,0.0,2052.5,37
29904,1842,2009,0.5,1925.5,-167
29905,2245,2013,0.0,2129.0,232
29906,2328,2458,0.5,2393.0,-130
29907,2294,2253,1.0,2273.5,41
29908,2181,2233,0.0,2207.0,-52
29909,2120,2373,0.5,2246.5,-253
29910,2229,2388,0.0,2308.5,-159
29911,2015,2020,1.0,2017.5,-5
29912,2175,2134,0.0,2154.5,41
29913,2348,2052,0.0,2200.0,296
29914,2320,2439,0.0,2379.5,-119
29915,2309,2312,0.5,2310.5,-3
29916,2259,2273,1.0,2266.0,-14
29917,2340,2217,1.0,2278.5,123
29918,1979,2042,0.5,2010.5,-63
29919,2259,2336,1.0,2297.5,-77
29920,2082,2027,0.5,2054.5,55
29921,2354,2272,0.5,2313.0,82
29922,2137,2373,0.0,2255.0,-236
29923,2026,2142,0.0,2084.0,-116
29924,2202,2100,0.0,2151.0,102
29925,2164,2123,0.0,2143.5,41
29926,2289,2407,1.0,2348.0,-118
29927,2034,2190,0.5,2112.0,-156
29928,1655,2164,0.0,1909.5,-509
29929,2208,2305,1.0,2256.5,-97
29930,2069,2097,0.5,2083.0,-28
29931,2027,2077,1.0,2052.0,-50
29932,2199,1624,1.0,1911.5,575
29933,1999,2087,0.0,2043.0,-88
29934,2183,2216,0.5,2199.5,-33
29935,2234,1850,0.5,2042.0,384
29936,2261,2167,1.0,2214.0,94
29937,2441,2451,0.5,2446.0,-10
29938,2096,2251,0.5,2173.5,-155
29939,2401,2219,1.0,2310.0,182
29940,2334,2094,1.0,2214.0,240
29941,2149,2166,0.0,2157.5,-17
29942,2018,2111,1.0,2064.5,-93
29943,2016,2099,0.5,2057.5,-83
29944,2315,2343,0.5,2329.0,-28
29945,2289,2337,0.5,2313.0,-48
29946,2274,2276,1.0,2275.0,-2
29947,2189,2270,0.5,2229.5,-81
29948,1899,2208,0.0,2053.5,-309
29949,1900,2192,1.0,2046.0,-292
29950,2030,1890,1.0,1960.0,140
29951,2131,2176,1.0,2153.5,-45
29952,2076,2018,1.0,2047.0,58
29953,1879,1766,1.0,1822.5,113
29954,2254,2070,1.0,2162.0,184
29955,2204,2096,1.0,2150.0,108
29956,2153,2047,1.0,2100.0,106
29957,1970,2259,0.0,2114.5,-289
29958,2183,2216,1.0,2199.5,-33
29959,2116,2199,1.0,2157.5,-83
29960,1917,1991,0.0,1954.0,-74
29961,2318,2060,0.0,2189.0,258
29962,2503,2482,0.0,2492.5,21
29963,2239,2392,0.0,2315.5,-153
29964,2107,2153,0.0,2130.0,-46
29965,2145,2174,0.0,2159.5,-29
29966,2117,2238,1.0,2177.5,-121
29967,1929,2119,1.0,2024.0,-190
29968,2074,2146,1.0,2110.0,-72
29969,1964,1893,0.0,1928.5,71
29970,1918,2238,1.0,2078.0,-320
29971,1908,1675,0.0,1791.5,233
29972,1950,2025,0.0,1987.5,-75
29973,2014,1841,0.5,1927.5,173
29974,2044,1992,0.5,2018.0,52
29975,1909,1966,1.0,1937.5,-57
29976,1880,1911,1.0,1895.5,-31
29977,2166,1785,1.0,1975.5,381
29978,2063,1852,1.0,1957.5,211
29979,2119,2158,1.0,2138.5,-39
29980,2297,2154,1.0,2225.5,143
29981,1880,2115,0.5,1997.5,-235
29982,2036,2053,0.5,2044.5,-17
29983,2000,2023,0.0,2011.5,-23
29984,2169,2007,1.0,2088.0,162
29985,2056,1956,1.0,2006.0,100
29986,1894,1963,0.0,1928.5,-69
29987,1993,2002,1.0,1997.5,-9
29988,1880,1855,0.0,1867.5,25
29989,2037,2082,0.0,2059.5,-45
29990,1692,1853,1.0,1772.5,-161
29991,2013,1879,0.0,1946.0,134
29992,1933,2129,1.0,2031.0,-196
29993,1812,1986,0.0,1899.0,-174
29994,2104,1944,1.0,2024.0,160
29995,2095,1656,0.0,1875.5,439
29996,2168,2293,1.0,2230.5,-125
29997,1787,1943,0.5,1865.0,-156
29998,1927,2004,0.0,1965.5,-77
29999,2339,1781,0.5,2060.0,558
30000,2169,2439,0.5,2304.0,-270
30001,2126,2215,0.0,2170.5,-89
30002,2058,2150,0.5,2104.0,-92
30003,1924,1904,0.0,1914.0,20
30004,1567,1606,1.0,1586.5,-39
30005,1889,1861,0.0,1875.0,28
30006,1663,1676,1.0,1669.5,-13
30007,1915,1960,1.0,1937.5,-45
30008,1736,1754,0.5,1745.0,-18
30009,1671,1782,1.0,1726.5,-111
30010,1877,1923,0.5,1900.0,-46
30011,1971,2049,1.0,2010.0,-78
30012,1561,1800,0.0,1680.5,-239
30013,1842,1976,0.0,1909.0,-134
30014,2024,2036,0.0,2030.0,-12
30015,1867,1825,0.5,1846.0,42
30016,2128,1869,1.0,1998.5,259
30017,1932,2050,1.0,1991.0,-118
30018,1963,2000,0.5,1981.5,-37
30019,2060,2044,1.0,2052.0,16
30020,1951,1956,1.0,1953.5,-5
30021,1850,1758,0.0,1804.0,92
30022,1914,1970,0.5,1942.0,-56
30023,1662,1782,0.0,1722.0,-120
30024,1516,1889,0.0,1702.5,-373
30025,1851,1995,1.0,1923.0,-144
30026,1615,1592,0.0,1603.5,23
30027,1798,1447,0.0,1622.5,351
30028,2011,1610,0.0,1810.5,401
30029,1712,1730,0.0,1721.0,-18
30030,1870,1793,1.0,1831.5,77
30031,1798,1750,0.0,1774.0,48
30032,1322,1713,1.0,1517.5,-391
30033,1678,1651,0.0,1664.5,27
30034,1576,2205,1.0,1890.5,-629
30035,1560,1952,0.0,1756.0,-392
30036,2401,2354,0.0,2377.5,47
30037,2339,2398,0.0,2368.5,-59
30038,2373,2272,1.0,2322.5,101
30039,2209,2282,0.0,2245.5,-73
30040,2003,2402,0.0,2202.5,-399
30041,2322,1930,1.0,2126.0,392
30042,2119,2347,0.5,2233.0,-228
30043,2283,1972,1.0,2127.5,311
30044,2318,2550,0.0,2434.0,-232
30045,2539,2221,1.0,2380.0,318
30046,2260,2457,0.5,2358.5,-197
30047,2416,2207,0.5,2311.5,209
30048,2538,2389,1.0,2463.5,149
30049,2275,2520,0.0,2397.5,-245
30050,2484,2162,0.5,2323.0,322
30051,2126,2452,0.0,2289.0,-326
30052,2408,2394,0.5,2401.0,14
30053,2353,2322,1.0,2337.5,31
30054,2290,2395,0.0,2342.5,-105
30055,2227,2216,0.0,2221.5,11
30056,2295,2474,0.5,2384.5,-179
30057,2383,2361,0.5,2372.0,22
30058,2304,2342,1.0,2323.0,-38
30059,2287,2339,0.0,2313.0,-52
30060,2338,2542,0.5,2440.0,-204
30061,2408,2325,1.0,2366.5,83
30062,2316,2402,1.0,2359.0,-86
30063,2379,2249,0.5,2314.0,130
30064,2658,2389,1.0,2523.5,269
30065,2376,2583,0.5,2479.5,-207
30066,2475,2268,1.0,2371.5,207
30067,2183,2417,0.5,2300.0,-234
30068,2444,2421,0.0,2432.5,23
30069,2298,2366,0.5,2332.0,-68
30070,2449,2189,1.0,2319.0,260
30071,2161,2279,0.0,2220.0,-118
30072,2355,2332,0.5,2343.5,23
30073,2259,2140,0.5,2199.5,119
30074,2273,2079,1.0,2176.0,194
30075,2121,2188,1.0,2154.5,-67
30076,2429,2368,0.5,2398.5,61
30077,2306,2335,0.5,2320.5,-29
30078,2314,2258,0.0,2286.0,56
30079,2231,2308,0.5,2269.5,-77
30080,2467,2444,0.5,2455.5,23
30081,2222,2372,1.0,2297.0,-150
30082,2336,2005,1.0,2170.5,331
30083,1913,2379,0.0,2146.0,-466
30084,2422,2360,0.5,2391.0,62
30085,2271,2369,0.0,2320.0,-98
30086,2277,2255,1.0,2266.0,22
30087,2230,2188,0.0,2209.0,42
30088,2437,2281,1.0,2359.0,156
30089,2276,2429,0.0,2352.5,-153
30090,2409,2269,1.0,2339.0,140
30091,2264,2346,0.0,2305.0,-82
30092,2362,2243,0.5,2302.5,119
30093,2306,2301,0.5,2303.5,5
30094,2232,2241,0.0,2236.5,-9
30095,2178,2235,1.0,2206.5,-57
30096,2402,2522,0.5,2462.0,-120
30097,2486,2150,1.0,2318.0,336
30098,2096,2463,0.0,2279.5,-367
30099,2474,2053,1.0,2263.5,421
30100,2353,2382,1.0,2367.5,-29
30101,2170,2262,0.5,2216.0,-92
30102,1892,2222,0.5,2057.0,-330
30103,2120,1607,1.0,1863.5,513
30104,2159,2136,1.0,2147.5,23
30105,2043,2046,0.5,2044.5,-3
30106,2015,2142,0.0,2078.5,-127
30107,1993,1777,1.0,1885.0,216
30108,2411,2304,1.0,2357.5,107
30109,2219,2383,0.5,2301.0,-164
30110,2268,2234,0.0,2251.0,34
30111,2247,2279,0.5,2263.0,-32
30112,2204,2332,0.5,2268.0,-128
30113,2247,2149,0.5,2198.0,98
30114,2117,2186,1.0,2151.5,-69
30115,2109,1928,1.0,2018.5,181
30116,2324,2230,1.0,2277.0,94
30117,2147,2289,0.0,2218.0,-142
30118,2324,1994,0.5,2159.0,330
30119,1780,2126,0.5,1953.0,-346
30120,2104,2367,1.0,2235.5,-263
30121,2205,2105,0.5,2155.0,100
30122,1954,2092,1.0,2023.0,-138
30123,2064,1883,1.0,1973.5,181
30124,2378,2386,1.0,2382.0,-8
30125,2358,2272,1.0,2315.0,86
30126,2189,2232,0.0,2210.5,-43
30127,2290,2219,0.0,2254.5,71
30128,2181,1584,1.0,1882.5,597
30129,1750,2139,0.0,1944.5,-389
30130,2056,1699,0.5,1877.5,357
30131,1688,2060,1.0,1874.0,-372
30132,2281,2059,1.0,2170.0,222
30133,2043,2128,0.0,2085.5,-85
30134,2119,1918,1.0,2018.5,201
30135,1921,1965,0.0,1943.0,-44
30136,2268,2245,0.0,2256.5,23
30137,2267,2135,1.0,2201.0,132
30138,2093,2201,0.5,2147.0,-108
30139,2185,2030,0.0,2107.5,155
30140,2285,2331,0.5,2308.0,-46
30141,2214,2031,0.0,2122.5,183
30142,2021,2220,0.5,2120.5,-199
30143,2021,2103,0.0,2062.0,-82
30144,2422,2015,1.0,2218.5,407
30145,2073,2391,0.0,2232.0,-318
30146,2228,1735,1.0,1981.5,493
30147,1881,2288,0.0,2084.5,-407
30148,2326,2199,0.5,2262.5,127
30149,2119,2209,0.0,2164.0,-90
30150,2201,2064,1.0,2132.5,137
30151,2000,2194,0.0,2097.0,-194
30152,2129,2279,0.0,2204.0,-150
30153,2176,2002,0.0,2089.0,174
30154,1965,2086,0.5,2025.5,-121
30155,1892,1993,1.0,1942.5,-101
30156,2142,2216,0.0,2179.0,-74
30157,2047,1908,0.0,1977.5,139
30158,1641,1992,0.5,1816.5,-351
30159,1908,1314,1.0,1611.0,594
30160,1808,2276,0.0,2042.0,-468
30161,2205,1766,1.0,1985.5,439
30162,1815,2164,0.0,1989.5,-349
30163,2084,1756,0.5,1920.0,328
30164,2175,1787,1.0,1981.0,388
30165,1876,2113,1.0,1994.5,-237
30166,2028,1942,1.0,1985.0,86
30167,1825,1949,0.0,1887.0,-124
30168,2002,2381,0.5,2191.5,-379
30169,1894,1888,0.5,1891.0,6
30170,1687,1679,0.0,1683.0,8
30171,1643,1631,0.0,1637.0,12
30172,2238,2159,1.0,2198.5,79
30173,1953,2095,0.5,2024.0,-142
30174,2023,1898,1.0,1960.5,125
30175,1844,2009,0.0,1926.5,-165
30176,1993,1547,1.0,1770.0,446
30177,1964,1994,0.0,1979.0,-30
30178,1973,1983,1.0,1978.0,-10
30179,2064,1945,0.5,2004.5,119
30180,1668,2199,0.0,1933.5,-531
30181,1623,1104,1.0,1363.5,519
30182,1704,2223,0.5,1963.5,-519
30183,2127,1961,1.0,2044.0,166
30184,1797,1957,0.0,1877.0,-160
30185,1495,1932,0.0,1713.5,-437
30186,1947,1983,0.5,1965.0,-36
30187,1584,1807,0.0,1695.5,-223
30188,1609,1606,0.0,1607.5,3
30189,2200,2075,0.0,2137.5,125
30190,2046,1910,1.0,1978.0,136
30191,1922,2106,0.0,2014.0,-184
30192,2011,1793,1.0,1902.0,218
30193,2001,2194,0.5,2097.5,-193
30194,2035,1824,0.0,1929.5,211
30195,1728,2062,0.0,1895.0,-334
30196,1994,1703,1.0,1848.5,291
30197,2050,1851,1.0,1950.5,199
30198,1674,1860,0.0,1767.0,-186
30199,1729,1684,1.0,1706.5,45
30200,1725,1576,1.0,1650.5,149
30201,2386,1716,1.0,2051.0,670
30202,1649,2323,0.0,1986.0,-674
30203,2017,1594,1.0,1805.5,423
30204,1574,2133,0.0,1853.5,-559
30205,2149,1897,1.0,2023.0,252
30206,1926,2025,0.5,1975.5,-99
30207,2008,1751,0.5,1879.5,257
30208,1735,1830,0.0,1782.5,-95
30209,2078,1605,1.0,1841.5,473
30210,1535,1789,0.0,1662.0,-254
30211,1791,1679,1.0,1735.0,112
30212,1777,1855,0.5,1816.0,-78
30213,1544,2017,0.5,1780.5,-473
30214,1700,1531,0.5,1615.5,169
30215,1660,1626,0.5,1643.0,34
30216,1948,1574,0.5,1761.0,374
30217,1740,1781,0.5,1760.5,-41
30218,1766,1693,1.0,1729.5,73
30219,1488,1795,0.0,1641.5,-307
30220,1821,2033,0.0,1927.0,-212
30221,2063,1616,0.5,1839.5,447
30222,1605,1886,0.0,1745.5,-281
30223,1695,1474,1.0,1584.5,221
30224,1903,1778,1.0,1840.5,125
30225,1802,1857,1.0,1829.5,-55
30226,1859,1703,1.0,1781.0,156
30227,1638,1833,0.0,1735.5,-195
30228,1515,2092,0.0,1803.5,-577
30229,2027,1460,1.0,1743.5,567
30230,1779,1840,1.0,1809.5,-61
30231,1775,1351,0.5,1563.0,424
30232,1584,1685,1.0,1634.5,-101
30233,1603,1492,1.0,1547.5,111
30234,1935,2023,0.0,1979.0,-88
30235,1971,1783,0.0,1877.0,188
30236,1746,1770,0.5,1758.0,-24
30237,1719,1529,1.0,1624.0,190
30238,1948,1871,0.5,1909.5,77
30239,1689,1786,0.0,1737.5,-97
30240,1654,1659,1.0,1656.5,-5
30241,1563,1565,1.0,1564.0,-2
30242,1736,1759,0.0,1747.5,-23
30243,1662,1476,1.0,1569.0,186
30244,1350,1495,0.5,1422.5,-145
30245,1943,1803,0.5,1873.0,140
30246,1814,1834,1.0,1824.0,-20
30247,1732,1922,1.0,1827.0,-190
30248,1701,1703,0.5,1702.0,-2
30249,1476,1721,0.0,1598.5,-245
30250,1681,1455,1.0,1568.0,226
30251,1339,1392,0.0,1365.5,-53
30252,1276,1276,1.0,1276.0,0
30253,1802,1671,0.5,1736.5,131
30254,1864,1763,0.5,1813.5,101
30255,1794,1625,1.0,1709.5,169
30256,1497,1611,0.0,1554.0,-114
30257,1406,1715,0.0,1560.5,-309
30258,1668,1403,1.0,1535.5,265
30259,1637,1088,0.0,1362.5,549
30260,1613,1632,0.5,1622.5,-19
30261,1563,1585,0.0,1574.0,-22
30262,1622,1559,1.0,1590.5,63
30263,1480,1491,0.5,1485.5,-11
30264,1923,1889,1.0,1906.0,34
30265,1517,1621,0.0,1569.0,-104
30266,1781,1768,1.0,1774.5,13
30267,1868,1696,1.0,1782.0,172
30268,1773,1913,0.5,1843.0,-140
30269,1836,1594,0.5,1715.0,242
30270,1584,1611,0.0,1597.5,-27
30271,1642,1894,0.5,1768.0,-252
30272,1737,1419,1.0,1578.0,318
30273,1312,1617,0.0,1464.5,-305
30274,1483,1291,1.0,1387.0,192
30275,1479,1195,0.0,1337.0,284
30276,1754,1392,1.0,1573.0,362
30277,1072,1783,0.0,1427.5,-711
30278,1685,1059,1.0,1372.0,626
30279,1204,1857,0.0,1530.5,-653
30280,1528,1393,1.0,1460.5,135
30281,1264,1375,0.0,1319.5,-111
30282,1372,1504,1.0,1438.0,-132
30283,1390,1561,0.0,1475.5,-171
30284,1812,1953,0.5,1882.5,-141
30285,1848,1778,1.0,1813.0,70
30286,1699,1915,0.5,1807.0,-216
30287,1809,1621,1.0,1715.0,188
30288,1450,1591,0.0,1520.5,-141
30289,1542,1570,0.0,1556.0,-28
30290,1488,1528,0.0,1508.0,-40
30291,1482,1499,1.0,1490.5,-17
30292,2550,2538,1.0,2544.0,12
30293,2520,2539,0.5,2529.5,-19
30294,2475,2475,0.5,2475.0,0
30295,2452,2457,1.0,2454.5,-5
30296,2394,2583,1.0,2488.5,-189
30297,2522,2353,0.5,2437.5,169
30298,2331,2475,0.5,2403.0,-144
30299,2417,2395,1.0,2406.0,22
30300,2389,2467,0.5,2428.0,-78
30301,2372,2275,0.5,2323.5,97
30302,2162,2336,0.5,2249.0,-174
30303,2355,2065,0.5,2210.0,290
30304,2522,2295,1.0,2408.5,227
30305,2361,2486,0.5,2423.5,-125
30306,2474,2304,0.0,2389.0,170
30307,2302,2419,0.5,2360.5,-117
30308,2437,2338,1.0,2387.5,99
30309,2325,2429,1.0,2377.0,-104
30310,2409,2316,1.0,2362.5,93
30311,2249,2346,0.0,2297.5,-97
30312,2542,2243,1.0,2392.5,299
30313,2306,2408,0.5,2357.0,-102
30314,2402,2241,0.0,2321.5,161
30315,2178,2379,0.0,2278.5,-201
30316,2422,2444,0.0,2433.0,-22
30317,2366,2369,0.5,2367.5,-3
30318,2277,2449,0.0,2363.0,-172
30319,2365,2188,1.0,2276.5,177
30320,2368,2221,1.0,2294.5,147
30321,2260,2306,0.5,2283.0,-46
30322,2258,2161,1.0,2209.5,97
30323,2207,2221,1.0,2214.0,-14
30324,2382,2408,0.5,2395.0,-26
30325,2322,2170,1.0,2246.0,152
30326,2222,2216,0.5,2219.0,6
30327,2054,2120,0.5,2087.0,-66
30328,2245,2474,0.5,2359.5,-229
30329,2383,2267,0.5,2325.0,116
30330,2201,2324,0.0,2262.5,-123
30331,2287,2185,0.5,2236.0,102
30332,2104,2140,0.0,2122.0,-36
30333,2273,2105,1.0,2189.0,168
30334,1954,2188,0.0,2071.0,-234
30335,2085,1941,1.0,2013.0,144
30336,2376,2181,0.5,2278.5,195
30337,2167,2268,1.0,2217.5,-101
30338,2183,2139,1.0,2161.0,44
30339,2056,2001,0.0,2028.5,55
30340,2043,2281,0.0,2162.0,-238
30341,2128,2142,1.0,2135.0,-14
30342,1993,2119,0.0,2056.0,-126
30343,1965,2006,0.0,1985.5,-41
30344,2332,2324,0.5,2328.0,8
30345,2289,2259,1.0,2274.0,30
30346,2079,2324,1.0,2201.5,-245
30347,2223,2121,1.0,2172.0,102
30348,2285,2353,0.5,2319.0,-68
30349,2262,2031,0.5,2146.5,231
30350,2021,1892,1.0,1956.5,129
30351,1883,2103,0.0,1993.0,-220
30352,2238,2429,0.5,2333.5,-191
30353,2335,2095,0.5,2215.0,240
30354,2003,2314,0.5,2158.5,-311
30355,2308,2023,0.0,2165.5,285
30356,2444,2249,1.0,2346.5,195
30357,2411,2222,0.5,2316.5,189
30358,2005,2383,0.0,2194.0,-378
30359,2279,1996,0.0,2137.5,283
30360,2252,2422,0.0,2337.0,-170
30361,2391,2223,0.0,2307.0,168
30362,2127,2288,0.0,2207.5,-161
30363,2147,1957,1.0,2052.0,190
30364,2536,2279,0.0,2407.5,257
30365,2176,2421,0.0,2298.5,-245
30366,2298,2125,0.0,2211.5,173
30367,2086,2161,1.0,2123.5,-75
30368,2515,2332,1.0,2423.5,183
30369,2247,2386,0.0,2316.5,-139
30370,2358,2109,0.5,2233.5,249
30371,2112,2232,0.5,2172.0,-120
30372,2216,2362,0.0,2289.0,-146
30373,2301,2047,1.0,2174.0,254
30374,1992,2256,0.5,2124.0,-264
30375,2235,1908,0.5,2071.5,327
30376,2304,2360,0.5,2332.0,-56
30377,2271,2214,1.0,2242.5,57
30378,2219,2234,0.5,2226.5,-15
30379,2230,2234,0.0,2232.0,-4
30380,2159,2402,0.0,2280.5,-243
30381,1892,2046,0.0,1969.0,-154
30382,2015,2150,0.5,2082.5,-135
30383,2096,1793,1.0,1944.5,303
30384,2315,2204,0.5,2259.5,111
30385,2149,2281,1.0,2215.0,-132
30386,2276,1983,1.0,2129.5,293
30387,2117,2269,0.0,2193.0,-152
30388,2182,2326,0.0,2254.0,-144
30389,2209,2194,1.0,2201.5,15
30390,2035,2201,1.0,2118.0,-166
30391,2194,1994,1.0,2094.0,200
30392,1932,2378,0.0,2155.0,-446
30393,2272,1947,0.5,2109.5,325
30394,1881,2219,0.0,2050.0,-338
30395,2120,1807,0.5,1963.5,313
30396,2199,2276,1.0,2237.5,-77
30397,2205,1667,0.5,1936.0,538
30398,1623,2164,0.5,1893.5,-541
30399,1993,2175,0.5,2084.0,-182
30400,2106,1923,0.5,2014.5,183
30401,1973,2028,1.0,2000.5,-55
30402,1949,1945,1.0,1947.0,4
30403,2369,2050,0.5,2209.5,319
30404,1860,2075,1.0,1967.5,-215
30405,2046,1729,1.0,1887.5,317
30406,1576,2106,0.0,1841.0,-530
30407,2331,2386,0.5,2358.5,-55
30408,2323,2214,0.5,2268.5,109
30409,2133,2017,0.5,2075.0,116
30410,2103,2021,0.0,2062.0,82
30411,2230,2092,1.0,2161.0,138
30412,2027,2147,0.0,2087.0,-120
30413,1994,2019,0.5,2006.5,-25
30414,1840,1784,0.5,1812.0,56
30415,2367,2125,0.0,2246.0,242
30416,1789,2205,0.0,1997.0,-416
30417,2092,1791,0.5,1941.5,301
30418,1855,2064,0.0,1959.5,-209
30419,2268,2002,1.0,2135.0,266
30420,1888,2135,0.0,2011.5,-247
30421,2079,1718,1.0,1898.5,361
30422,1631,2030,0.0,1830.5,-399
30423,2023,2149,0.0,2086.0,-126
30424,2025,1971,1.0,1998.0,54
30425,1770,2008,0.0,1889.0,-238
30426,1825,1719,1.0,1772.0,106
30427,2381,1903,1.0,2142.0,478
30428,1857,1894,0.5,1875.5,-37
30429,1894,1859,0.0,1876.5,35
30430,1833,1679,1.0,1756.0,154
30431,2059,2015,0.0,2037.0,44
30432,2073,2043,0.0,2058.0,30
30433,1918,1735,1.0,1826.5,183
30434,1881,1921,1.0,1901.0,-40
30435,2033,1948,1.0,1990.5,85
30436,1781,2063,1.0,1922.0,-282
30437,1886,1837,1.0,1861.5,49
30438,1766,1695,0.5,1730.5,71
30439,1685,2040,0.0,1862.5,-355
30440,1721,1584,1.0,1652.5,137
30441,1492,1681,0.0,1586.5,-189
30442,1392,1244,1.0,1318.0,148
30443,1851,2017,0.0,1934.0,-166
30444,1577,1674,0.5,1625.5,-97
30445,1684,1626,1.0,1655.0,58
30446,1660,1725,0.0,1692.5,-65
30447,1632,1495,0.5,1563.5,137
30448,1668,1613,1.0,1640.5,55
30449,1559,1584,0.0,1571.5,-25
30450,1606,1555,0.0,1580.5,51
30451,1907,2129,0.0,2018.0,-222
30452,2002,1786,1.0,1894.0,216
30453,1654,1965,0.0,1809.5,-311
30454,1885,1565,1.0,1725.0,320
30455,2142,1910,1.0,2026.0,232
30456,1922,1908,0.5,1915.0,14
30457,1773,1807,1.0,1790.0,-34
30458,1793,1641,0.0,1717.0,152
30459,1964,1777,0.0,1870.5,187
30460,1531,1983,0.0,1757.0,-452
30461,2064,1700,1.0,1882.0,364
30462,2159,1896,1.0,2027.5,263
30463,1824,2001,0.5,1912.5,-177
30464,1898,1953,1.0,1925.5,-55
30465,1703,1728,0.0,1715.5,-25
30466,1787,1844,0.0,1815.5,-57
30467,1868,2048,1.0,1958.0,-180
30468,1942,1876,0.5,1909.0,66
30469,1611,1913,0.0,1762.0,-302
30470,1704,1825,0.0,1764.5,-121
30471,1594,1649,0.0,1621.5,-55
30472,1826,1961,0.0,1893.5,-135
30473,1802,1797,0.0,1799.5,5
30474,1766,1738,0.0,1752.0,28
30475,1794,1763,1.0,1778.5,31
30476,1756,1815,1.0,1785.5,-59
30477,2199,1611,1.0,1905.0,588
30478,1759,1736,0.0,1747.5,23
30479,2064,2035,0.0,2049.5,29
30480,1495,1794,0.0,1644.5,-299
30481,1715,2000,0.5,1857.5,-285
30482,1899,1889,1.0,1894.0,10
30483,1781,1768,1.0,1774.5,13
30484,1803,1668,1.0,1735.5,135
30485,1104,1668,0.0,1386.0,-564
30486,1701,1814,0.5,1757.5,-113
30487,1926,1643,1.0,1784.5,283
30488,1773,1751,1.0,1762.0,22
30489,1778,1735,0.0,1756.5,43
30490,1616,1821,0.5,1718.5,-205
30491,1703,1802,0.0,1752.5,-99
30492,1605,1665,0.5,1635.0,-60
30493,1574,1636,0.0,1605.0,-62
30494,1693,1740,1.0,1716.5,-47
30495,1928,1488,0.0,1708.0,440
30496,1831,1943,1.0,1887.0,-112
30497,1679,1535,0.0,1607.0,144
30498,1703,1732,1.0,1717.5,-29
30499,1812,1783,1.0,1797.5,29
30500,1746,1699,0.0,1722.5,47
30501,1670,1683,1.0,1676.5,-13
30502,1529,1621,0.0,1575.0,-92
30503,1737,1617,1.0,1677.0,120
30504,1483,1490,0.0,1486.5,-7
30505,1775,1515,1.0,1645.0,260
30506,1460,1233,1.0,1346.5,227
30507,1871,1724,1.0,1797.5,147
30508,1637,1689,0.5,1663.0,-52
30509,1659,1585,0.0,1622.0,74
30510,1491,1563,1.0,1527.0,-72
30511,1671,1232,1.0,1451.5,439
30512,1372,1864,0.0,1618.0,-492
30513,1625,1407,1.0,1516.0,218
30514,1561,1497,1.0,1529.0,64
30515,1748,1696,1.0,1722.0,52
30516,1259,1773,0.0,1516.0,-514
30517,1594,1088,1.0,1341.0,506
30518,1741,1621,1.0,1681.0,120
30519,1025,1350,0.0,1187.5,-325
30520,1783,1476,1.0,1629.5,307
30521,1455,1685,0.0,1570.0,-230
30522,1857,1363,1.0,1610.0,494
30523,1339,1528,0.0,1433.5,-189
30524,1591,1022,1.0,1306.5,569
30525,1528,1542,1.0,1535.0,-14
30526,1392,1482,0.0,1437.0,-90
30527,1419,1642,1.0,1530.5,-223
30528,1392,1312,0.0,1352.0,80
30529,1450,1570,0.0,1510.0,-120
30530,1488,1499,0.0,1493.5,-11
30531,1953,1731,1.0,1842.0,222
30532,1584,1848,1.0,1716.0,-264
30533,1915,1699,0.5,1807.0,216
30534,1688,1809,0.0,1748.5,-121
30535,1204,1059,1.0,1131.5,145
30536,1390,1504,0.0,1447.0,-114
30537,2538,1477,0.5,2007.5,1061
30538,2429,2437,0.0,2433.0,-8
30539,2475,2520,0.0,2497.5,-45
30540,2346,2409,0.5,2377.5,-63
30541,2658,2484,0.5,2571.0,174
30542,2539,2550,0.5,2544.5,-11
30543,2475,2583,1.0,2529.0,-108
30544,2457,2475,0.5,2466.0,-18
30545,2444,2417,0.5,2430.5,27
30546,2353,2394,0.0,2373.5,-41
30547,2449,2366,0.5,2407.5,83
30548,2395,2331,0.5,2363.0,64
30549,2295,2365,0.5,2330.0,-70
30550,2408,2542,0.0,2475.0,-134
30551,2304,2361,1.0,2332.5,-57
30552,2379,2402,1.0,2390.5,-23
30553,2368,2339,0.5,2353.5,29
30554,2486,2522,0.5,2504.0,-36
30555,2258,2306,1.0,2282.0,-48
30556,2419,2463,0.5,2441.0,-44
30557,2474,2231,0.0,2352.5,243
30558,2289,2324,0.0,2306.5,-35
30559,2342,2383,1.0,2362.5,-41
30560,2223,2324,1.0,2273.5,-101
30561,2355,2324,0.0,2339.5,31
30562,2031,2285,1.0,2158.0,-254
30563,2273,2140,1.0,2206.5,133
30564,2103,2021,1.0,2062.0,82
30565,2281,2085,0.0,2183.0,196
30566,2372,2467,0.0,2419.5,-95
30567,2065,2128,0.0,2096.5,-63
30568,2355,2379,1.0,2367.0,-24
30569,2408,2119,1.0,2263.5,289
30570,2376,2389,0.5,2382.5,-13
30571,2290,2322,0.5,2306.0,-32
30572,2001,2183,0.0,2092.0,-182
30573,2422,2216,1.0,2319.0,206
30574,2275,2389,1.0,2332.0,-114
30575,2228,2391,1.0,2309.5,-163
30576,2126,2162,0.0,2144.0,-36
30577,2306,2147,1.0,2226.5,159
30578,2221,2318,0.5,2269.5,-97
30579,2178,2241,0.5,2209.5,-63
30580,2161,2260,1.0,2210.5,-99
30581,2378,2051,0.5,2214.5,327
30582,2222,2444,0.5,2333.0,-222
30583,2189,2272,1.0,2230.5,-83
30584,1996,2005,0.5,2000.5,-9
30585,2279,2219,0.0,2249.0,60
30586,2386,2515,0.5,2450.5,-129
30587,2086,2125,0.5,2105.5,-39
30588,2232,2358,1.0,2295.0,-126
30589,2338,1892,1.0,2115.0,446
30590,2369,2422,0.5,2395.5,-53
30591,2316,2325,0.5,2320.5,-9
30592,2156,2277,0.0,2216.5,-121
30593,2326,2249,1.0,2287.5,77
30594,2095,2238,1.0,2166.5,-143
30595,2209,2183,0.5,2196.0,26
30596,2023,2003,0.5,2013.0,20
30597,2362,2194,1.0,2278.0,168
30598,2150,2402,0.0,2276.0,-252
30599,2256,2301,0.0,2278.5,-45
30600,2053,2096,1.0,2074.5,-43
30601,2315,2232,0.5,2273.5,83
30602,2075,2369,1.0,2222.0,-294
30603,2276,2281,0.5,2278.5,-5
30604,2011,2106,0.5,2058.5,-95
30605,2205,2269,1.0,2237.0,-64
30606,2259,2332,1.0,2295.5,-73
30607,2064,2092,0.5,2078.0,-28
30608,2024,2079,0.0,2051.5,-55
30609,2304,1992,0.5,2148.0,312
30610,2222,2382,0.0,2302.0,-160
30611,2234,2219,1.0,2226.5,15
30612,2087,2120,0.0,2103.5,-33
30613,2230,2247,1.0,2238.5,-17
30614,2105,2104,0.5,2104.5,1
30615,1994,2147,0.5,2070.5,-153
30616,1883,1941,0.5,1912.0,-58
30617,2360,1780,0.0,2070.0,580
30618,2267,2245,0.0,2256.0,22
30619,2255,2271,0.5,2263.0,-16
30620,2185,2201,0.0,2193.0,-16
30621,2276,2234,0.0,2255.0,42
30622,2262,2353,1.0,2307.5,-91
30623,2164,2205,1.0,2184.5,-41
30624,1607,1892,0.5,1749.5,-285
30625,2149,2101,1.0,2125.0,48
30626,2106,2175,1.0,2140.5,-69
30627,2008,2025,1.0,2016.5,-17
30628,2028,2113,0.0,2070.5,-85
30629,2136,1830,0.5,1983.0,306
30630,1886,2033,0.5,1959.5,-147
30631,2142,2043,1.0,2092.5,99
30632,1724,1695,0.0,1709.5,29
30633,2199,2006,0.0,2102.5,193
30634,2093,2268,1.0,2180.5,-175
30635,1623,1667,0.0,1645.0,-44
30636,2030,2079,0.5,2054.5,-49
30637,2214,1993,0.5,2103.5,221
30638,1923,2220,1.0,2071.5,-297
30639,2133,1994,1.0,2063.5,139
30640,1973,2021,0.5,1997.0,-48
30641,1903,2429,0.0,2166.0,-526
30642,2314,1857,1.0,2085.5,457
30643,1859,2308,0.0,2083.5,-449
30644,1997,1822,1.0,1909.5,175
30645,2536,2182,1.0,2359.0,354
30646,2194,2421,0.0,2307.5,-227
30647,2298,2035,1.0,2166.5,263
30648,2062,2189,0.5,2125.5,-127
30649,2050,1495,1.0,1772.5,555
30650,1983,1860,0.5,1921.5,123
30651,1576,1668,0.0,1622.0,-92
30652,1584,1561,0.5,1572.5,23
30653,2249,2159,0.5,2204.0,90
30654,2046,2411,0.0,2228.5,-365
30655,2383,1793,1.0,2088.0,590
30656,1777,2268,0.0,2022.5,-491
30657,2204,1932,1.0,2068.0,272
30658,1947,2149,1.0,2048.0,-202
30659,1983,1881,0.0,1932.0,102
30660,1807,1928,1.0,1867.5,-121
30661,2332,1953,1.0,2142.5,379
30662,1898,2247,0.0,2072.5,-349
30663,2186,1844,1.0,2015.0,342
30664,1745,2109,0.0,1927.0,-364
30665,2015,2254,0.0,2134.5,-239
30666,2216,2073,0.5,2144.5,143
30667,1735,1992,0.5,1863.5,-257
30668,1908,1881,0.5,1894.5,27
30669,2043,2048,1.0,2045.5,-5
30670,1868,1918,1.0,1893.0,-50
30671,1953,1913,1.0,1933.0,40
30672,1836,1921,0.5,1878.5,-85
30673,2129,1964,0.0,2046.5,165
30674,1983,2002,0.0,1992.5,-19
30675,1965,2064,1.0,2014.5,-99
30676,1896,1993,0.0,1944.5,-97
30677,2040,2199,0.5,2119.5,-159
30678,2119,1721,1.0,1920.0,398
30679,1681,2035,0.0,1858.0,-354
30680,2000,1392,1.0,1696.0,608
30681,1889,2252,0.0,2070.5,-363
30682,2223,1899,0.5,2061.0,324
30683,1923,2127,0.5,2025.0,-204
30684,2073,1768,0.5,1920.5,305
30685,1716,2142,0.0,1929.0,-426
30686,1908,1649,1.0,1778.5,259
30687,1574,1773,0.0,1673.5,-199
30688,2323,1851,1.0,2087.0,472
30689,1674,2017,0.5,1845.5,-343
30690,2103,1684,0.0,1893.5,419
30691,1725,2133,1.0,1929.0,-408
30692,1731,1831,0.0,1781.0,-100
30693,1834,1584,1.0,1709.0,250
30694,1750,1732,1.0,1741.0,18
30695,1703,1699,0.0,1701.0,4
30696,1808,2381,0.0,2094.5,-573
30697,1894,1738,1.0,1816.0,156
30698,1815,1894,0.0,1854.5,-79
30699,1643,1756,1.0,1699.5,-113
30700,2092,1802,1.0,1947.0,290
30701,1763,2019,0.5,1891.0,-256
30702,1840,1794,1.0,1817.0,46
30703,1096,1779,1.0,1437.5,-683
30704,1685,1897,0.0,1791.0,-212
30705,1751,1584,1.0,1667.5,167
30706,1492,1773,1.0,1632.5,-281
30707,1735,1603,1.0,1669.0,132
30708,2078,2002,0.5,2040.0,76
30709,1888,1789,0.0,1838.5,99
30710,1791,1718,0.5,1754.5,73
30711,1687,1855,0.5,1771.0,-168
30712,1821,1803,1.0,1812.0,18
30713,1814,1616,1.0,1715.0,198
30714,1605,1922,0.0,1763.5,-317
30715,1643,1474,1.0,1558.5,169
30716,1948,1812,1.0,1880.0,136
30717,1778,1781,1.0,1779.5,-3
30718,1837,1670,1.0,1753.5,167
30719,1621,1795,0.0,1708.0,-174
30720,2023,1894,1.0,1958.5,129
30721,1737,1763,0.5,1750.0,-26
30722,1770,1617,1.0,1693.5,153
30723,1490,1719,0.5,1604.5,-229
30724,1515,1783,0.0,1649.0,-268
30725,1685,1460,0.0,1572.5,225
30726,2017,1351,1.0,1684.0,666
30727,1626,1544,1.0,1585.0,82
30728,1632,1660,0.0,1646.0,-28
30729,1864,1671,0.5,1767.5,193
30730,1559,1613,0.0,1586.0,-54
30731,1497,1625,0.0,1561.0,-128
30732,1704,1555,0.5,1629.5,149
30733,1876,1787,0.5,1831.5,89
30734,1826,1961,0.0,1893.5,-135
30735,1825,1942,0.5,1883.5,-117
30736,1592,1797,0.0,1694.5,-205
30737,1403,1715,0.0,1559.0,-312
30738,1824,2001,1.0,1912.5,-177
30739,1668,1728,0.5,1698.0,-60
30740,1777,1668,1.0,1722.5,109
30741,1104,1531,0.0,1317.5,-427
30742,1700,1566,0.5,1633.0,134
30743,2200,1574,1.0,1887.0,626
30744,1632,1910,0.0,1771.0,-278
30745,1922,1740,1.0,1831.0,182
30746,1488,1807,1.0,1647.5,-319
30747,1759,1948,0.0,1853.5,-189
30748,1907,1662,0.5,1784.5,245
30749,1794,1786,1.0,1790.0,8
30750,1565,1495,1.0,1530.0,70
30751,1696,1741,0.0,1718.5,-45
30752,1773,1748,1.0,1760.5,25
30753,1350,1594,0.5,1472.0,-244
30754,1724,1591,0.5,1657.5,133
30755,1542,1585,0.5,1563.5,-43
30756,1563,1528,1.0,1545.5,35
30757,1482,1491,0.5,1486.5,-9
30758,1935,1778,1.0,1856.5,157
30759,1703,1783,1.0,1743.0,-80
30760,1683,1638,0.5,1660.5,45
30761,1636,1529,1.0,1582.5,107
30762,1151,1775,0.0,1463.0,-624
30763,1479,1195,0.0,1337.0,284
30764,1419,1642,1.0,1530.5,-223
30765,1226,1312,1.0,1269.0,-86
30766,1605,1871,0.0,1738.0,-266
30767,1689,1928,1.0,1808.5,-239
30768,1535,1659,0.0,1597.0,-124
30769,1563,1679,0.0,1621.0,-116
30770,1480,1406,1.0,1443.0,74
30771,1088,1517,1.0,1302.5,-429
30772,1476,1025,1.0,1250.5,451
30773,1570,1450,1.0,1510.0,120
30774,1363,1455,0.0,1409.0,-92
30775,1499,1488,1.0,1493.5,11
30776,1375,1339,1.0,1357.0,36
30777,1204,1059,0.0,1131.5,145
30778,1407,1372,0.5,1389.5,35
30779,1022,1561,1.0,1291.5,-539
30780,2181,1953,0.5,2067.0,228
30781,1848,2167,1.0,2007.5,-319
30782,2139,1915,1.0,2027.0,224
30783,1809,2060,0.0,1934.5,-251
30784,1264,1392,0.0,1328.0,-128
30785,1390,1504,0.0,1447.0,-114
30786,2538,1477,0.0,2007.5,1061
30787,2366,2444,0.0,2405.0,-78
30788,2484,2520,0.5,2502.0,-36
30789,2365,2449,1.0,2407.0,-84
30790,2437,2452,0.0,2444.5,-15
30791,2258,2306,0.5,2282.0,-48
30792,2346,2409,1.0,2377.5,-63
30793,2221,2231,0.0,2226.0,-10
30794,2467,2246,0.5,2356.5,221
30795,2539,2550,0.0,2544.5,-11
30796,2336,2372,0.5,2354.0,-36
30797,2416,2475,1.0,2445.5,-59
30798,2658,2379,1.0,2518.5,279
30799,2361,2295,0.0,2328.0,66
30800,2522,2583,0.5,2552.5,-61
30801,2302,2304,0.0,2303.0,-2
30802,2285,2475,0.0,2380.0,-190
30803,2322,2408,1.0,2365.0,-86
30804,2021,2031,0.5,2026.0,-10
30805,2216,2290,0.0,2253.0,-74
30806,2394,2103,0.5,2248.5,291
30807,2325,2338,1.0,2331.5,-13
30808,2331,2353,0.0,2342.0,-22
30809,2249,2316,0.5,2282.5,-67
30810,2383,2227,0.5,2305.0,156
30811,2228,2422,0.0,2325.0,-194
30812,2324,2342,0.0,2333.0,-18
30813,2147,2288,0.5,2217.5,-141
30814,2324,2287,0.0,2305.5,37
30815,2408,2542,0.5,2475.0,-134
30816,2223,2289,0.5,2256.0,-66
30817,2287,2379,0.5,2333.0,-92
30818,2515,2126,1.0,2320.5,389
30819,2075,2369,1.0,2222.0,-294
30820,2358,2386,1.0,2372.0,-28
30821,2011,2046,0.5,2028.5,-35
30822,2522,2232,0.5,2377.0,290
30823,2272,2378,0.5,2325.0,-106
30824,2463,2486,1.0,2474.5,-23
30825,2219,2189,0.0,2204.0,30
30826,2243,2474,1.0,2358.5,-231
30827,2142,2136,1.0,2139.0,6
30828,2178,2241,0.5,2209.5,-63
30829,2006,1993,0.5,1999.5,13
30830,2318,2051,1.0,2184.5,267
30831,2205,2367,1.0,2286.0,-162
30832,2161,2221,1.0,2191.0,-60
30833,1992,2064,0.0,2028.0,-72
30834,2268,2207,0.0,2237.5,61
30835,2140,2355,0.0,2247.5,-215
30836,2093,2135,0.5,2114.0,-42
30837,2188,2273,0.5,2230.5,-85
30838,2353,2030,1.0,2191.5,323
30839,2219,2214,1.0,2216.5,5
30840,1883,2262,0.0,2072.5,-379
30841,2247,2234,1.0,2240.5,13
30842,2281,1607,1.0,1944.0,674
30843,2008,2149,0.0,2078.5,-141
30844,2119,2128,1.0,2123.5,-9
30845,1825,1830,0.0,1827.5,-5
30846,2181,1965,0.0,2073.0,216
30847,2256,2362,1.0,2309.0,-106
30848,2056,2139,0.5,2097.5,-83
30849,2235,2232,1.0,2233.5,3
30850,2389,2060,1.0,2224.5,329
30851,2209,2326,1.0,2267.5,-117
30852,2268,2376,0.5,2322.0,-108
30853,2194,2201,0.0,2197.5,-7
30854,2402,2183,1.0,2292.5,219
30855,2147,2230,0.5,2188.5,-83
30856,2096,1892,0.5,1994.0,204
30857,1780,1994,1.0,1887.0,-214
30858,2238,2053,0.0,2145.5,185
30859,2255,2271,0.0,2263.0,-16
30860,2023,2003,1.0,2013.0,20
30861,2230,2234,1.0,2232.0,-4
30862,2429,2009,1.0,2219.0,420
30863,2162,2275,0.0,2218.5,-113
30864,2314,2335,1.0,2324.5,-21
30865,2065,2126,0.0,2095.5,-61
30866,2252,2308,0.0,2280.0,-56
30867,2421,2536,0.0,2478.5,-115
30868,2127,2223,0.5,2175.0,-96
30869,2161,2189,1.0,2175.0,-28
30870,2444,2073,0.5,2258.5,371
30871,2369,2422,1.0,2395.5,-53
30872,1996,2222,0.0,2109.0,-226
30873,2188,2277,0.5,2232.5,-89
30874,2411,1913,0.5,2162.0,498
30875,2276,2315,0.5,2295.5,-39
30876,2268,2383,0.0,2325.5,-115
30877,2264,2269,0.5,2266.5,-5
30878,2332,2279,1.0,2305.5,53
30879,2047,2254,0.0,2150.5,-207
30880,2186,2247,1.0,2216.5,-61
30881,1908,1992,0.5,1950.0,-84
30882,1947,2109,0.0,2028.0,-162
30883,2125,2279,1.0,2202.0,-154
30884,1807,1881,0.0,1844.0,-74
30885,1892,2086,1.0,1989.0,-194
30886,2002,1609,0.0,1805.5,393
30887,2220,2331,1.0,2275.5,-111
30888,1993,1965,0.5,1979.0,28
30889,2021,2133,0.0,2077.0,-112
30890,2142,1885,0.0,2013.5,257
30891,2043,2059,1.0,2051.0,-16
30892,1773,1908,0.5,1840.5,-135
30893,1921,1953,0.5,1937.0,-32
30894,2119,1641,0.0,1880.0,478
30895,1923,1993,0.0,1958.0,-70
30896,2064,2035,0.0,2049.5,29
30897,1973,1994,0.5,1983.5,-21
30898,1851,2000,0.0,1925.5,-149
30899,2222,2170,1.0,2196.0,52
30900,1684,1674,1.0,1679.0,10
30901,2087,2120,1.0,2103.5,-33
30902,2332,1725,1.0,2028.5,607
30903,2078,2125,0.0,2101.5,-47
30904,2079,2259,0.5,2169.0,-180
30905,1791,1789,1.0,1790.0,2
30906,1495,2121,0.0,1808.0,-626
30907,1667,2199,0.0,1933.0,-532
30908,1668,1983,0.0,1825.5,-315
30909,2033,1584,0.5,1808.5,449
30910,2164,2276,0.5,2220.0,-112
30911,1695,2063,0.0,1879.0,-368
30912,2084,2101,1.0,2092.5,-17
30913,2050,1724,1.0,1887.0,326
30914,1837,1948,0.0,1892.5,-111
30915,1729,1860,1.0,1794.5,-131
30916,1795,1766,1.0,1780.5,29
30917,2104,1576,1.0,1840.0,528
30918,2027,2092,1.0,2059.5,-65
30919,1941,1954,0.0,1947.5,-13
30920,1840,2019,1.0,1929.5,-179
30921,2381,1883,1.0,2132.0,498
30922,1926,1897,0.0,1911.5,29
30923,1679,1894,0.5,1786.5,-215
30924,1735,1751,1.0,1743.0,-16
30925,2175,1643,0.5,1909.0,532
30926,1859,1903,0.0,1881.0,-44
30927,2113,2106,0.5,2109.5,7
30928,1822,1833,0.0,1827.5,-11
30929,1814,1949,0.0,1881.5,-135
30930,1971,2023,0.0,1997.0,-52
30931,1701,1922,1.0,1811.5,-221
30932,1770,1763,0.0,1766.5,7
30933,2048,1643,0.5,1845.5,405
30934,1750,1731,0.5,1740.5,19
30935,1913,1868,1.0,1890.5,45
30936,1688,1699,0.0,1693.5,-11
30937,2015,1611,1.0,1813.0,404
30938,1983,2149,0.0,2066.0,-166
30939,1735,2073,0.5,1904.0,-338
30940,1928,2117,1.0,2022.5,-189
30941,2017,1881,1.0,1949.0,136
30942,1824,2001,0.5,1912.5,-177
30943,1544,1577,0.5,1560.5,-33
30944,1703,1728,1.0,1715.5,-25
30945,1716,1660,0.0,1688.0,56
30946,1983,1964,1.0,1973.5,19
30947,1594,1649,0.0,1621.5,-55
30948,1896,2064,1.0,1980.0,-168
30949,2159,1574,0.5,1866.5,585
30950,1907,1948,1.0,1927.5,-41
30951,2015,2046,1.0,2030.5,-31
30952,1565,1654,0.0,1609.5,-89
30953,1787,1777,0.5,1782.0,10
30954,1864,1671,1.0,1767.5,193
30955,1825,1876,0.0,1850.5,-51
30956,1497,1625,0.0,1561.0,-128
30957,2040,1763,1.0,1901.5,277
30958,1531,1777,0.0,1654.0,-246
30959,1681,1721,0.5,1701.0,-40
30960,2194,1392,1.0,1793.0,802
30961,1773,1696,0.0,1734.5,77
30962,2062,2035,1.0,2048.5,27
30963,1584,1594,0.0,1589.0,-10
30964,1943,1994,0.5,1968.5,-51
30965,1953,2159,1.0,2056.0,-206
30966,1834,1831,0.0,1832.5,3
30967,1745,1844,1.0,1794.5,-99
30968,1899,1732,0.0,1815.5,167
30969,1910,2200,0.0,2055.0,-290
30970,1768,1923,1.0,1845.5,-155
30971,1807,1922,0.5,1864.5,-115
30972,1783,1781,0.0,1782.0,2
30973,1637,1724,1.0,1680.5,-87
30974,1857,1685,1.0,1771.0,172
30975,1563,1585,1.0,1574.0,-22
30976,1802,2386,0.0,2094.0,-584
30977,2323,1794,0.5,2058.5,529
30978,1611,2017,0.0,1814.0,-406
30979,2133,1096,1.0,1614.5,1037
30980,1894,1685,0.0,1789.5,209
30981,1584,1737,0.0,1660.5,-153
30982,1483,1492,1.0,1487.5,-9
30983,1244,1490,1.0,1367.0,-246
30984,1642,1778,0.5,1710.0,-136
30985,1802,1419,1.0,1610.5,383
30986,1226,1703,0.0,1464.5,-477
30987,1636,1291,1.0,1463.5,345
30988,1778,1821,0.5,1799.5,-43
30989,1616,1699,0.5,1657.5,-83
30990,1670,1605,0.0,1637.5,65
30991,1474,1621,1.0,1547.5,-147
30992,2002,1515,1.0,1758.5,487
30993,1460,1888,0.0,1674.0,-428
30994,1351,1631,0.0,1491.0,-280
30995,1738,1808,1.0,1773.0,-70
30996,1479,1815,0.5,1647.0,-336
30997,1591,1632,1.0,1611.5,-41
30998,1613,1542,0.5,1577.5,71
30999,1528,1559,0.5,1543.5,-31
31000,1622,1482,0.0,1552.0,140
31001,1715,1871,1.0,1793.0,-156
31002,1689,1659,0.5,1674.0,30
31003,1563,1668,0.0,1615.5,-105
31004,1704,1570,0.0,1637.0,134
31005,1488,1961,0.0,1724.5,-473
31006,1797,1499,0.5,1648.0,298
31007,1232,1574,1.0,1403.0,-342
31008,1632,1375,0.5,1503.5,257
31009,1372,1693,1.0,1532.5,-321
31010,1488,1561,0.0,1524.5,-73
31011,1668,1741,0.0,1704.5,-73
31012,1350,1476,0.5,1413.0,-126
31013,1754,1736,1.0,1745.0,18
31014,1759,1794,0.0,1776.5,-35
31015,1775,1935,0.0,1855.0,-160
31016,1783,1233,1.0,1508.0,550
31017,1529,1746,1.0,1637.5,-217
31018,1621,1480,0.0,1550.5,141
31019,1025,1517,0.0,1271.0,-492
31020,1406,1022,1.0,1214.0,384
31021,1072,1259,0.0,1165.5,-187
31022,1535,1928,1.0,1731.5,-393
31023,1204,1059,0.0,1131.5,145
31024,1392,1679,0.0,1535.5,-287
31025,1455,1476,1.0,1465.5,-21
31026,1392,1363,0.0,1377.5,29
31027,1264,1390,0.0,1327.0,-126
31028,2267,1953,0.5,2110.0,314
31029,1848,2201,0.0,2024.5,-353
31030,2185,1809,1.0,1997.0,376
31031,1595,2137,0.0,1866.0,-542
31032,2444,2658,0.5,2551.0,-214
31033,2583,2366,1.0,2474.5,217
31034,2449,2475,0.5,2462.0,-26
31035,2417,2365,0.5,2391.0,52
31036,2408,2437,0.0,2422.5,-29
31037,2429,2322,1.0,2375.5,107
31038,2290,2346,0.5,2318.0,-56
31039,2246,2216,1.0,2231.0,30
31040,2338,2538,0.5,2438.0,-200
31041,2520,2325,1.0,2422.5,195
31042,2316,2475,0.5,2395.5,-159
31043,2484,2249,0.5,2366.5,235
31044,2550,2295,1.0,2422.5,255
31045,2361,2539,0.0,2450.0,-178
31046,2457,2304,0.5,2380.5,153
31047,2339,2416,0.0,2377.5,-77
31048,2542,2368,1.0,2455.0,174
31049,2306,2408,1.0,2357.0,-102
31050,2402,2231,1.0,2316.5,171
31051,2221,2379,0.0,2300.0,-158
31052,2467,2515,0.5,2491.0,-48
31053,2358,2372,0.5,2365.0,-14
31054,2336,2232,0.5,2284.0,104
31055,2290,2355,0.5,2322.5,-65
31056,2522,2285,0.5,2403.5,237
31057,2031,2486,0.5,2258.5,-455
31058,2463,2021,1.0,2242.0,442
31059,2103,2474,0.0,2288.5,-371
31060,2318,2474,0.5,2396.0,-156
31061,2383,2260,1.0,2321.5,123
31062,2161,2342,0.5,2251.5,-181
31063,2287,2207,1.0,2247.0,80
31064,2422,2281,0.5,2351.5,141
31065,2128,2391,0.0,2259.5,-263
31066,2288,2119,0.5,2203.5,169
31067,1965,2147,0.5,2056.0,-182
31068,2362,2304,1.0,2333.0,58
31069,2219,2301,0.5,2260.0,-82
31070,2256,2234,0.5,2245.0,22
31071,2247,2235,0.0,2241.0,12
31072,2429,2389,0.5,2409.0,40
31073,2376,2335,0.5,2355.5,41
31074,2314,2268,1.0,2291.0,46
31075,2183,2308,0.5,2245.5,-125
31076,2315,2394,0.5,2354.5,-79
31077,2331,2276,0.5,2303.5,55
31078,2269,2395,0.0,2332.0,-126
31079,2227,2264,0.0,2245.5,-37
31080,2279,2243,0.0,2261.0,36
31081,2306,2125,1.0,2215.5,181
31082,2086,2178,0.0,2132.0,-92
31083,2051,1892,0.5,1971.5,159
31084,2355,2536,0.0,2445.5,-181
31085,2298,2140,1.0,2219.0,158
31086,2273,2189,0.0,2231.0,84
31087,2161,2188,0.5,2174.5,-27
31088,2360,2324,0.0,2342.0,36
31089,2289,2271,0.0,2280.0,18
31090,2234,2324,0.0,2279.0,-90
31091,2223,2230,1.0,2226.5,-7
31092,2059,2230,0.5,2144.5,-171
31093,2147,2043,1.0,2095.0,104
31094,1953,1994,0.5,1973.5,-41
31095,1784,1921,0.0,1852.5,-137
31096,2422,2378,0.5,2400.0,44
31097,2272,2369,0.5,2320.5,-97
31098,2277,2189,0.0,2233.0,88
31099,2120,2156,1.0,2138.0,-36
31100,2402,2332,1.0,2367.0,70
31101,2186,2150,0.0,2168.0,36
31102,2096,2109,1.0,2102.5,-13
31103,2112,2053,0.5,2082.5,59
31104,1993,2135,1.0,2064.0,-142
31105,2093,1994,0.0,2043.5,99
31106,1973,2079,1.0,2026.0,-106
31107,2030,1945,0.0,1987.5,85
31108,2136,2238,0.0,2187.0,-102
31109,2095,2043,1.0,2069.0,52
31110,2142,2003,0.5,2072.5,139
31111,2023,1993,1.0,2008.0,30
31112,2075,2331,0.0,2203.0,-256
31113,2214,2046,1.0,2130.0,168
31114,2106,2220,0.5,2163.0,-114
31115,2133,2011,0.5,2072.0,122
31116,2382,2367,0.5,2374.5,15
31117,2205,2170,0.5,2187.5,35
31118,2222,2092,1.0,2157.0,130
31119,2064,2087,0.0,2075.5,-23
31120,2183,2199,1.0,2191.0,-16
31121,1667,2209,0.0,1938.0,-542
31122,2201,1623,1.0,1912.0,578
31123,1803,2194,0.0,1998.5,-391
31124,2259,2332,1.0,2295.5,-73
31125,1701,1922,0.5,1811.5,-221
31126,2024,2121,1.0,2072.5,-97
31127,2276,1643,1.0,1959.5,633
31128,2167,2181,0.5,2174.0,-14
31129,2101,2205,0.5,2153.0,-104
31130,2060,2056,0.0,2058.0,4
31131,2353,2084,0.0,2218.5,269
31132,2267,2245,0.0,2256.0,22
31133,1892,2262,0.0,2077.0,-370
31134,2137,2185,0.5,2161.0,-48
31135,2149,1883,1.0,2016.0,266
31136,2027,2092,1.0,2059.5,-65
31137,2008,2025,0.5,2016.5,-17
31138,1779,2019,0.0,1899.0,-240
31139,2389,1825,1.0,2107.0,564
31140,1729,2050,0.0,1889.5,-321
31141,2162,2275,1.0,2218.5,-113
31142,1561,1576,0.0,1568.5,-15
31143,2175,2065,0.0,2120.0,110
31144,1894,2381,0.0,2137.5,-487
31145,2113,2106,1.0,2109.5,7
31146,1643,1679,1.0,1661.0,-36
31147,2254,1949,0.0,2101.5,305
31148,2411,2249,0.5,2330.0,162
31149,2047,2216,0.0,2131.5,-169
31150,2279,2383,1.0,2331.0,-104
31151,2159,1908,0.0,2033.5,251
31152,2222,2444,0.5,2333.0,-222
31153,1844,1953,0.0,1898.5,-109
31154,1913,2005,0.5,1959.0,-92
31155,2252,1745,0.0,1998.5,507
31156,2015,2159,0.5,2087.0,-144
31157,2127,2223,1.0,2175.0,-96
31158,1777,1793,0.0,1785.0,-16
31159,1671,1957,0.0,1814.0,-286
31160,2002,2129,0.0,2065.5,-127
31161,1625,1864,0.0,1744.5,-239
31162,1885,1993,1.0,1939.0,-108
31163,1964,1497,1.0,1730.5,467
31164,1674,1851,1.0,1762.5,-177
31165,2064,1983,0.5,2023.5,81
31166,1725,1684,1.0,1704.5,41
31167,2048,1896,0.5,1972.0,152
31168,1773,2142,0.0,1957.5,-369
31169,1913,1868,1.0,1890.5,45
31170,1314,1641,0.0,1477.5,-327
31171,2199,1611,1.0,1905.0,588
31172,2073,2015,0.5,2044.0,58
31173,2035,2119,0.5,2077.0,-84
31174,1881,1735,1.0,1808.0,146
31175,1932,2064,0.5,1998.0,-132
31176,1721,2040,0.0,1880.5,-319
31177,1881,1947,1.0,1914.0,-66
31178,1276,1392,0.0,1334.0,-116
31179,2194,1807,1.0,2000.5,387
31180,1899,1889,1.0,1894.0,10
31181,2062,2035,1.0,2048.5,27
31182,1768,1923,0.0,1845.5,-155
31183,1724,1994,0.0,1859.0,-270
31184,2323,2386,1.0,2354.5,-63
31185,1563,1637,0.0,1600.0,-74
31186,2133,2017,1.0,2075.0,116
31187,1778,1491,1.0,1634.5,287
31188,1668,1983,0.0,1825.5,-315
31189,1638,1802,0.0,1720.0,-164
31190,1606,1584,0.5,1595.0,22
31191,1781,1636,1.0,1708.5,145
31192,2105,2104,1.0,2104.5,1
31193,1766,1837,0.0,1801.5,-71
31194,1883,1954,1.0,1918.5,-71
31195,1897,1795,1.0,1846.0,102
31196,1616,1821,0.5,1718.5,-205
31197,1751,1926,0.5,1838.5,-175
31198,1474,1605,0.5,1539.5,-131
31199,1808,1773,1.0,1790.5,35
31200,1544,1577,1.0,1560.5,-33
31201,1766,1738,1.0,1752.0,28
31202,1660,1626,0.0,1643.0,34
31203,1592,1756,0.0,1674.0,-164
31204,1886,2063,1.0,1974.5,-177
31205,1728,1824,1.0,1776.0,-96
31206,1724,1695,1.0,1709.5,29
31207,2023,1703,0.0,1863.0,320
31208,1718,2002,0.5,1860.0,-284
31209,1763,1971,0.0,1867.0,-208
31210,1631,1687,0.0,1659.0,-56
31211,1903,1719,1.0,1811.0,184
31212,1983,2204,0.0,2093.5,-221
31213,1833,1857,0.0,1845.0,-24
31214,1928,2117,1.0,2022.5,-189
31215,1584,1822,1.0,1703.0,-238
31216,1375,1232,0.0,1303.5,143
31217,1699,1750,0.5,1724.5,-51
31218,1561,1372,0.0,1466.5,189
31219,1948,1688,0.0,1818.0,260
31220,1617,1894,0.5,1755.5,-277
31221,1654,1786,0.5,1720.0,-132
31222,1490,1483,0.0,1486.5,7
31223,1685,1565,0.0,1625.0,120
31224,1834,1943,0.0,1888.5,-109
31225,1492,1584,0.5,1538.0,-92
31226,1703,1732,1.0,1717.5,-29
31227,1696,1603,0.0,1649.5,93
31228,1910,2200,0.5,2055.0,-290
31229,1773,1748,0.0,1760.5,25
31230,1807,1922,0.5,1864.5,-115
31231,1787,1594,0.5,1690.5,193
31232,1857,1685,1.0,1771.0,172
31233,1942,1876,0.5,1909.0,66
31234,1777,1763,0.0,1770.0,14
31235,1649,1716,0.5,1682.5,-67
31236,1700,1531,1.0,1615.5,169
31237,1741,1594,0.5,1667.5,147
31238,1668,1403,1.0,1535.5,265
31239,1736,1476,1.0,1606.0,260
31240,1570,1450,0.0,1510.0,120
31241,1794,1662,1.0,1728.0,132
31242,1499,1488,0.0,1493.5,11
31243,1591,1495,0.0,1543.0,96
31244,1778,1812,1.0,1795.0,-34
31245,1528,1542,0.0,1535.0,-14
31246,1670,1699,0.0,1684.5,-29
31247,1802,1482,1.0,1642.0,320
31248,1611,1763,1.0,1687.0,-152
31249,1935,1096,1.0,1515.5,839
31250,1312,1419,0.0,1365.5,-107
31251,1746,1783,1.0,1764.5,-37
31252,1291,1226,1.0,1258.5,65
31253,1515,1683,0.5,1599.0,-168
31254,1605,1351,0.5,1478.0,254
31255,1535,1928,0.0,1731.5,-393
31256,1088,1679,0.0,1383.5,-591
31257,1632,1704,0.0,1668.0,-72
31258,1961,1613,1.0,1787.0,348
31259,1559,1826,0.5,1692.5,-267
31260,1797,1555,0.5,1676.0,242
31261,1871,1754,1.0,1812.5,117
31262,1659,1689,1.0,1674.0,-30
31263,1574,1563,1.0,1568.5,11
31264,1566,1668,1.0,1617.0,-102
31265,1693,1632,0.0,1662.5,61
31266,1476,1488,0.0,1482.0,-12
31267,1233,1775,0.5,1504.0,-542
31268,1363,1455,1.0,1409.0,-92
31269,1480,1339,1.0,1409.5,141
31270,1517,1621,1.0,1569.0,-104
31271,1022,1025,0.5,1023.5,-3
31272,1504,1390,0.0,1447.0,114
31273,1072,1059,0.0,1065.5,13
31274,1204,1393,0.0,1298.5,-189
31275,1953,2125,0.5,2039.0,-172
31276,2078,1848,1.0,1963.0,230
31277,1915,1791,0.0,1853.0,124
31278,1855,1595,1.0,1725.0,260
31279,2437,2658,0.0,2547.5,-221
31280,2583,2429,0.0,2506.0,154
31281,2409,2522,0.5,2465.5,-113
31282,2475,2346,1.0,2410.5,129
31283,2542,2550,0.5,2546.0,-8
31284,2539,2408,0.5,2473.5,131
31285,2402,2475,1.0,2438.5,-73
31286,2457,2379,1.0,2418.0,78
31287,2538,2522,1.0,2530.0,16
31288,2486,2520,0.0,2503.0,-34
31289,2475,2463,0.5,2469.0,12
31290,2474,2452,1.0,2463.0,22
31291,2361,2326,1.0,2343.5,35
31292,2209,2304,0.0,2256.5,-95
31293,2339,2201,0.0,2270.0,138
31294,2194,2302,0.0,2248.0,-108
31295,2422,2444,1.0,2433.0,-22
31296,2449,2391,0.5,2420.0,58
31297,2228,2365,0.0,2296.5,-137
31298,2279,2288,0.5,2283.5,-9
31299,2362,2467,0.5,2414.5,-105
31300,2372,2301,0.5,2336.5,71
31301,2256,2379,0.5,2317.5,-123
31302,2355,2235,1.0,2295.0,120
31303,2515,2474,0.5,2494.5,41
31304,2383,2386,0.0,2384.5,-3
31305,2358,2342,0.0,2350.0,16
31306,2287,2290,0.0,2288.5,-3
31307,2536,2408,1.0,2472.0,128
31308,2322,2421,0.5,2371.5,-99
31309,2298,2216,0.0,2257.0,82
31310,2054,2189,0.5,2121.5,-135
31311,2331,2243,1.0,2287.0,88
31312,2306,2214,0.5,2260.0,92
31313,2220,2241,0.5,2230.5,-21
31314,2178,2021,0.5,2099.5,157
31315,2378,2429,0.5,2403.5,-51
31316,2335,2272,0.5,2303.5,63
31317,2189,2314,1.0,2251.5,-125
31318,2308,2219,1.0,2263.5,89
31319,2238,2338,0.0,2288.0,-100
31320,2325,2095,0.5,2210.0,230
31321,2003,2316,0.0,2159.5,-313
31322,2249,2023,0.5,2136.0,226
31323,2368,2324,1.0,2346.0,44
31324,2324,2306,0.5,2315.0,18
31325,2258,2223,0.5,2240.5,35
31326,2126,2231,0.5,2178.5,-105
31327,1993,2402,0.5,2197.5,-409
31328,1892,1994,0.0,1943.0,-102
31329,1973,2150,1.0,2061.5,-177
31330,2053,1945,0.0,1999.0,108
31331,2394,2332,0.0,2363.0,62
31332,2259,2353,0.5,2306.0,-94
31333,2331,2079,0.5,2205.0,252
31334,2121,2395,0.0,2258.0,-274
31335,2304,2276,1.0,2290.0,28
31336,2205,2219,0.5,2212.0,-14
31337,2234,2164,1.0,2199.0,70
31338,2084,2247,0.0,2165.5,-163
31339,2389,2281,0.0,2335.0,108
31340,2128,2376,0.0,2252.0,-248
31341,2268,2065,0.5,2166.5,203
31342,1965,2183,1.0,2074.0,-218
31343,2149,2318,0.0,2233.5,-169
31344,2221,2008,1.0,2114.5,213
31345,1830,2161,0.0,1995.5,-331
31346,2207,1825,1.0,2016.0,382
31347,2230,2382,0.5,2306.0,-152
31348,2170,2147,1.0,2158.5,23
31349,1994,2222,0.0,2108.0,-228
31350,2120,1780,0.0,1950.0,340
31351,2285,2315,0.5,2300.0,-30
31352,2281,2031,1.0,2156.0,250
31353,2021,2269,0.0,2145.0,-248
31354,2264,2103,0.5,2183.5,161
31355,2245,2059,1.0,2152.0,186
31356,2043,2201,0.0,2122.0,-158
31357,2185,1953,0.5,2069.0,232
31358,1921,2137,0.0,2029.0,-216
31359,2389,2249,1.0,2319.0,140
31360,2411,2275,0.0,2343.0,136
31361,2162,2268,0.5,2215.0,-106
31362,2279,2065,1.0,2172.0,214
31363,2422,2355,1.0,2388.5,67
31364,2273,2369,0.5,2321.0,-96
31365,2277,2188,0.5,2232.5,89
31366,2085,2188,0.5,2136.5,-103
31367,2381,2444,0.5,2412.5,-63
31368,2222,1894,1.0,2058.0,328
31369,1679,2005,0.5,1842.0,-326
31370,1996,1643,1.0,1819.5,353
31371,2279,2106,1.0,2192.5,173
31372,2113,2125,0.5,2119.0,-12
31373,2086,2028,1.0,2057.0,58
31374,1949,1892,1.0,1920.5,57
31375,2332,2182,1.0,2257.0,150
31376,2194,2247,0.0,2220.5,-53
31377,2186,2062,1.0,2124.0,124
31378,1994,2109,0.0,2051.5,-115
31379,2129,2360,0.0,2244.5,-231
31380,2271,1965,1.0,2118.0,306
31381,1993,2255,0.5,2124.0,-262
31382,2230,1885,1.0,2057.5,345
31383,2136,1932,1.0,2034.0,204
31384,1947,2043,0.0,1995.0,-96
31385,1993,1881,1.0,1937.0,112
31386,1807,2006,0.5,1906.5,-199
31387,2268,2252,1.0,2260.0,16
31388,2223,2135,1.0,2179.0,88
31389,2093,2127,1.0,2110.0,-34
31390,2073,2079,0.0,2076.0,-6
31391,2369,2048,1.0,2208.5,321
31392,1868,2075,0.0,1971.5,-207
31393,2106,1836,1.0,1971.0,270
31394,1611,2011,0.5,1811.0,-400
31395,1851,2353,0.0,2102.0,-502
31396,2262,1674,1.0,1968.0,588
31397,1684,1883,0.0,1783.5,-199
31398,1607,1725,0.0,1666.0,-118
31399,2386,1897,1.0,2141.5,489
31400,1926,2017,0.0,1971.5,-91
31401,2103,1751,1.0,1927.0,352
31402,1735,2133,0.0,1934.0,-398
31403,2367,1778,1.0,2072.5,589
31404,1802,2205,0.0,2003.5,-403
31405,2092,1638,1.0,1865.0,454
31406,1636,1992,0.0,1814.0,-356
31407,2002,2167,0.0,2084.5,-165
31408,2139,1888,1.0,2013.5,251
31409,1718,2056,0.5,1887.0,-338
31410,2060,1687,1.0,1873.5,373
31411,2078,2050,0.5,2064.0,28
31412,1860,1789,0.0,1824.5,71
31413,1791,1729,0.5,1760.0,62
31414,1561,1855,0.5,1708.0,-294
31415,2105,1803,1.0,1954.0,302
31416,1814,1954,1.0,1884.0,-140
31417,1941,1922,0.0,1931.5,19
31418,1701,1883,0.5,1792.0,-182
31419,2199,2199,1.0,2199.0,0
31420,2119,1667,1.0,1893.0,452
31421,1623,2035,1.0,1829.0,-412
31422,2092,1808,1.0,1950.0,284
31423,1766,2027,0.0,1896.5,-261
31424,2019,1815,1.0,1917.0,204
31425,1756,1840,0.5,1798.0,-84
31426,2033,2015,1.0,2024.0,18
31427,2073,2063,0.0,2068.0,10
31428,1886,1735,0.5,1810.5,151
31429,1881,1724,0.0,1802.5,157
31430,2159,1584,1.0,1871.5,575
31431,1750,2046,1.0,1898.0,-296
31432,2015,1699,1.0,1857.0,316
31433,1688,1793,0.0,1740.5,-105
31434,1964,2254,0.0,2109.0,-290
31435,2216,1983,1.0,2099.5,233
31436,2064,2047,0.0,2055.5,17
31437,1992,1896,1.0,1944.0,96
31438,1671,2142,0.0,1906.5,-471
31439,1908,1864,0.5,1886.0,44
31440,1625,1773,1.0,1699.0,-148
31441,1641,1497,1.0,1569.0,144
31442,1943,1889,1.0,1916.0,54
31443,1923,1831,0.0,1877.0,92
31444,1732,1768,1.0,1750.0,-36
31445,1781,1703,1.0,1742.0,78
31446,2159,1736,1.0,1947.5,423
31447,1759,1953,0.0,1856.0,-194
31448,1844,1662,0.0,1753.0,182
31449,1794,1745,0.5,1769.5,49
31450,1910,2040,0.0,1975.0,-130
31451,1721,1922,1.0,1821.5,-201
31452,1807,1681,1.0,1744.0,126
31453,1392,1793,1.0,1592.5,-401
31454,1783,1903,0.5,1843.0,-120
31455,1857,1685,1.0,1771.0,172
31456,1857,1859,0.0,1858.0,-2
31457,2204,1637,1.0,1920.5,567
31458,1585,2149,0.0,1867.0,-564
31459,2117,1563,1.0,1840.0,554
31460,1491,1928,0.0,1709.5,-437
31461,1495,1907,0.0,1701.0,-412
31462,1786,1983,0.5,1884.5,-197
31463,1584,1654,0.5,1619.0,-70
31464,1565,1606,0.0,1585.5,-41
31465,2017,2023,0.5,2020.0,-6
31466,1971,1577,0.0,1774.0,394
31467,1544,1770,0.0,1657.0,-226
31468,1719,1626,0.5,1672.5,93
31469,1812,2001,0.0,1906.5,-189
31470,1824,1778,0.5,1801.0,46
31471,1699,1728,1.0,1713.5,-29
31472,1703,1621,0.5,1662.0,82
31473,1515,1763,0.5,1639.0,-248
31474,1794,1460,0.0,1627.0,334
31475,1096,1611,0.0,1353.5,-515
31476,1948,1351,1.0,1649.5,597
31477,1928,1605,0.0,1766.5,323
31478,1766,1781,1.0,1773.5,-15
31479,1821,1795,0.0,1808.0,26
31480,1649,1716,0.0,1682.5,-67
31481,1605,1616,0.0,1610.5,-11
31482,1894,1474,0.5,1684.0,420
31483,1531,1777,0.0,1654.0,-246
31484,1617,1737,0.0,1677.0,-120
31485,1715,1483,0.0,1599.0,232
31486,1783,1935,1.0,1859.0,-152
31487,1529,1746,1.0,1637.5,-217
31488,1871,1668,0.0,1769.5,203
31489,1748,1696,0.5,1722.0,52
31490,1659,1689,0.0,1674.0,-30
31491,1594,1773,1.0,1683.5,-179
31492,1232,1563,0.0,1397.5,-331
31493,1876,1787,1.0,1831.5,89
31494,1407,1375,0.0,1391.0,32
31495,1825,1942,1.0,1883.5,-117
31496,1704,1561,0.5,1632.5,143
31497,1542,1591,0.0,1566.5,-49
31498,1826,1961,1.0,1893.5,-135
31499,1482,1528,1.0,1505.0,-46
31500,1450,1797,0.5,1623.5,-347
31501,1584,1685,1.0,1634.5,-101
31502,1488,1570,0.0,1529.0,-82
31503,1603,1492,0.5,1547.5,111
31504,1406,1499,0.0,1452.5,-93
31505,1740,1574,0.5,1657.0,166
31506,1488,1693,1.0,1590.5,-205
31507,1479,1088,1.0,1283.5,391
31508,1668,1195,0.0,1431.5,473
31509,1621,1480,0.5,1550.5,141
31510,1642,1517,0.0,1579.5,125
31511,1233,1775,0.0,1504.0,-542
31512,1226,1312,1.0,1269.0,-86
31513,1632,1291,1.0,1461.5,341
31514,1363,1476,0.5,1419.5,-113
31515,1559,1613,1.0,1586.0,-54
31516,1276,1339,0.0,1307.5,-63
31517,1264,1555,0.0,1409.5,-291
31518,1390,1504,0.0,1447.0,-114
31519,1022,1477,0.0,1249.5,-455
31520,1059,1072,0.0,1065.5,-13
31521,1392,1392,0.5,1392.0,0
31522,1741,1953,0.0,1847.0,-212
31523,1848,1915,0.0,1881.5,-67
31524,1809,1476,1.0,1642.5,333
31525,2304,2195,0.5,2249.5,109
31526,2780,2698,0.5,2739.0,82
31527,2752,2781,0.5,2766.5,-29
31528,2735,2772,0.5,2753.5,-37
31529,2603,2861,0.0,2732.0,-258
31530,2663,2679,0.0,2671.0,-16
31531,2627,2802,0.5,2714.5,-175
31532,2769,2720,0.5,2744.5,49
31533,2679,2720,0.5,2699.5,-41
31534,2802,2752,1.0,2777.0,50
31535,2781,2769,0.0,2775.0,12
31536,2861,2627,1.0,2744.0,234
31537,2772,2780,0.5,2776.0,-8
31538,2698,2603,0.0,2650.5,95
31539,2663,2735,0.0,2699.0,-72
31540,2735,2679,1.0,2707.0,56
31541,2780,2663,1.0,2721.5,117
31542,2603,2772,0.5,2687.5,-169
31543,2752,2861,0.5,2806.5,-109
31544,2769,2802,0.0,2785.5,-33
31545,2720,2781,1.0,2750.5,-61
31546,2627,2698,0.5,2662.5,-71
31547,2663,2603,0.0,2633.0,60
31548,2698,2752,0.5,2725.0,-54
31549,2802,2720,0.5,2761.0,82
31550,2861,2769,1.0,2815.0,92
31551,2772,2627,1.0,2699.5,145
31552,2735,2780,0.5,2757.5,-45
31553,2679,2781,1.0,2730.0,-102
31554,2769,2698,0.5,2733.5,71
31555,2780,2679,1.0,2729.5,101
31556,2752,2772,1.0,2762.0,-20
31557,2720,2861,0.5,2790.5,-141
31558,2781,2802,0.5,2791.5,-21
31559,2627,2663,0.5,2645.0,-36
31560,2603,2735,0.5,2669.0,-132
31561,2655,2581,1.0,2618.0,74
31562,2615,2686,1.0,2650.5,-71
31563,2630,2688,0.0,2659.0,-58
31564,2708,2566,1.0,2637.0,142
31565,2572,2621,0.5,2596.5,-49
31566,2600,2556,1.0,2578.0,44
31567,2587,2619,1.0,2603.0,-32
31568,2556,2615,0.0,2585.5,-59
31569,2619,2708,0.5,2663.5,-89
31570,2621,2587,1.0,2604.0,34
31571,2688,2600,0.5,2644.0,88
31572,2581,2566,1.0,2573.5,15
31573,2686,2572,1.0,2629.0,114
31574,2655,2630,0.5,2642.5,25
31575,2566,2619,1.0,2592.5,-53
31576,2587,2686,0.0,2636.5,-99
31577,2600,2655,1.0,2627.5,-55
31578,2708,2621,1.0,2664.5,87
31579,2615,2688,0.5,2651.5,-73
31580,2630,2581,0.5,2605.5,49
31581,2572,2556,0.0,2564.0,16
31582,2556,2587,0.5,2571.5,-31
31583,2630,2600,1.0,2615.0,30
31584,2621,2566,1.0,2593.5,55
31585,2688,2572,0.5,2630.0,116
31586,2686,2708,0.5,2697.0,-22
31587,2655,2615,0.5,2635.0,40
31588,2581,2619,0.0,2600.0,-38
31589,2572,2655,0.5,2613.5,-83
31590,2600,2581,0.5,2590.5,19
31591,2708,2556,1.0,2632.0,152
31592,2619,2621,0.0,2620.0,-2
31593,2587,2688,0.5,2637.5,-101
31594,2566,2686,0.5,2626.0,-120
31595,2615,2630,1.0,2622.5,-15
31596,2321,2445,1.0,2383.0,-124
31597,2450,2508,0.0,2479.0,-58
31598,2516,2572,0.0,2544.0,-56
31599,2400,2402,1.0,2401.0,-2
31600,2492,2617,0.5,2554.5,-125
31601,2521,2579,0.5,2550.0,-58
31602,2543,2295,1.0,2419.0,248
31603,2617,2521,1.0,2569.0,96
31604,2579,2321,0.5,2450.0,258
31605,2402,2445,0.0,2423.5,-43
31606,2508,2492,1.0,2500.0,16
31607,2295,2516,0.0,2405.5,-221
31608,2572,2450,1.0,2511.0,122
31609,2400,2543,1.0,2471.5,-143
31610,2450,2295,0.0,2372.5,155
31611,2492,2572,0.5,2532.0,-80
31612,2321,2617,0.0,2469.0,-296
31613,2445,2579,0.5,2512.0,-134
31614,2543,2402,1.0,2472.5,141
31615,2516,2400,1.0,2458.0,116
31616,2521,2508,0.5,2514.5,13
31617,2508,2321,0.5,2414.5,187
31618,2617,2445,1.0,2531.0,172
31619,2543,2516,1.0,2529.5,27
31620,2572,2521,1.0,2546.5,51
31621,2400,2450,0.5,2425.0,-50
31622,2295,2492,0.0,2393.5,-197
31623,2402,2579,0.0,2490.5,-177
31624,2579,2617,0.5,2598.0,-38
31625,2492,2400,1.0,2446.0,92
31626,2321,2572,0.0,2446.5,-251
31627,2445,2508,0.0,2476.5,-63
31628,2516,2402,0.5,2459.0,114
31629,2450,2543,0.0,2496.5,-93
31630,2521,2295,1.0,2408.0,226
31631,2500,2455,0.0,2477.5,45
31632,2550,2495,0.0,2522.5,55
31633,2455,2475,1.0,2465.0,-20
31634,2535,2495,0.0,2515.0,40
31635,1621,2397,0.0,2009.0,-776
31636,2813,2304,1.0,2558.5,509
31637,2340,2796,0.0,2568.0,-456
31638,2341,2785,0.0,2563.0,-444
31639,2772,2371,1.0,2571.5,401
31640,2434,2772,0.0,2603.0,-338
31641,2764,2470,1.0,2617.0,294
31642,2484,2741,0.5,2612.5,-257
31643,2775,2489,1.0,2632.0,286
31644,2487,2757,0.0,2622.0,-270
31645,2756,2492,1.0,2624.0,264
31646,2500,2747,0.5,2623.5,-247
31647,2746,2500,1.0,2623.0,246
31648,2512,2740,0.5,2626.0,-228
31649,2744,2519,1.0,2631.5,225
31650,2524,2739,1.0,2631.5,-215
31651,2719,2539,1.0,2629.0,180
31652,2556,2737,0.0,2646.5,-181
31653,2731,2534,0.5,2632.5,197
31654,2569,2733,0.5,2651.0,-164
31655,2716,2535,0.5,2625.5,181
31656,2567,2720,0.5,2643.5,-153
31657,2719,2546,1.0,2632.5,173
31658,2551,2723,0.5,2637.0,-172
31659,2715,2561,1.0,2638.0,154
31660,2567,2714,0.0,2640.5,-147
31661,2710,2567,0.5,2638.5,143
31662,2565,2724,0.0,2644.5,-159
31663,2702,2571,1.0,2636.5,131
31664,2574,2709,0.0,2641.5,-135
31665,2707,2584,1.0,2645.5,123
31666,2588,2706,0.5,2647.0,-118
31667,2710,2584,1.0,2647.0,126
31668,2584,2708,0.0,2646.0,-124
31669,2700,2586,0.5,2643.0,114
31670,2578,2706,0.0,2642.0,-128
31671,2702,2607,0.5,2654.5,95
31672,2595,2701,0.5,2648.0,-106
31673,2699,2594,1.0,2646.5,105
31674,2605,2699,0.5,2652.0,-94
31675,2696,2609,0.5,2652.5,87
31676,2609,2696,1.0,2652.5,-87
31677,2696,2607,1.0,2651.5,89
31678,2625,2691,1.0,2658.0,-66
31679,2698,2626,0.5,2662.0,72
31680,2623,2688,1.0,2655.5,-65
31681,2693,2628,0.5,2660.5,65
31682,2644,2680,1.0,2662.0,-36
31683,2693,2632,0.5,2662.5,61
31684,2632,2664,0.5,2648.0,-32
31685,2678,2643,0.0,2660.5,35
31686,2635,2672,0.5,2653.5,-37
31687,2668,2636,0.5,2652.0,32
31688,2624,2669,1.0,2646.5,-45
31689,2667,2660,1.0,2663.5,7
31690,2623,2676,0.5,2649.5,-53
31691,2655,2645,0.5,2650.0,10
31692,2630,2651,0.5,2640.5,-21
31693,2660,2652,0.0,2656.0,8
31694,2634,2660,0.5,2647.0,-26
31695,2659,2654,0.5,2656.5,5
31696,2651,2653,0.5,2652.0,-2
31697,2662,2651,0.5,2656.5,11
31698,2646,2648,0.0,2647.0,-2
31699,2304,2813,0.0,2558.5,-509
31700,2796,2340,0.5,2568.0,456
31701,2785,2784,1.0,2784.5,1
31702,2371,2341,0.5,2356.0,30
31703,2772,2772,1.0,2772.0,0
31704,2470,2434,0.5,2452.0,36
31705,2741,2764,0.5,2752.5,-23
31706,2489,2484,0.5,2486.5,5
31707,2757,2775,1.0,2766.0,-18
31708,2492,2487,0.5,2489.5,5
31709,2747,2756,1.0,2751.5,-9
31710,2500,2500,1.0,2500.0,0
31711,2740,2746,0.5,2743.0,-6
31712,2519,2512,0.5,2515.5,7
31713,2739,2744,1.0,2741.5,-5
31714,2539,2524,0.0,2531.5,15
31715,2737,2719,0.5,2728.0,18
31716,2534,2556,0.0,2545.0,-22
31717,2733,2731,0.5,2732.0,2
31718,2535,2569,0.5,2552.0,-34
31719,2720,2716,0.5,2718.0,4
31720,2546,2567,0.0,2556.5,-21
31721,2723,2719,0.0,2721.0,4
31722,2561,2551,0.5,2556.0,10
31723,2714,2715,1.0,2714.5,-1
31724,2567,2567,0.5,2567.0,0
31725,2724,2710,1.0,2717.0,14
31726,2571,2565,0.0,2568.0,6
31727,2709,2702,0.5,2705.5,7
31728,2584,2574,0.5,2579.0,10
31729,2706,2707,0.5,2706.5,-1
31730,2584,2588,0.5,2586.0,-4
31731,2708,2710,0.5,2709.0,-2
31732,2586,2584,0.5,2585.0,2
31733,2706,2700,1.0,2703.0,6
31734,2607,2578,0.0,2592.5,29
31735,2701,2702,0.5,2701.5,-1
31736,2594,2595,0.0,2594.5,-1
31737,2699,2699,0.5,2699.0,0
31738,2609,2605,0.5,2607.0,4
31739,2696,2696,0.5,2696.0,0
31740,2607,2609,1.0,2608.0,-2
31741,2691,2696,0.5,2693.5,-5
31742,2626,2625,0.5,2625.5,1
31743,2688,2698,0.0,2693.0,-10
31744,2628,2623,0.5,2625.5,5
31745,2680,2693,1.0,2686.5,-13
31746,2632,2644,0.5,2638.0,-12
31747,2664,2693,0.5,2678.5,-29
31748,2643,2632,0.0,2637.5,11
31749,2672,2678,0.5,2675.0,-6
31750,2636,2635,0.5,2635.5,1
31751,2669,2668,0.0,2668.5,1
31752,2660,2624,0.5,2642.0,36
31753,2676,2667,1.0,2671.5,9
31754,2645,2623,0.5,2634.0,22
31755,2651,2655,0.0,2653.0,-4
31756,2652,2630,0.0,2641.0,22
31757,2660,2660,0.5,2660.0,0
31758,2654,2634,0.5,2644.0,20
31759,2653,2659,0.5,2656.0,-6
31760,2651,2651,0.5,2651.0,0
31761,2648,2662,0.5,2655.0,-14
31762,2484,2646,0.5,2565.0,-162
31763,2746,2741,1.0,2743.5,5
31764,2512,2500,0.5,2506.0,12
31765,2524,2740,0.0,2632.0,-216
31766,2569,2739,1.0,2654.0,-170
31767,2535,2733,0.0,2634.0,-198
31768,2720,2716,1.0,2718.0,4
31769,2567,2567,1.0,2567.0,0
31770,2706,2710,0.5,2708.0,-4
31771,2586,2588,0.5,2587.0,-2
31772,2595,2700,1.0,2647.5,-105
31773,2605,2701,1.0,2653.0,-96
31774,2609,2699,1.0,2654.0,-90
31775,2696,2696,1.0,2696.0,0
31776,2626,2607,0.0,2616.5,19
31777,2628,2698,0.0,2663.0,-70
31778,2644,2693,0.0,2668.5,-49
31779,2632,2680,1.0,2656.0,-48
31780,2664,2693,1.0,2678.5,-29
31781,2678,2632,0.0,2655.0,46
31782,2672,2643,0.5,2657.5,29
31783,2668,2635,1.0,2651.5,33
31784,2655,2636,0.5,2645.5,19
31785,2652,2645,1.0,2648.5,7
31786,2634,2660,0.5,2647.0,-26
31787,2659,2660,1.0,2659.5,-1
31788,2651,2654,1.0,2652.5,-3
31789,2662,2653,1.0,2657.5,9
31790,2741,2651,0.5,2696.0,90
31791,2500,2484,0.0,2492.0,16
31792,2740,2746,1.0,2743.0,-6
31793,2739,2512,1.0,2625.5,227
31794,2733,2524,1.0,2628.5,209
31795,2716,2569,0.5,2642.5,147
31796,2567,2535,0.0,2551.0,32
31797,2710,2720,1.0,2715.0,-10
31798,2588,2567,0.5,2577.5,21
31799,2700,2706,0.5,2703.0,-6
31800,2701,2586,0.5,2643.5,115
31801,2699,2595,0.5,2647.0,104
31802,2696,2605,1.0,2650.5,91
31803,2607,2609,0.0,2608.0,-2
31804,2698,2696,1.0,2697.0,2
31805,2693,2626,0.5,2659.5,67
31806,2680,2628,0.5,2654.0,52
31807,2693,2644,1.0,2668.5,49
31808,2632,2632,1.0,2632.0,0
31809,2643,2664,0.0,2653.5,-21
31810,2635,2678,0.5,2656.5,-43
31811,2636,2672,0.5,2654.0,-36
31812,2645,2668,0.5,2656.5,-23
31813,2660,2655,1.0,2657.5,5
31814,2660,2652,1.0,2656.0,8
31815,2654,2634,1.0,2644.0,20
31816,2653,2659,0.5,2656.0,-6
31817,2651,2651,0.0,2651.0,0
31818,2484,2662,0.0,2573.0,-178
31819,2569,2741,0.0,2655.0,-172
31820,2567,2733,0.5,2650.0,-166
31821,2588,2710,0.0,2649.0,-122
31822,2700,2706,0.0,2703.0,-6
31823,2696,2586,1.0,2641.0,110
31824,2632,2609,0.5,2620.5,23
31825,2632,2693,1.0,2662.5,-61
31826,2643,2664,0.0,2653.5,-21
31827,2635,2678,0.5,2656.5,-43
31828,2645,2672,0.5,2658.5,-27
31829,2660,2655,1.0,2657.5,5
31830,2659,2652,0.5,2655.5,7
31831,2741,2654,0.5,2697.5,87
31832,2733,2484,0.5,2608.5,249
31833,2710,2569,0.5,2639.5,141
31834,2706,2567,0.0,2636.5,139
31835,2586,2588,0.5,2587.0,-2
31836,2609,2700,0.0,2654.5,-91
31837,2693,2696,0.0,2694.5,-3
31838,2664,2632,1.0,2648.0,32
31839,2678,2632,1.0,2655.0,46
31840,2672,2643,1.0,2657.5,29
31841,2655,2635,1.0,2645.0,20
31842,2652,2645,0.5,2648.5,7
31843,2654,2660,0.5,2657.0,-6
31844,2710,2659,0.0,2684.5,51
31845,2588,2567,1.0,2577.5,21
31846,2664,2706,0.0,2685.0,-42
31847,2654,2632,0.5,2643.0,22
31848,2567,2659,1.0,2613.0,-92
31849,2706,2710,1.0,2708.0,-4
31850,2632,2588,0.0,2610.0,44
31851,2659,2664,0.0,2661.5,-5
31852,2706,2654,1.0,2680.0,52
31853,2632,2588,0.0,2610.0,44
31854,2648,2664,0.5,2656.0,-16
31855,2796,2813,1.0,2804.5,-17
31856,2651,2662,0.5,2656.5,-11
31857,2785,2784,1.0,2784.5,1
31858,2660,2654,0.5,2657.0,6
31859,2772,2772,1.0,2772.0,0
31860,2630,2660,0.5,2645.0,-30
31861,2741,2764,1.0,2752.5,-23
31862,2676,2655,0.5,2665.5,21
31863,2757,2775,1.0,2766.0,-18
31864,2624,2667,0.5,2645.5,-43
31865,2747,2756,0.5,2751.5,-9
31866,2672,2668,0.5,2670.0,4
31867,2740,2746,0.5,2743.0,-6
31868,2664,2678,1.0,2671.0,-14
31869,2739,2744,1.0,2741.5,-5
31870,2680,2632,0.5,2656.0,48
31871,2737,2719,1.0,2728.0,18
31872,2623,2693,0.0,2658.0,-70
31873,2733,2731,0.5,2732.0,2
31874,2625,2698,0.5,2661.5,-73
31875,2720,2716,1.0,2718.0,4
31876,2609,2696,0.0,2652.5,-87
31877,2696,2719,0.5,2707.5,-23
31878,2605,2551,0.5,2578.0,54
31879,2714,2715,0.5,2714.5,-1
31880,2567,2699,0.5,2633.0,-132
31881,2724,2595,0.5,2659.5,129
31882,2706,2702,0.5,2704.0,4
31883,2709,2702,0.5,2705.5,7
31884,2708,2586,0.5,2647.0,122
31885,2706,2707,1.0,2706.5,-1
31886,2813,2710,0.5,2761.5,103
31887,2662,2648,0.5,2655.0,14
31888,2784,2796,0.5,2790.0,-12
31889,2654,2651,0.5,2652.5,3
31890,2772,2785,0.5,2778.5,-13
31891,2660,2660,0.5,2660.0,0
31892,2764,2772,1.0,2768.0,-8
31893,2655,2630,1.0,2642.5,25
31894,2775,2741,0.5,2758.0,34
31895,2667,2676,0.5,2671.5,-9
31896,2756,2757,0.5,2756.5,-1
31897,2668,2624,0.5,2646.0,44
31898,2746,2747,0.5,2746.5,-1
31899,2678,2672,0.5,2675.0,6
31900,2744,2740,0.5,2742.0,4
31901,2632,2664,0.5,2648.0,-32
31902,2719,2739,1.0,2729.0,-20
31903,2693,2680,0.0,2686.5,13
31904,2731,2737,1.0,2734.0,-6
31905,2698,2623,0.5,2660.5,75
31906,2716,2733,1.0,2724.5,-17
31907,2696,2625,1.0,2660.5,71
31908,2719,2720,1.0,2719.5,-1
31909,2551,2609,1.0,2580.0,-58
31910,2715,2696,0.5,2705.5,19
31911,2699,2605,0.5,2652.0,94
31912,2595,2714,0.0,2654.5,-119
31913,2702,2567,1.0,2634.5,135
31914,2702,2724,0.5,2713.0,-22
31915,2586,2706,0.0,2646.0,-120
31916,2707,2709,0.5,2708.0,-2
31917,2710,2708,0.5,2709.0,2
31918,2648,2706,0.0,2677.0,-58
31919,2651,2813,0.5,2732.0,-162
31920,2772,2784,1.0,2778.0,-12
31921,2655,2660,0.0,2657.5,-5
31922,2676,2741,0.5,2708.5,-65
31923,2756,2775,0.5,2765.5,-19
31924,2668,2624,1.0,2646.0,44
31925,2746,2747,0.5,2746.5,-1
31926,2740,2672,0.5,2706.0,68
31927,2698,2678,0.5,2688.0,20
31928,2696,2733,0.0,2714.5,-37
31929,2605,2720,1.0,2662.5,-115
31930,2699,2715,1.0,2707.0,-16
31931,2706,2714,0.5,2710.0,-8
31932,2708,2702,0.0,2705.0,6
31933,2813,2707,1.0,2760.0,106
31934,2784,2648,1.0,2716.0,136
31935,2660,2651,0.5,2655.5,9
31936,2741,2772,1.0,2756.5,-31
31937,2775,2655,1.0,2715.0,120
31938,2624,2676,0.5,2650.0,-52
31939,2747,2756,0.0,2751.5,-9
31940,2672,2668,0.0,2670.0,4
31941,2678,2746,1.0,2712.0,-68
31942,2733,2740,0.5,2736.5,-7
31943,2720,2698,1.0,2709.0,22
31944,2715,2696,0.0,2705.5,19
31945,2714,2605,0.5,2659.5,109
31946,2702,2699,1.0,2700.5,3
31947,2707,2706,1.0,2706.5,1
31948,2624,2708,0.5,2666.0,-84
31949,2698,2756,0.0,2727.0,-58
31950,2756,2733,0.5,2744.5,23
31951,2733,2624,1.0,2678.5,109
31952,2756,2698,0.5,2727.0,58
31953,2624,2624,0.5,2624.0,0
31954,2624,2756,1.0,2690.0,-132
31955,2813,2756,0.0,2784.5,57
31956,2707,2706,0.5,2706.5,1
31957,2784,2796,0.5,2790.0,-12
31958,2702,2709,1.0,2705.5,-7
31959,2772,2785,0.5,2778.5,-13
31960,2567,2702,0.0,2634.5,-135
31961,2764,2772,1.0,2768.0,-8
31962,2605,2699,0.0,2652.0,-94
31963,2775,2741,0.5,2758.0,34
31964,2719,2551,1.0,2635.0,168
31965,2624,2757,0.5,2690.5,-133
31966,2716,2720,0.5,2718.0,-4
31967,2746,2668,1.0,2707.0,78
31968,2731,2733,0.5,2732.0,-2
31969,2664,2678,0.0,2671.0,-14
31970,2719,2737,0.5,2728.0,-18
31971,2706,2739,0.5,2722.5,-33
31972,2796,2813,0.5,2804.5,-17
31973,2709,2707,0.5,2708.0,2
31974,2785,2784,1.0,2784.5,1
31975,2702,2702,0.5,2702.0,0
31976,2772,2772,1.0,2772.0,0
31977,2699,2567,0.5,2633.0,132
31978,2741,2764,0.5,2752.5,-23
31979,2551,2605,0.5,2578.0,-54
31980,2757,2775,0.5,2766.0,-18
31981,2720,2719,0.5,2719.5,1
31982,2668,2624,0.5,2646.0,44
31983,2733,2716,0.5,2724.5,17
31984,2678,2746,0.5,2712.0,-68
31985,2737,2731,0.0,2734.0,6
31986,2739,2664,0.5,2701.5,75
31987,2796,2719,1.0,2757.5,77
31988,2784,2707,1.0,2745.5,77
31989,2785,2709,0.0,2747.0,76
31990,2772,2702,0.5,2737.0,70
31991,2775,2702,1.0,2738.5,73
31992,2720,2551,1.0,2635.5,169
31993,2716,2624,0.0,2670.0,92
31994,2678,2668,0.0,2673.0,10
31995,2664,2731,1.0,2697.5,-67
31996,2719,2737,0.5,2728.0,-18
31997,2707,2739,0.0,2723.0,-32
31998,2709,2796,0.0,2752.5,-87
31999,2702,2784,0.5,2743.0,-82
32000,2702,2785,0.5,2743.5,-83
32001,2551,2772,0.5,2661.5,-221
32002,2624,2775,0.5,2699.5,-151
32003,2668,2720,0.0,2694.0,-52
32004,2731,2716,1.0,2723.5,15
32005,2737,2678,0.5,2707.5,59
32006,2739,2664,0.5,2701.5,75
32007,2702,2719,1.0,2710.5,-17
32008,2716,2772,1.0,2744.0,-56
32009,2739,2668,0.5,2703.5,71
32010,2772,2719,1.0,2745.5,53
32011,2668,2702,0.0,2685.0,-34
32012,2719,2716,0.5,2717.5,3
32013,2702,2739,0.5,2720.5,-37
32014,2739,2772,0.5,2755.5,-33
32015,2772,2719,1.0,2745.5,53
32016,2719,2702,0.0,2710.5,17
32017,2631,2535,0.5,2583.0,96
32018,2739,2706,0.5,2722.5,33
32019,2796,2664,1.0,2730.0,132
32020,2731,2784,0.0,2757.5,-53
32021,2702,2746,0.5,2724.0,-44
32022,2716,2772,0.5,2744.0,-56
32023,2772,2720,0.5,2746.0,52
32024,2719,2764,0.5,2741.5,-45
32025,2741,2775,1.0,2758.0,-34
32026,2706,2739,0.5,2722.5,-33
32027,2664,2796,0.0,2730.0,-132
32028,2784,2731,0.5,2757.5,53
32029,2746,2702,0.5,2724.0,44
32030,2772,2716,0.5,2744.0,56
32031,2720,2772,1.0,2746.0,-52
32032,2764,2719,0.5,2741.5,45
32033,2775,2741,0.5,2758.0,34
32034,2706,2739,0.5,2722.5,-33
32035,2702,2746,0.5,2724.0,-44
32036,2716,2772,1.0,2744.0,-56
32037,2719,2764,1.0,2741.5,-45
32038,2739,2706,0.5,2722.5,33
32039,2746,2702,1.0,2724.0,44
32040,2772,2716,0.0,2744.0,56
32041,2764,2719,0.5,2741.5,45
32042,2706,2739,0.0,2722.5,-33
32043,2739,2706,0.0,2722.5,33
32044,2739,2706,0.0,2722.5,33
32045,2706,2739,0.5,2722.5,-33
32046,2706,2741,0.5,2723.5,-35
32047,2719,2796,0.5,2757.5,-77
32048,2784,2720,1.0,2752.0,64
32049,2716,2746,0.5,2731.0,-30
32050,2741,2706,0.0,2723.5,35
32051,2796,2719,0.5,2757.5,77
32052,2720,2784,0.5,2752.0,-64
32053,2746,2716,0.5,2731.0,30
32054,2796,2719,0.5,2757.5,77
32055,2716,2746,1.0,2731.0,-30
32056,2719,2796,1.0,2757.5,-77
32057,2746,2716,0.5,2731.0,30
32058,2716,2706,0.5,2711.0,10
32059,2719,2784,0.5,2751.5,-65
32060,2195,2231,1.0,2213.0,-36
32061,2425,2170,1.0,2297.5,255
32062,2457,2590,1.0,2523.5,-133
32063,2648,2214,1.0,2431.0,434
32064,2461,2497,1.0,2479.0,-36
32065,2379,2204,0.5,2291.5,175
32066,2244,2324,1.0,2284.0,-80
32067,2380,2257,0.5,2318.5,123
32068,2331,2378,0.0,2354.5,-47
32069,2349,2363,0.0,2356.0,-14
32070,2223,2327,0.0,2275.0,-104
32071,2337,2382,1.0,2359.5,-45
32072,2590,2201,0.0,2395.5,389
32073,2216,2630,0.0,2423.0,-414
32074,2107,2286,0.5,2196.5,-179
32075,2352,2379,1.0,2365.5,-27
32076,2242,2392,0.5,2317.0,-150
32077,2424,2305,0.5,2364.5,119
32078,2206,2311,1.0,2258.5,-105
32079,2205,2209,0.0,2207.0,-4
32080,2448,2395,0.5,2421.5,53
32081,2360,2313,1.0,2336.5,47
32082,2419,2112,1.0,2265.5,307
32083,2537,2387,0.5,2462.0,150
32084,2377,2315,0.5,2346.0,62
32085,2234,2151,0.5,2192.5,83
32086,1995,2373,0.5,2184.0,-378
32087,2330,2147,1.0,2238.5,183
32088,2198,2231,1.0,2214.5,-33
32089,2210,2129,0.0,2169.5,81
32090,2650,2637,1.0,2643.5,13
32091,2423,2556,0.5,2489.5,-133
32092,2546,2432,0.0,2489.0,114
32093,2416,2536,0.0,2476.0,-120
32094,2455,2368,0.5,2411.5,87
32095,2333,2329,0.0,2331.0,4
32096,2340,2311,0.0,2325.5,29
32097,2330,2266,1.0,2298.0,64
32098,2256,2216,1.0,2236.0,40
32099,2295,2157,1.0,2226.0,138
32100,2094,1899,1.0,1996.5,195
32101,2457,2151,0.5,2304.0,306
32102,2568,2257,1.0,2412.5,311
32103,2461,2387,1.0,2424.0,74
32104,2313,2170,0.5,2241.5,143
32105,2204,2419,0.5,2311.5,-215
32106,2448,2214,1.0,2331.0,234
32107,2244,2303,0.5,2273.5,-59
32108,2147,2363,0.0,2255.0,-216
32109,2130,2129,1.0,2129.5,1
32110,2198,2223,0.5,2210.5,-25
32111,2126,2137,0.0,2131.5,-11
32112,2709,2787,0.5,2748.0,-78
32113,2766,2758,0.5,2762.0,8
32114,2770,2830,1.0,2800.0,-60
32115,2757,2785,0.5,2771.0,-28
32116,2830,2757,1.0,2793.5,73
32117,2785,2770,0.5,2777.5,15
32118,2758,2709,1.0,2733.5,49
32119,2787,2766,1.0,2776.5,21
32120,2785,2830,0.5,2807.5,-45
32121,2709,2766,0.5,2737.5,-57
32122,2758,2787,0.5,2772.5,-29
32123,2757,2770,0.0,2763.5,-13
32124,2757,2709,1.0,2733.0,48
32125,2770,2787,0.5,2778.5,-17
32126,2766,2785,0.5,2775.5,-19
32127,2830,2758,1.0,2794.0,72
32128,2113,2495,0.0,2304.0,-382
32129,2799,2767,0.5,2783.0,32
32130,2784,2769,0.5,2776.5,15
32131,2794,2809,0.5,2801.5,-15
32132,2763,2800,1.0,2781.5,-37
32133,2800,2794,1.0,2797.0,6
32134,2809,2784,0.5,2796.5,25
32135,2769,2799,0.5,2784.0,-30
32136,2767,2763,0.5,2765.0,4
32137,2784,2800,0.5,2792.0,-16
32138,2794,2763,0.0,2778.5,31
32139,2769,2767,0.5,2768.0,2
32140,2799,2809,0.5,2804.0,-10
32141,2809,2769,0.0,2789.0,40
32142,2767,2794,0.5,2780.5,-27
32143,2763,2784,1.0,2773.5,-21
32144,2800,2799,0.5,2799.5,1
32145,2809,2767,1.0,2788.0,42
32146,2769,2800,0.5,2784.5,-31
32147,2799,2763,0.5,2781.0,36
32148,2784,2794,1.0,2789.0,-10
32149,2474,2591,1.0,2532.5,-117
32150,2757,2790,0.5,2773.5,-33
32151,2760,2793,0.5,2776.5,-33
32152,2794,2762,1.0,2778.0,32
32153,2786,2780,0.5,2783.0,6
32154,2786,2757,0.0,2771.5,29
32155,2780,2794,0.5,2787.0,-14
32156,2762,2760,1.0,2761.0,2
32157,2793,2790,0.5,2791.5,3
32158,2757,2793,0.5,2775.0,-36
32159,2790,2762,1.0,2776.0,28
32160,2760,2780,1.0,2770.0,-20
32161,2794,2786,0.5,2790.0,8
32162,2794,2757,0.5,2775.5,37
32163,2786,2760,0.5,2773.0,26
32164,2780,2790,0.0,2785.0,-10
32165,2762,2793,0.5,2777.5,-31
32166,2757,2762,0.5,2759.5,-5
32167,2793,2780,0.5,2786.5,13
32168,2790,2786,0.5,2788.0,4
32169,2760,2794,1.0,2777.0,-34
32170,1928,2353,0.0,2140.5,-425
32171,2792,2807,0.5,2799.5,-15
32172,2791,2761,0.5,2776.0,30
32173,2755,2770,0.5,2762.5,-15
32174,2771,2769,0.5,2770.0,2
32175,2819,2751,0.5,2785.0,68
32176,2770,2771,0.5,2770.5,-1
32177,2761,2755,1.0,2758.0,6
32178,2769,2792,0.5,2780.5,-23
32179,2807,2819,0.5,2813.0,-12
32180,2751,2791,0.5,2771.0,-40
32181,2771,2761,1.0,2766.0,10
32182,2792,2819,0.0,2805.5,-27
32183,2769,2770,0.5,2769.5,-1
32184,2791,2807,0.5,2799.0,-16
32185,2755,2751,1.0,2753.0,4
32186,2751,2771,0.5,2761.0,-20
32187,2770,2792,0.5,2781.0,-22
32188,2761,2769,0.5,2765.0,-8
32189,2819,2791,0.5,2805.0,28
32190,2807,2755,0.5,2781.0,52
32191,2771,2807,0.5,2789.0,-36
32192,2770,2761,0.5,2765.5,9
32193,2792,2791,1.0,2791.5,1
32194,2755,2819,0.5,2787.0,-64
32195,2769,2751,0.0,2760.0,18
32196,2819,2771,0.5,2795.0,48
32197,2761,2792,0.5,2776.5,-31
32198,2751,2770,0.5,2760.5,-19
32199,2791,2755,1.0,2773.0,36
32200,2807,2769,1.0,2788.0,38
32201,2356,2315,1.0,2335.5,41
32202,2801,2842,1.0,2821.5,-41
32203,2741,2753,0.5,2747.0,-12
32204,2526,2779,0.5,2652.5,-253
32205,2753,2801,0.5,2777.0,-48
32206,2842,2526,1.0,2684.0,316
32207,2779,2741,1.0,2760.0,38
32208,2545,2556,0.5,2550.5,-11
32209,2652,2572,0.5,2612.0,80
32210,2558,2588,0.5,2573.0,-30
32211,2546,2594,0.5,2570.0,-48
32212,2642,2437,1.0,2539.5,205
32213,2529,2706,0.5,2617.5,-177
32214,2638,2534,0.5,2586.0,104
32215,2499,2609,1.0,2554.0,-110
32216,2436,2580,0.0,2508.0,-144
32217,2595,2515,0.5,2555.0,80
32218,2562,2490,0.0,2526.0,72
32219,2370,2559,0.5,2464.5,-189
32220,2536,2444,1.0,2490.0,92
32221,2636,2393,1.0,2514.5,243
32222,2626,2399,1.0,2512.5,227
32223,2599,2396,1.0,2497.5,203
32224,2578,2369,1.0,2473.5,209
32225,2298,2506,0.0,2402.0,-208
32226,2486,2359,1.0,2422.5,127
32227,2313,2459,0.0,2386.0,-146
32228,2556,2546,1.0,2551.0,10
32229,2588,2545,0.5,2566.5,43
32230,2490,2652,0.5,2571.0,-162
32231,2572,2642,0.0,2607.0,-70
32232,2580,2558,0.0,2569.0,22
32233,2594,2536,0.5,2565.0,58
32234,2706,2499,1.0,2602.5,207
32235,2529,2638,1.0,2583.5,-109
32236,2506,2636,0.5,2571.0,-130
32237,2515,2626,0.5,2570.5,-111
32238,2486,2599,0.5,2542.5,-113
32239,2437,2595,0.0,2516.0,-158
32240,2459,2578,0.5,2518.5,-119
32241,2559,2451,1.0,2505.0,108
32242,2534,2419,1.0,2476.5,115
32243,2609,2370,0.5,2489.5,239
32244,2360,2604,0.5,2482.0,-244
32245,2336,2562,0.5,2449.0,-226
32246,2444,2327,0.5,2385.5,117
32247,2295,2436,0.0,2365.5,-141
32248,2642,2556,0.5,2599.0,86
32249,2558,2545,0.5,2551.5,13
32250,2706,2559,1.0,2632.5,147
32251,2652,2534,0.0,2593.0,118
32252,2536,2588,0.0,2562.0,-52
32253,2595,2529,0.5,2562.0,66
32254,2490,2594,1.0,2542.0,-104
32255,2499,2636,0.0,2567.5,-137
32256,2626,2486,0.5,2556.0,140
32257,2599,2459,1.0,2529.0,140
32258,2370,2580,1.0,2475.0,-210
32259,2578,2409,0.5,2493.5,169
32260,2402,2572,0.0,2487.0,-170
32261,2546,2393,0.5,2469.5,153
32262,2436,2506,1.0,2471.0,-70
32263,2296,2515,0.5,2405.5,-219
32264,2638,2378,1.0,2508.0,260
32265,2609,2396,1.0,2502.5,213
32266,2604,2369,1.0,2486.5,235
32267,2562,2360,1.0,2461.0,202
32268,2556,2490,0.5,2523.0,66
32269,2588,2706,0.5,2647.0,-118
32270,2545,2642,0.5,2593.5,-97
32271,2534,2558,0.5,2546.0,-24
32272,2636,2370,0.5,2503.0,266
32273,2529,2599,1.0,2564.0,-70
32274,2572,2595,0.5,2583.5,-23
32275,2652,2436,0.5,2544.0,216
32276,2546,2638,0.5,2592.0,-92
32277,2536,2626,0.0,2581.0,-90
32278,2515,2609,0.0,2562.0,-94
32279,2486,2604,0.0,2545.0,-118
32280,2594,2419,0.5,2506.5,175
32281,2393,2578,0.5,2485.5,-185
32282,2409,2562,0.0,2485.5,-153
32283,2559,2296,1.0,2427.5,263
32284,2499,2162,1.0,2330.5,337
32285,2580,2353,0.5,2466.5,227
32286,2506,2336,1.0,2421.0,170
32287,2359,2511,0.5,2435.0,-152
32288,2066,2165,0.5,2115.5,-99
32289,2768,2743,0.0,2755.5,25
32290,2724,2720,0.5,2722.0,4
32291,2708,2659,0.5,2683.5,49
32292,2649,2624,0.5,2636.5,25
32293,2613,2716,0.5,2664.5,-103
32294,2676,2602,1.0,2639.0,74
32295,2602,2634,1.0,2618.0,-32
32296,2530,2554,0.0,2542.0,-24
32297,2877,2735,1.0,2806.0,142
32298,2659,2630,0.5,2644.5,29
32299,2628,2576,0.5,2602.0,52
32300,2640,2528,0.5,2584.0,112
32301,2760,2718,0.5,2739.0,42
32302,2742,2795,0.5,2768.5,-53
32303,2751,2668,0.5,2709.5,83
32304,2666,2786,0.5,2726.0,-120
32305,2745,2753,1.0,2749.0,-8
32306,2671,2664,1.0,2667.5,7
32307,2662,2624,0.5,2643.0,38
32308,2651,2638,0.5,2644.5,13
32309,2772,2625,1.0,2698.5,147
32310,2574,2681,1.0,2627.5,-107
32311,2553,2579,1.0,2566.0,-26
32312,2561,2461,0.5,2511.0,100
32313,2700,2709,1.0,2704.5,-9
32314,2646,2615,1.0,2630.5,31
32315,2510,2639,1.0,2574.5,-129
32316,2612,2367,1.0,2489.5,245
32317,2632,2801,0.5,2716.5,-169
32318,2565,2589,0.0,2577.0,-24
32319,2569,2587,1.0,2578.0,-18
32320,2530,2614,0.0,2572.0,-84
32321,2713,2517,1.0,2615.0,196
32322,2519,2618,1.0,2568.5,-99
32323,2581,2467,1.0,2524.0,114
32324,2351,2542,0.5,2446.5,-191
32325,2545,2578,0.5,2561.5,-33
32326,2473,2535,0.0,2504.0,-62
32327,2508,2448,0.5,2478.0,60
32328,2423,2491,0.5,2457.0,-68
32329,2531,2654,1.0,2592.5,-123
32330,2547,2461,1.0,2504.0,86
32331,2470,2203,1.0,2336.5,267
32332,2396,2425,0.5,2410.5,-29
32333,2760,2590,0.5,2675.0,170
32334,2669,2664,0.5,2666.5,5
32335,2649,2619,0.5,2634.0,30
32336,2565,2603,0.0,2584.0,-38
32337,2644,2710,0.0,2677.0,-66
32338,2634,2602,0.5,2618.0,32
32339,2455,2501,0.0,2478.0,-46
32340,2507,2277,1.0,2392.0,230
32341,2740,2709,1.0,2724.5,31
32342,2650,2665,1.0,2657.5,-15
32343,2650,2572,1.0,2611.0,78
32344,2524,2653,0.0,2588.5,-129
32345,2523,2744,0.5,2633.5,-221
32346,2717,2522,0.5,2619.5,195
32347,2421,2723,0.0,2572.0,-302
32348,2707,2453,1.0,2580.0,254
32349,2574,2644,0.5,2609.0,-70
32350,2641,2574,0.5,2607.5,67
32351,2564,2608,0.5,2586.0,-44
32352,2526,2562,0.0,2544.0,-36
32353,2671,2513,1.0,2592.0,158
32354,2411,2606,0.5,2508.5,-195
32355,2563,2501,1.0,2532.0,62
32356,2418,2608,0.0,2513.0,-190
32357,2525,2562,0.5,2543.5,-37
32358,2522,2374,0.0,2448.0,148
32359,2374,2525,0.5,2449.5,-151
32360,2477,2291,0.5,2384.0,186
32361,2378,2787,0.0,2582.5,-409
32362,2706,2399,0.0,2552.5,307
32363,2333,2659,0.0,2496.0,-326
32364,2624,2236,1.0,2430.0,388
32365,2416,2740,0.5,2578.0,-324
32366,2637,2413,1.0,2525.0,224
32367,2392,2690,0.0,2541.0,-298
32368,2676,2266,1.0,2471.0,410
32369,2273,2649,0.0,2461.0,-376
32370,2570,2197,1.0,2383.5,373
32371,2187,2568,0.0,2377.5,-381
32372,2583,2156,1.0,2369.5,427
32373,2141,2594,0.0,2367.5,-453
32374,2598,2154,1.0,2376.0,444
32375,2067,2424,0.0,2245.5,-357
32376,2490,2093,0.5,2291.5,397
32377,2698,2611,0.5,2654.5,87
32378,2433,2620,0.0,2526.5,-187
32379,2618,2328,0.5,2473.0,290
32380,2251,2603,0.5,2427.0,-352
32381,2469,2805,0.0,2637.0,-336
32382,2686,2406,1.0,2546.0,280
32383,2384,2672,0.0,2528.0,-288
32384,2655,2303,1.0,2479.0,352
32385,2335,2500,0.0,2417.5,-165
32386,2477,2450,0.0,2463.5,27
32387,2216,2580,0.5,2398.0,-364
32388,2595,2106,1.0,2350.5,489
32389,1946,2532,0.0,2239.0,-586
32390,2514,1781,1.0,2147.5,733
32391,2507,2218,1.0,2362.5,289
32392,2215,2361,1.0,2288.0,-146
32393,2320,2214,0.0,2267.0,106
32394,2156,2256,0.5,2206.0,-100
32395,2602,2533,0.5,2567.5,69
32396,2537,2571,0.0,2554.0,-34
32397,2586,2457,0.0,2521.5,129
32398,2455,2487,0.5,2471.0,-32
32399,2571,2536,0.5,2553.5,35
32400,2543,2595,0.5,2569.0,-52
32401,2549,2448,1.0,2498.5,101
32402,2555,2559,0.5,2557.0,-4
32403,2653,2622,0.0,2637.5,31
32404,2593,2448,1.0,2520.5,145
32405,2390,2528,0.5,2459.0,-138
32406,2458,2318,0.5,2388.0,140
32407,2590,2527,1.0,2558.5,63
32408,2400,2410,1.0,2405.0,-10
32409,2186,2301,0.5,2243.5,-115
32410,2604,2090,1.0,2347.0,514
32411,2172,2522,0.0,2347.0,-350
32412,2473,2173,1.0,2323.0,300
32413,2105,2373,0.0,2239.0,-268
32414,2606,2236,1.0,2421.0,370
32415,2110,2435,0.0,2272.5,-325
32416,2402,2104,1.0,2253.0,298
32417,2078,2447,0.0,2262.5,-369
32418,2388,2441,0.5,2414.5,-53
32419,2431,2279,1.0,2355.0,152
32420,2155,2419,0.5,2287.0,-264
32421,2255,2659,0.0,2457.0,-404
32422,2618,2425,1.0,2521.5,193
32423,2272,2569,0.0,2420.5,-297
32424,2537,2190,1.0,2363.5,347
32425,2489,2591,0.0,2540.0,-102
32426,2350,2427,0.5,2388.5,-77
32427,2382,2277,1.0,2329.5,105
32428,2225,2391,0.5,2308.0,-166
32429,2438,2627,0.0,2532.5,-189
32430,2487,2286,1.0,2386.5,201
32431,2239,2466,0.5,2352.5,-227
32432,2589,2157,1.0,2373.0,432
32433,2644,2408,1.0,2526.0,236
32434,2323,2556,0.0,2439.5,-233
32435,2432,2236,1.0,2334.0,196
32436,2224,2447,0.0,2335.5,-223
32437,2581,2484,0.5,2532.5,97
32438,2464,2416,0.0,2440.0,48
32439,2284,2500,0.0,2392.0,-216
32440,2426,2382,1.0,2404.0,44
32441,2549,2317,0.5,2433.0,232
32442,2405,2505,0.0,2455.0,-100
32443,2365,2250,1.0,2307.5,115
32444,2193,2186,0.0,2189.5,7
32445,2590,2591,0.0,2590.5,-1
32446,2437,2526,0.5,2481.5,-89
32447,2438,2431,1.0,2434.5,7
32448,2425,2363,0.0,2394.0,62
32449,2471,2663,0.0,2567.0,-192
32450,2629,2330,1.0,2479.5,299
32451,2189,2630,0.5,2409.5,-441
32452,2553,2173,1.0,2363.0,380
32453,2396,2387,0.0,2391.5,9
32454,2392,2180,1.0,2286.0,212
32455,2254,2289,1.0,2271.5,-35
32456,2277,2139,0.0,2208.0,138
32457,2521,2329,1.0,2425.0,192
32458,2126,2505,0.5,2315.5,-379
32459,2486,2258,1.0,2372.0,228
32460,2165,2427,1.0,2296.0,-262
32461,2448,2513,1.0,2480.5,-65
32462,2462,2463,0.5,2462.5,-1
32463,2365,2439,0.0,2402.0,-74
32464,2334,2172,1.0,2253.0,162
32465,2154,2307,0.0,2230.5,-153
32466,2157,2084,1.0,2120.5,73
32467,2079,2170,1.0,2124.5,-91
32468,2160,1979,1.0,2069.5,181
32469,2318,2055,1.0,2186.5,263
32470,1963,2365,0.0,2164.0,-402
32471,1854,2320,0.5,2087.0,-466
32472,2502,2334,1.0,2418.0,168
32473,2261,2495,0.5,2378.0,-234
32474,2382,2299,1.0,2340.5,83
32475,2244,2323,0.0,2283.5,-79
32476,2472,2414,0.5,2443.0,58
32477,2244,2332,0.0,2288.0,-88
32478,2283,2210,0.5,2246.5,73
32479,2125,2150,0.0,2137.5,-25
32480,2164,2243,1.0,2203.5,-79
32481,2118,2056,1.0,2087.0,62
32482,2087,2261,1.0,2174.0,-174
32483,2221,2090,0.5,2155.5,131
32484,2060,2063,1.0,2061.5,-3
32485,2125,2017,1.0,2071.0,108
32486,2115,2120,0.0,2117.5,-5
32487,2222,1985,1.0,2103.5,237
32488,1933,2193,0.5,2063.0,-260
32489,2144,1977,1.0,2060.5,167
32490,2030,2070,1.0,2050.0,-40
32491,2181,2435,0.5,2308.0,-254
32492,2346,2225,0.5,2285.5,121
32493,2245,2275,0.5,2260.0,-30
32494,2305,1993,1.0,2149.0,312
32495,2143,2263,0.5,2203.0,-120
32496,2085,2169,1.0,2127.0,-84
32497,2106,2246,0.5,2176.0,-140
32498,2272,1951,1.0,2111.5,321
32499,2068,2012,1.0,2040.0,56
32500,1893,1930,0.0,1911.5,-37
32501,1911,2137,0.0,2024.0,-226
32502,2508,2170,0.0,2339.0,338
32503,2320,2145,0.0,2232.5,175
32504,2183,2387,0.0,2285.0,-204
32505,2139,2383,0.0,2261.0,-244
32506,2177,2099,1.0,2138.0,78
32507,2425,2311,1.0,2368.0,114
32508,2309,2259,1.0,2284.0,50
32509,2222,2143,0.5,2182.5,79
32510,2121,2103,0.0,2112.0,18
32511,2354,2068,1.0,2211.0,286
32512,2070,2368,0.0,2219.0,-298
32513,2229,2024,1.0,2126.5,205
32514,2002,2106,0.5,2054.0,-104
32515,2123,2344,0.0,2233.5,-221
32516,2373,1951,1.0,2162.0,422
32517,2036,2183,0.0,2109.5,-147
32518,2024,1972,1.0,1998.0,52
32519,1829,1873,0.0,1851.0,-44
32520,1846,1884,0.0,1865.0,-38
32521,2341,1950,1.0,2145.5,391
32522,1802,2296,1.0,2049.0,-494
32523,2125,1755,1.0,1940.0,370
32524,2183,1965,1.0,2074.0,218
32525,2044,1746,0.0,1895.0,298
32526,2253,2112,1.0,2182.5,141
32527,1880,2065,0.0,1972.5,-185
32528,2034,2000,0.0,2017.0,34
32529,2064,1917,0.0,1990.5,147
32530,2194,2121,1.0,2157.5,73
32531,2046,2085,1.0,2065.5,-39
32532,2141,2218,0.0,2179.5,-77
32533,2039,1944,0.5,1991.5,95
32534,1707,2083,0.0,1895.0,-376
32535,2087,1922,1.0,2004.5,165
32536,1929,2024,1.0,1976.5,-95
32537,2256,1685,1.0,1970.5,571
32538,2081,2067,1.0,2074.0,14
32539,2321,2249,1.0,2285.0,72
32540,2311,2352,1.0,2331.5,-41
32541,1948,2523,0.0,2235.5,-575
32542,1844,2176,0.0,2010.0,-332
32543,2117,1899,1.0,2008.0,218
32544,2297,1937,1.0,2117.0,360
32545,1828,2282,0.0,2055.0,-454
32546,2231,1969,1.0,2100.0,262
32547,1892,2246,0.0,2069.0,-354
32548,2315,2272,0.5,2293.5,43
32549,2085,2326,0.0,2205.5,-241
32550,2226,1760,1.0,1993.0,466
32551,1846,2140,0.0,1993.0,-294
32552,2054,2201,0.0,2127.5,-147
32553,1993,1931,0.0,1962.0,62
32554,2106,2026,0.5,2066.0,80
32555,1841,1945,0.0,1893.0,-104
32556,2111,1833,1.0,1972.0,278
32557,1908,1878,0.5,1893.0,30
32558,2036,1996,0.5,2016.0,40
32559,1645,2180,0.0,1912.5,-535
32560,1920,2031,1.0,1975.5,-111
32561,1653,1580,0.0,1616.5,73
32562,1883,1920,1.0,1901.5,-37
32563,1479,1577,0.0,1528.0,-98
32564,1606,1808,1.0,1707.0,-202
32565,1944,1910,0.0,1927.0,34
32566,2074,1565,0.0,1819.5,509
32567,1987,2011,0.5,1999.0,-24
32568,1689,1779,0.5,1734.0,-90
32569,1952,2131,1.0,2041.5,-179
32570,1960,2036,0.0,1998.0,-76
32571,1953,1899,1.0,1926.0,54
32572,2119,1909,1.0,2014.0,210
32573,1729,1976,0.0,1852.5,-247
32574,1848,2055,0.0,1951.5,-207
32575,2190,1769,1.0,1979.5,421
32576,1720,1964,0.0,1842.0,-244
32577,1904,1723,1.0,1813.5,181
32578,2070,2085,1.0,2077.5,-15
32579,1933,2060,0.0,1996.5,-127
32580,2020,2032,1.0,2026.0,-12
32581,1828,1884,1.0,1856.0,-56
32582,1724,1630,1.0,1677.0,94
32583,1817,1777,1.0,1797.0,40
32584,1668,1783,0.0,1725.5,-115
32585,1532,1830,1.0,1681.0,-298
32586,2372,2137,1.0,2254.5,235
32587,2105,2114,0.5,2109.5,-9
32588,2226,2057,1.0,2141.5,169
32589,2042,2132,0.0,2087.0,-90
32590,2283,2288,1.0,2285.5,-5
32591,2357,2239,1.0,2298.0,118
32592,2166,2299,0.0,2232.5,-133
32593,2312,2202,0.5,2257.0,110
32594,2743,2613,1.0,2678.0,130
32595,2602,2724,1.0,2663.0,-122
32596,2659,2602,0.5,2630.5,57
32597,2554,2613,0.5,2583.5,-59
32598,2760,2772,1.0,2766.0,-12
32599,2681,2751,0.5,2716.0,-70
32600,2786,2553,0.0,2669.5,233
32601,2548,2714,0.5,2631.0,-166
32602,2805,2877,0.5,2841.0,-72
32603,2630,2686,0.0,2658.0,-56
32604,2672,2628,0.5,2650.0,44
32605,2528,2655,0.5,2591.5,-127
32606,2718,2745,0.5,2731.5,-27
32607,2631,2742,0.5,2686.5,-111
32608,2668,2662,0.5,2665.0,6
32609,2638,2638,0.5,2638.0,0
32610,2744,2700,0.0,2722.0,44
32611,2615,2717,0.5,2666.0,-102
32612,2723,2510,1.0,2616.5,213
32613,2471,2680,1.0,2575.5,-209
32614,2753,2760,0.5,2756.5,-7
32615,2664,2671,1.0,2667.5,-7
32616,2656,2649,1.0,2652.5,7
32617,2603,2624,1.0,2613.5,-21
32618,2531,2632,0.5,2581.5,-101
32619,2589,2559,0.0,2574.0,30
32620,2461,2529,1.0,2495.0,-68
32621,2614,2470,0.5,2542.0,144
32622,2713,2545,1.0,2629.0,168
32623,2535,2618,0.5,2576.5,-83
32624,2581,2508,0.5,2544.5,73
32625,2491,2542,0.0,2516.5,-51
32626,2710,2740,0.0,2725.0,-30
32627,2665,2634,0.0,2649.5,31
32628,2501,2650,0.5,2575.5,-149
32629,2653,2507,0.5,2580.0,146
32630,2709,2549,1.0,2629.0,160
32631,2505,2646,0.5,2575.5,-141
32632,2689,2461,0.5,2575.0,228
32633,2365,2612,1.0,2488.5,-247
32634,2484,2671,0.0,2577.5,-187
32635,2563,2487,0.5,2525.0,76
32636,2500,2608,0.5,2554.0,-108
32637,2548,2426,1.0,2487.0,122
32638,2768,2574,1.0,2671.0,194
32639,2574,2720,0.5,2647.0,-146
32640,2680,2562,1.0,2621.0,118
32641,2541,2624,0.0,2582.5,-83
32642,2716,2571,0.5,2643.5,145
32643,2595,2676,0.0,2635.5,-81
32644,2634,2549,1.0,2591.5,85
32645,2554,2549,0.5,2551.5,5
32646,2500,2659,0.5,2579.5,-159
32647,2618,2477,1.0,2547.5,141
32648,2450,2569,1.0,2509.5,-119
32649,2537,2440,0.0,2488.5,97
32650,2625,2215,1.0,2420.0,410
32651,2214,2574,1.0,2394.0,-360
32652,2554,2156,1.0,2355.0,398
32653,2116,2561,0.0,2338.5,-445
32654,2441,2604,0.0,2522.5,-163
32655,2522,2431,0.0,2476.5,91
32656,2347,2503,0.5,2425.0,-156
32657,2473,2349,1.0,2411.0,124
32658,2594,2544,0.5,2569.0,50
32659,2606,2598,0.5,2602.0,8
32660,2499,2402,1.0,2450.5,97
32661,2447,2424,0.5,2435.5,23
32662,2622,2787,0.5,2704.5,-165
32663,2659,2593,0.5,2626.0,66
32664,2528,2653,1.0,2590.5,-125
32665,2624,2458,1.0,2541.0,166
32666,2678,2644,1.0,2661.0,34
32667,2556,2595,0.5,2575.5,-39
32668,2532,2432,0.5,2482.0,100
32669,2447,2514,0.5,2480.5,-67
32670,2740,2698,0.5,2719.0,42
32671,2624,2637,0.0,2630.5,-13
32672,2690,2620,1.0,2655.0,70
32673,2618,2704,1.0,2661.0,-86
32674,2627,2296,1.0,2461.5,331
32675,2374,2487,0.0,2430.5,-113
32676,2589,2374,1.0,2481.5,215
32677,2291,2486,0.5,2388.5,-195
32678,2527,2649,1.0,2588.0,-122
32679,2568,2400,0.5,2484.0,168
32680,2522,2583,0.5,2552.5,-61
32681,2645,2250,1.0,2447.5,395
32682,2505,2521,0.0,2513.0,-16
32683,2669,2590,1.0,2629.5,79
32684,2486,2437,0.5,2461.5,49
32685,2591,2619,0.0,2605.0,-28
32686,2659,2735,1.0,2697.0,-76
32687,2277,2350,0.0,2313.5,-73
32688,2612,2576,1.0,2594.0,36
32689,2578,2225,1.0,2401.5,353
32690,2571,2602,0.5,2586.5,-31
32691,2448,2474,0.5,2461.0,-26
32692,2453,2487,0.5,2470.0,-34
32693,2663,2423,0.5,2543.0,240
32694,2522,2523,0.5,2522.5,-1
32695,2630,2629,1.0,2629.5,1
32696,2418,2421,0.0,2419.5,-3
32697,2544,2553,0.5,2548.5,-9
32698,2641,2644,0.5,2642.5,-3
32699,2519,2517,0.5,2518.0,2
32700,2544,2608,1.0,2576.0,-64
32701,2644,2351,0.5,2497.5,293
32702,2427,2489,0.0,2458.0,-62
32703,2323,2602,1.0,2462.5,-279
32704,2387,2382,1.0,2384.5,5
32705,2654,2277,0.5,2465.5,377
32706,2186,2307,0.0,2246.5,-121
32707,2467,2547,1.0,2507.0,-80
32708,2160,2170,0.5,2165.0,-10
32709,2513,2396,0.5,2454.5,117
32710,2587,2565,1.0,2576.0,22
32711,2439,2462,0.0,2450.5,-23
32712,2530,2560,0.5,2545.0,-30
32713,2533,2334,0.0,2433.5,199
32714,2526,2590,0.5,2558.0,-64
32715,2457,2537,0.5,2497.0,-80
32716,2363,2438,0.5,2400.5,-75
32717,2562,2398,0.5,2480.0,164
32718,2650,2709,1.0,2679.5,-59
32719,2525,2522,0.0,2523.5,3
32720,2496,2524,0.5,2510.0,-28
32721,2396,2533,0.5,2464.5,-137
32722,2406,2469,1.0,2437.5,-63
32723,2254,2082,0.0,2168.0,172
32724,2224,2303,0.0,2263.5,-79
32725,2387,2139,1.0,2263.0,248
32726,2164,2141,0.0,2152.5,23
32727,2289,2392,1.0,2340.5,-103
32728,2067,2154,0.0,2110.5,-87
32729,2063,2277,0.0,2170.0,-214
32730,2390,2653,0.5,2521.5,-263
32731,2081,2125,1.0,2103.0,-44
32732,2313,2318,1.0,2315.5,-5
32733,2513,2120,0.5,2316.5,393
32734,2410,2590,0.5,2500.0,-180
32735,2411,2390,0.5,2400.5,21
32736,2181,2337,0.0,2259.0,-156
32737,2263,2418,1.0,2340.5,-155
32738,2320,2361,1.0,2340.5,-41
32739,2246,2085,0.0,2165.5,161
32740,2322,2256,1.0,2289.0,66
32741,2611,2272,1.0,2441.5,339
32742,2333,2438,0.0,2385.5,-105
32743,2251,2433,0.0,2342.0,-182
32744,2239,2286,1.0,2262.5,-47
32745,2112,1893,0.0,2002.5,219
32746,2279,2388,1.0,2333.5,-109
32747,2014,2253,0.0,2133.5,-239
32748,2508,2065,1.0,2286.5,443
32749,2416,2581,0.0,2498.5,-165
32750,2320,2170,0.5,2245.0,150
32751,2061,2382,0.0,2221.5,-321
32752,2216,2145,1.0,2180.5,71
32753,1829,2114,0.5,1971.5,-285
32754,1946,2106,0.0,2026.0,-160
32755,1884,1846,1.0,1865.0,38
32756,2222,2188,0.0,2205.0,34
32757,2333,2378,1.0,2355.5,-45
32758,2195,2193,1.0,2194.0,2
32759,2236,2289,0.0,2262.5,-53
32760,2315,2144,0.0,2229.5,171
32761,2365,2449,0.0,2407.0,-84
32762,2226,2326,1.0,2276.0,-100
32763,2320,2316,1.0,2318.0,4
32764,2164,2140,0.5,2152.0,24
32765,2495,2502,0.5,2498.5,-7
32766,2087,2056,0.0,2071.5,31
32767,2382,2419,1.0,2400.5,-37
32768,2236,2090,0.0,2163.0,146
32769,1930,2068,0.0,1999.0,-138
32770,2069,2104,0.0,2086.5,-35
32771,2137,2061,1.0,2099.0,76
32772,2408,2078,1.0,2243.0,330
32773,2332,2472,1.0,2402.0,-140
32774,2224,2323,0.5,2273.5,-99
32775,2150,2283,0.0,2216.5,-133
32776,2387,2211,1.0,2299.0,176
32777,2413,2416,0.5,2414.5,-3
32778,2311,2383,0.5,2347.0,-72
32779,2273,2392,1.0,2332.5,-119
32780,2317,2177,0.0,2247.0,140
32781,2368,2354,0.5,2361.0,14
32782,2121,2405,1.0,2263.0,-284
32783,2106,2229,0.0,2167.5,-123
32784,2344,2335,0.5,2339.5,9
32785,2259,2425,0.5,2342.0,-166
32786,2252,2373,0.5,2312.5,-121
32787,2103,2166,1.0,2134.5,-63
32788,2523,2183,1.0,2353.0,340
32789,2090,2317,0.0,2203.5,-227
32790,2122,2222,0.5,2172.0,-100
32791,2105,2172,1.0,2138.5,-67
32792,2087,2121,1.0,2104.0,-34
32793,1751,2024,0.5,1887.5,-273
32794,2436,2054,1.0,2245.0,382
32795,1931,2346,0.0,2138.5,-415
32796,2275,2305,0.0,2290.0,-30
32797,2297,2333,0.5,2315.0,-36
32798,2425,2350,1.0,2387.5,75
32799,2282,2272,1.0,2277.0,10
32800,2190,2231,1.0,2210.5,-41
32801,2437,1950,1.0,2193.5,487
32802,1802,2431,0.0,2116.5,-629
32803,2425,1755,1.0,2090.0,670
32804,2256,2445,0.0,2350.5,-189
32805,2365,2463,0.5,2414.0,-98
32806,2321,2249,0.0,2285.0,72
32807,2172,2222,0.0,2197.0,-50
32808,2121,2352,0.5,2236.5,-231
32809,2380,2471,1.0,2425.5,-91
32810,2218,2194,0.0,2206.0,24
32811,2173,2189,1.0,2181.0,-16
32812,2126,1986,0.5,2056.0,140
32813,2139,2154,0.0,2146.5,-15
32814,2165,2258,1.0,2211.5,-93
32815,1979,2079,0.5,2029.0,-100
32816,2106,2103,0.0,2104.5,3
32817,2277,2341,0.5,2309.0,-64
32818,1858,2111,0.0,1984.5,-253
32819,1965,2296,0.5,2130.5,-331
32820,1996,1878,0.0,1937.0,118
32821,2046,2064,0.0,2055.0,-18
32822,2031,2036,0.5,2033.5,-5
32823,2067,1920,1.0,1993.5,147
32824,1883,1920,1.0,1901.5,-37
32825,2081,1803,0.5,1942.0,278
32826,1606,1808,0.0,1707.0,-202
32827,2068,2311,1.0,2189.5,-243
32828,1944,2039,0.0,1991.5,-95
32829,2002,2070,1.0,2036.0,-68
32830,1875,1312,0.5,1593.5,563
32831,2251,2143,1.0,2197.0,108
32832,2106,2169,1.0,2137.5,-63
32833,2283,1922,1.0,2102.5,361
32834,1799,2239,1.0,2019.0,-440
32835,1685,2202,0.0,1943.5,-517
32836,1746,2311,0.0,2028.5,-565
32837,2309,2044,1.0,2176.5,265
32838,2075,2143,0.0,2109.0,-68
32839,2036,2123,1.0,2079.5,-87
32840,1951,1953,1.0,1952.0,-2
32841,1963,1972,1.0,1967.5,-9
32842,2063,2060,0.5,2061.5,3
32843,2017,2190,0.0,2103.5,-173
32844,1964,2115,0.0,2039.5,-151
32845,1985,1904,0.0,1944.5,81
32846,2280,2181,1.0,2230.5,99
32847,1977,1933,0.0,1955.0,44
32848,1993,2245,1.0,2119.0,-252
32849,2137,2030,0.5,2083.5,107
32850,1910,1944,0.5,1927.0,-34
32851,2105,2113,0.5,2109.0,-8
32852,1565,2074,1.0,1819.5,-509
32853,2183,2057,1.0,2120.0,126
32854,1976,2270,0.0,2123.0,-294
32855,1883,2099,0.0,1991.0,-216
32856,2210,2244,0.5,2227.0,-34
32857,1969,1828,0.0,1898.5,141
32858,2125,2177,1.0,2151.0,-52
32859,2131,1892,0.0,2011.5,239
32860,2261,2334,1.0,2297.5,-73
32861,2194,1952,0.0,2073.0,242
32862,2244,2299,1.0,2271.5,-55
32863,2012,1960,1.0,1986.0,52
32864,2118,2243,0.5,2180.5,-125
32865,2070,2261,1.0,2165.5,-191
32866,2201,1880,1.0,2040.5,321
32867,2056,1993,0.0,2024.5,63
32868,2026,2000,1.0,2013.0,26
32869,1963,1948,1.0,1955.5,15
32870,1899,1844,0.0,1871.5,55
32871,1630,1828,1.0,1729.0,-198
32872,1777,1724,1.0,1750.5,53
32873,2272,1817,1.0,2044.5,455
32874,1830,2085,1.0,1957.5,-255
32875,2125,1532,1.0,1828.5,593
32876,2085,1846,0.5,1965.5,239
32877,1987,2011,0.5,1999.0,-24
32878,2032,2001,0.5,2016.5,31
32879,1817,1952,0.0,1884.5,-135
32880,1779,2020,0.5,1899.5,-241
32881,1833,1841,0.0,1837.0,-8
32882,1689,1688,0.0,1688.5,1
32883,2070,1908,0.0,1989.0,162
32884,2180,2060,0.5,2120.0,120
32885,1580,1645,0.5,1612.5,-65
32886,1577,1653,0.5,1615.0,-76
32887,1909,1479,1.0,1694.0,430
32888,1729,2030,0.0,1879.5,-301
32889,1783,1817,0.0,1800.0,-34
32890,1848,1845,1.0,1846.5,3
32891,1723,1720,0.0,1721.5,3
32892,2273,2372,0.0,2322.5,-99
32893,2329,2197,1.0,2263.0,132
32894,2187,2226,0.5,2206.5,-39
32895,2132,2156,1.0,2144.0,-24
32896,2288,2536,0.0,2412.0,-248
32897,2543,2357,1.0,2450.0,186
32898,2299,2448,0.0,2373.5,-149
32899,2426,2312,1.0,2369.0,114
32900,2743,2713,1.0,2728.0,30
32901,2618,2724,0.5,2671.0,-106
32902,2659,2542,1.0,2600.5,117
32903,2563,2649,0.0,2606.0,-86
32904,2613,2772,0.0,2692.5,-159
32905,2681,2602,0.5,2641.5,79
32906,2602,2553,0.5,2577.5,49
32907,2461,2539,0.0,2500.0,-78
32908,2801,2877,0.0,2839.0,-76
32909,2628,2565,1.0,2596.5,63
32910,2587,2528,1.0,2557.5,59
32911,2528,2560,1.0,2544.0,-32
32912,2760,2531,0.5,2645.5,229
32913,2559,2664,0.0,2611.5,-105
32914,2649,2461,1.0,2555.0,188
32915,2425,2603,0.0,2514.0,-178
32916,2700,2760,1.0,2730.0,-60
32917,2795,2615,1.0,2705.0,180
32918,2510,2751,0.5,2630.5,-241
32919,2714,2471,1.0,2592.5,243
32920,2604,2768,0.5,2686.0,-164
32921,2720,2522,0.5,2621.0,198
32922,2503,2708,0.5,2605.5,-205
32923,2624,2473,0.5,2548.5,151
32924,2671,2527,0.5,2599.0,144
32925,2400,2606,0.0,2503.0,-206
32926,2186,2548,0.5,2367.0,-362
32927,2718,2627,0.5,2672.5,91
32928,2466,2742,0.0,2604.0,-276
32929,2668,2589,1.0,2628.5,79
32930,2486,2666,0.0,2576.0,-180
32931,2710,2740,0.5,2725.0,-30
32932,2637,2634,0.5,2635.5,3
32933,2501,2690,0.0,2595.5,-189
32934,2676,2507,1.0,2591.5,169
32935,2745,2598,0.5,2671.5,147
32936,2499,2631,0.5,2565.0,-132
32937,2664,2424,1.0,2544.0,240
32938,2490,2638,0.0,2564.0,-148
32939,2500,2716,0.0,2608.0,-216
32940,2676,2450,0.5,2563.0,226
32941,2440,2634,0.0,2537.0,-194
32942,2549,2353,0.5,2451.0,196
32943,2740,2805,0.5,2772.5,-65
32944,2686,2665,0.5,2675.5,21
32945,2665,2672,0.0,2668.5,-7
32946,2655,2653,0.5,2654.0,2
32947,2625,2678,1.0,2651.5,-53
32948,2580,2574,0.5,2577.0,6
32949,2579,2532,1.0,2555.5,47
32950,2514,2561,0.5,2537.5,-47
32951,2545,2709,0.5,2627.0,-164
32952,2646,2535,0.5,2590.5,111
32953,2508,2639,0.5,2573.5,-131
32954,2689,2411,1.0,2550.0,278
32955,2645,2654,1.0,2649.5,-9
32956,2547,2669,0.5,2608.0,-122
32957,2619,2467,1.0,2543.0,152
32958,2203,2565,0.0,2384.0,-362
32959,2709,2632,1.0,2670.5,77
32960,2589,2650,0.5,2619.5,-61
32961,2572,2569,0.5,2570.5,3
32962,2614,2496,0.0,2555.0,118
32963,2744,2578,1.0,2661.0,166
32964,2473,2717,0.0,2595.0,-244
32965,2723,2448,0.5,2585.5,275
32966,2423,2707,0.0,2565.0,-284
32967,2753,2622,0.5,2687.5,131
32968,2593,2656,1.0,2624.5,-63
32969,2624,2473,1.0,2548.5,151
32970,2528,2651,0.5,2589.5,-123
32971,2735,2663,0.5,2699.0,72
32972,2629,2659,0.5,2644.0,-30
32973,2576,2630,1.0,2603.0,-54
32974,2553,2640,0.5,2596.5,-87
32975,2644,2549,0.5,2596.5,95
32976,2505,2641,0.5,2573.0,-136
32977,2608,2461,0.5,2534.5,147
32978,2365,2544,1.0,2454.5,-179
32979,2787,2644,0.5,2715.5,143
32980,2602,2706,0.5,2654.0,-104
32981,2653,2455,1.0,2554.0,198
32982,2323,2624,0.0,2473.5,-301
32983,2644,2590,1.0,2617.0,54
32984,2526,2556,0.0,2541.0,-30
32985,2432,2438,0.5,2435.0,-6
32986,2363,2447,0.5,2405.0,-84
32987,2659,2508,0.0,2583.5,151
32988,2170,2618,0.0,2394.0,-448
32989,2569,2320,1.0,2444.5,249
32990,2145,2490,0.5,2317.5,-345
32991,2536,2507,1.0,2521.5,29
32992,2361,2543,0.5,2452.0,-182
32993,2448,2320,0.0,2384.0,128
32994,2256,2555,0.5,2405.5,-299
32995,2083,2544,0.0,2313.5,-461
32996,2435,2121,1.0,2278.0,314
32997,2087,2402,0.5,2244.5,-315
32998,2447,2024,1.0,2235.5,423
32999,2698,2405,1.0,2551.5,293
33000,2250,2624,0.0,2437.0,-374
33001,2620,2121,1.0,2370.5,499
33002,2193,2603,0.0,2398.0,-410
33003,2571,2387,0.5,2479.0,184
33004,2392,2549,1.0,2470.5,-157
33005,2559,2277,1.0,2418.0,282
33006,2239,2554,0.0,2396.5,-315
33007,2218,2335,0.0,2276.5,-117
33008,2156,2214,1.0,2185.0,-58
33009,2570,2116,1.0,2343.0,454
33010,1829,2114,0.0,1971.5,-285
33011,2583,2568,1.0,2575.5,15
33012,1884,1873,0.0,1878.5,11
33013,2653,2522,1.0,2587.5,131
33014,2406,2469,1.0,2437.5,-63
33015,2390,2448,1.0,2419.0,-58
33016,2303,2384,0.5,2343.5,-81
33017,2408,2318,0.5,2363.0,90
33018,2431,2441,1.0,2436.0,-10
33019,2224,2323,0.0,2273.5,-99
33020,2347,2419,0.0,2383.0,-72
33021,2574,2211,1.0,2392.5,363
33022,2487,2484,0.5,2485.5,3
33023,2562,2564,1.0,2563.0,-2
33024,2426,2464,0.0,2445.0,-38
33025,2502,2541,1.0,2521.5,-39
33026,2222,2523,0.0,2372.5,-301
33027,2419,2495,1.0,2457.0,-76
33028,2117,2176,0.5,2146.5,-59
33029,2296,2382,1.0,2339.0,-86
33030,2279,2388,0.0,2333.5,-109
33031,2374,2374,1.0,2374.0,0
33032,2425,2291,0.0,2358.0,134
33033,2346,2436,1.0,2391.0,-90
33034,2166,2259,0.0,2212.5,-93
33035,2305,2275,1.0,2290.0,30
33036,2068,2103,0.0,2085.5,-35
33037,2255,2333,1.0,2294.0,-78
33038,1980,2061,0.0,2020.5,-81
33039,2190,2272,1.0,2231.0,-82
33040,2448,2137,0.0,2292.5,311
33041,2517,2544,1.0,2530.5,-27
33042,2222,2463,0.5,2342.5,-241
33043,2351,2467,1.0,2409.0,-116
33044,2591,2172,1.0,2381.5,419
33045,2258,2329,1.0,2293.5,-71
33046,2425,2431,1.0,2428.0,-6
33047,2103,2165,0.0,2134.0,-62
33048,2489,2445,0.5,2467.0,44
33049,2505,2521,0.5,2513.0,-16
33050,2387,2427,0.5,2407.0,-40
33051,2486,2437,1.0,2461.5,49
33052,2307,2391,0.0,2349.0,-84
33053,2586,2571,0.5,2578.5,15
33054,2186,2157,0.0,2171.5,29
33055,2453,2487,1.0,2470.0,-34
33056,2591,2160,1.0,2375.5,431
33057,2457,2537,1.0,2497.0,-80
33058,2277,2350,0.0,2313.5,-73
33059,2398,2455,1.0,2426.5,-57
33060,2523,2225,0.0,2374.0,298
33061,2433,2611,1.0,2522.0,-178
33062,2421,2522,0.5,2471.5,-101
33063,1893,2328,0.0,2110.5,-435
33064,2462,2453,0.5,2457.5,9
33065,2195,2222,0.0,2208.5,-27
33066,2402,2439,1.0,2420.5,-37
33067,2070,2144,0.0,2107.0,-74
33068,2438,2334,0.5,2386.0,104
33069,2318,2449,1.0,2383.5,-131
33070,2286,2333,0.0,2309.5,-47
33071,2316,2365,1.0,2340.5,-49
33072,2387,2239,1.0,2313.0,148
33073,2326,2315,0.0,2320.5,11
33074,2383,2366,1.0,2374.5,17
33075,2140,2226,0.0,2183.0,-86
33076,2471,2311,1.0,2391.0,160
33077,2413,2416,0.5,2414.5,-3
33078,2380,2330,0.0,2355.0,50
33079,2266,2273,0.0,2269.5,-7
33080,2067,2189,0.0,2128.0,-122
33081,2333,2378,1.0,2355.5,-45
33082,2081,1803,0.0,1942.0,278
33083,2236,2289,0.0,2262.5,-53
33084,2341,2311,0.0,2326.0,30
33085,2525,2522,1.0,2523.5,3
33086,2125,2277,0.0,2201.0,-152
33087,2477,2533,1.0,2505.0,-56
33088,2334,1965,0.0,2149.5,369
33089,2180,2396,0.5,2288.0,-216
33090,2299,2261,1.0,2280.0,38
33091,2139,2254,1.0,2196.5,-115
33092,2590,2244,1.0,2417.0,346
33093,1993,2201,0.0,2097.0,-208
33094,2301,2337,1.0,2319.0,-36
33095,1996,2181,0.0,2088.5,-185
33096,2125,2063,1.0,2094.0,62
33097,2031,2036,0.0,2033.5,-5
33098,2121,2081,1.0,2101.0,40
33099,2414,1920,0.0,2167.0,494
33100,2416,2581,0.5,2498.5,-165
33101,2177,2244,0.0,2210.5,-67
33102,2382,2284,0.5,2333.0,98
33103,1951,2125,0.0,2038.0,-174
33104,2106,2216,1.0,2161.0,-110
33105,1972,2036,0.5,2004.0,-64
33106,2188,1946,1.0,2067.0,242
33107,2236,1963,0.5,2099.5,273
33108,2373,2344,1.0,2358.5,29
33109,2104,2110,0.0,2107.0,-6
33110,2183,2252,1.0,2217.5,-69
33111,2354,2069,1.0,2211.5,285
33112,2085,2263,0.0,2174.0,-178
33113,2229,2368,0.5,2298.5,-139
33114,2272,2246,0.0,2259.0,26
33115,2332,2106,1.0,2219.0,226
33116,2239,2283,0.0,2261.0,-44
33117,2150,2283,0.0,2216.5,-133
33118,2202,2166,0.5,2184.0,36
33119,2060,2128,0.0,2094.0,-68
33120,2056,2164,1.0,2110.0,-108
33121,2115,2017,0.5,2066.0,98
33122,2024,2087,0.0,2055.5,-63
33123,2118,2280,0.5,2199.0,-162
33124,2225,2261,1.0,2243.0,-36
33125,2221,2245,0.5,2233.0,-24
33126,1993,2070,1.0,2031.5,-77
33127,2317,2143,1.0,2230.0,174
33128,2251,2090,1.0,2170.5,161
33129,2173,2106,0.0,2139.5,67
33130,1951,2105,0.5,2028.0,-154
33131,2311,2183,1.0,2247.0,128
33132,2048,2309,0.5,2178.5,-261
33133,2139,2121,0.0,2130.0,18
33134,2164,2183,1.0,2173.5,-19
33135,2112,2154,0.0,2133.0,-42
33136,2067,2014,1.0,2040.5,53
33137,2065,2093,0.0,2079.0,-28
33138,1944,2272,0.5,2108.0,-328
33139,2085,2074,0.5,2079.5,11
33140,2051,2125,0.0,2088.0,-74
33141,1760,1565,0.5,1662.5,195
33142,2085,2068,0.0,2076.5,17
33143,2070,2046,1.0,2058.0,24
33144,2038,2024,1.0,2031.0,14
33145,1828,2273,1.0,2050.5,-445
33146,2197,1630,1.0,1913.5,567
33147,1724,2168,0.0,1946.0,-444
33148,2187,1777,1.0,1982.0,410
33149,1928,2055,0.0,1991.5,-127
33150,2121,2106,1.0,2113.5,15
33151,1945,2194,0.5,2069.5,-249
33152,2218,1858,1.0,2038.0,360
33153,1878,1986,0.0,1932.0,-108
33154,2139,2256,0.0,2197.5,-117
33155,2249,2084,1.0,2166.5,165
33156,2079,2321,0.0,2200.0,-242
33157,2352,1979,1.0,2165.5,373
33158,1802,2085,0.0,1943.5,-283
33159,2001,1755,1.0,1878.0,246
33160,2020,1933,1.0,1976.5,87
33161,1841,1883,0.0,1862.0,-42
33162,1808,1833,1.0,1820.5,-25
33163,2039,1606,0.0,1822.5,433
33164,2060,2070,0.0,2065.0,-10
33165,1312,1944,0.5,1628.0,-632
33166,1884,1875,1.0,1879.5,9
33167,2270,1880,1.0,2075.0,390
33168,2056,2119,0.0,2087.5,-63
33169,1889,2000,0.5,1944.5,-111
33170,1746,2137,0.0,1941.5,-391
33171,2113,2044,1.0,2078.5,69
33172,2075,2105,0.0,2090.0,-30
33173,1860,2036,0.5,1948.0,-176
33174,1953,1933,0.0,1943.0,20
33175,1977,1899,1.0,1938.0,78
33176,2012,2030,0.0,2021.0,-18
33177,2063,2055,0.0,2059.0,8
33178,1964,2190,1.0,2077.0,-226
33179,1908,1937,0.0,1922.5,-29
33180,1883,2180,0.0,2031.5,-297
33181,1645,1828,0.0,1736.5,-183
33182,1969,1580,1.0,1774.5,389
33183,2030,1817,0.0,1923.5,213
33184,1817,1532,1.0,1674.5,285
33185,1909,2131,0.0,2020.0,-222
33186,1707,1948,0.0,1827.5,-241
33187,1799,1922,0.5,1860.5,-123
33188,1899,1844,0.5,1871.5,55
33189,2011,1987,0.0,1999.0,24
33190,1779,1848,1.0,1813.5,-69
33191,1769,1688,1.0,1728.5,81
33192,1622,1723,0.5,1672.5,-101
33193,1653,1783,0.5,1718.0,-130
33194,1668,1577,0.0,1622.5,91
33195,2372,2513,0.0,2442.5,-141
33196,2390,2329,0.5,2359.5,61
33197,2114,2411,0.0,2262.5,-297
33198,2501,2132,1.0,2316.5,369
33199,2288,2297,1.0,2292.5,-9
33200,2350,2357,0.5,2353.5,-7
33201,2299,2282,1.0,2290.5,17
33202,2246,2312,1.0,2279.0,-66
33203,2760,2743,1.0,2751.5,17
33204,2724,2664,1.0,2694.0,60
33205,2649,2659,0.5,2654.0,-10
33206,2613,2603,1.0,2608.0,10
33207,2716,2795,1.0,2755.5,-79
33208,2751,2676,0.0,2713.5,75
33209,2634,2786,0.5,2710.0,-152
33210,2714,2549,0.5,2631.5,165
33211,2877,2709,0.0,2793.0,168
33212,2639,2630,0.5,2634.5,9
33213,2628,2689,0.5,2658.5,-61
33214,2612,2528,0.5,2570.0,84
33215,2602,2742,0.0,2672.0,-140
33216,2668,2602,1.0,2635.0,66
33217,2554,2666,0.5,2610.0,-112
33218,2638,2539,1.0,2588.5,99
33219,2772,2745,0.5,2758.5,27
33220,2631,2681,0.5,2656.0,-50
33221,2553,2664,1.0,2608.5,-111
33222,2662,2548,0.0,2605.0,114
33223,2671,2625,0.5,2648.0,46
33224,2574,2606,0.5,2590.0,-32
33225,2608,2579,0.5,2593.5,29
33226,2554,2548,1.0,2551.0,6
33227,2805,2740,1.0,2772.5,65
33228,2637,2686,1.0,2661.5,-49
33229,2672,2704,0.5,2688.0,-32
33230,2676,2655,0.5,2665.5,21
33231,2768,2713,1.0,2740.5,55
33232,2618,2720,0.0,2669.0,-102
33233,2708,2581,0.0,2644.5,127
33234,2542,2680,0.0,2611.0,-138
33235,2549,2645,0.5,2597.0,-96
33236,2590,2505,1.0,2547.5,85
33237,2461,2669,0.0,2565.0,-208
33238,2619,2365,0.5,2492.0,254
33239,2787,2700,1.0,2743.5,87
33240,2615,2706,0.5,2660.5,-91
33241,2659,2510,1.0,2584.5,149
33242,2471,2624,0.0,2547.5,-153
33243,2735,2604,1.0,2669.5,131
33244,2522,2659,0.5,2590.5,-137
33245,2576,2503,1.0,2539.5,73
33246,2473,2612,0.5,2542.5,-139
33247,2531,2744,0.0,2637.5,-213
33248,2717,2559,1.0,2638.0,158
33249,2461,2680,0.0,2570.5,-219
33250,2707,2470,0.5,2588.5,237
33251,2649,2709,0.0,2679.0,-60
33252,2650,2570,0.5,2610.0,80
33253,2568,2572,1.0,2570.0,-4
33254,2496,2583,0.0,2539.5,-87
33255,2622,2740,0.5,2681.0,-118
33256,2665,2593,1.0,2629.0,72
33257,2528,2650,0.0,2589.0,-122
33258,2653,2458,0.5,2555.5,195
33259,2513,2671,0.5,2592.0,-158
33260,2656,2411,1.0,2533.5,245
33261,2501,2624,0.0,2562.5,-123
33262,2651,2418,0.5,2534.5,233
33263,2627,2477,1.0,2552.0,150
33264,2450,2487,1.0,2468.5,-37
33265,2466,2440,1.0,2453.0,26
33266,2353,2486,1.0,2419.5,-133
33267,2698,2571,1.0,2634.5,127
33268,2595,2624,0.0,2609.5,-29
33269,2618,2559,0.5,2588.5,59
33270,2554,2603,0.5,2578.5,-49
33271,2659,2653,1.0,2656.0,6
33272,2390,2618,0.5,2504.0,-228
33273,2569,2318,0.5,2443.5,251
33274,2313,2537,0.5,2425.0,-224
33275,2594,2644,0.5,2619.0,-50
33276,2556,2598,0.5,2577.0,-42
33277,2499,2432,0.5,2465.5,67
33278,2460,2490,0.5,2475.0,-30
33279,2544,2678,0.5,2611.0,-134
33280,2580,2606,1.0,2593.0,-26
33281,2435,2595,0.5,2515.0,-160
33282,2514,2447,1.0,2480.5,67
33283,2525,2710,0.5,2617.5,-185
33284,2501,2296,0.5,2398.5,205
33285,2374,2439,0.5,2406.5,-65
33286,2507,2374,0.5,2440.5,133
33287,2435,2527,0.0,2481.0,-92
33288,2400,2436,1.0,2418.0,-36
33289,2250,2275,1.0,2262.5,-25
33290,2333,2574,0.0,2453.5,-241
33291,2574,2255,1.0,2414.5,319
33292,2425,2564,0.5,2494.5,-139
33293,2562,2272,1.0,2417.0,290
33294,2441,2502,0.5,2471.5,-61
33295,2495,2431,1.0,2463.0,64
33296,2419,2419,1.0,2419.0,0
33297,2382,2349,0.0,2365.5,33
33298,2335,2536,0.0,2435.5,-201
33299,2543,2426,0.5,2484.5,117
33300,2632,2644,0.5,2638.0,-12
33301,2602,2589,0.0,2595.5,13
33302,2529,2323,1.0,2426.0,206
33303,2277,2569,0.5,2423.0,-292
33304,2544,2513,0.5,2528.5,31
33305,2462,2517,1.0,2489.5,-55
33306,2519,2402,0.0,2460.5,117
33307,2334,2351,1.0,2342.5,-17
33308,2801,2330,1.0,2565.5,471
33309,2380,2587,1.0,2483.5,-207
33310,2560,2189,1.0,2374.5,371
33311,2173,2530,0.0,2351.5,-357
33312,2663,2644,0.5,2653.5,19
33313,2641,2629,0.5,2635.0,12
33314,2630,2608,0.5,2619.0,22
33315,2526,2553,0.0,2539.5,-27
33316,2602,2591,0.5,2596.5,11
33317,2437,2571,0.5,2504.0,-134
33318,2586,2425,1.0,2505.5,161
33319,2445,2487,1.0,2466.0,-42
33320,2590,2545,0.5,2567.5,45
33321,2535,2526,0.5,2530.5,9
33322,2438,2508,0.5,2473.0,-70
33323,2491,2363,1.0,2427.0,128
33324,2449,2473,0.5,2461.0,-24
33325,2474,2318,1.0,2396.0,156
33326,2365,2448,0.0,2406.5,-83
33327,2423,2320,1.0,2371.5,103
33328,2507,2611,0.5,2559.0,-104
33329,2433,2320,1.0,2376.5,113
33330,2256,2328,0.0,2292.0,-72
33331,2251,2322,1.0,2286.5,-71
33332,2547,2533,1.0,2540.0,14
33333,2537,2467,1.0,2502.0,70
33334,2203,2457,0.0,2330.0,-254
33335,2398,2396,1.0,2397.0,2
33336,2378,2387,0.0,2382.5,-9
33337,2366,2399,0.5,2382.5,-33
33338,2333,2383,0.0,2358.0,-50
33339,2311,2289,0.5,2300.0,22
33340,2521,2562,1.0,2541.5,-41
33341,2522,2505,1.0,2513.5,17
33342,2437,2533,0.0,2485.0,-96
33343,2477,2486,0.5,2481.5,-9
33344,2387,2068,1.0,2227.5,319
33345,2061,2392,0.0,2226.5,-331
33346,2289,1980,1.0,2134.5,309
33347,2137,2277,0.0,2207.0,-140
33348,2469,2218,0.5,2343.5,251
33349,2215,2406,0.5,2310.5,-191
33350,2384,2214,1.0,2299.0,170
33351,2156,2224,1.0,2190.0,-68
33352,2523,2396,0.5,2459.5,127
33353,2180,2222,0.5,2201.0,-42
33354,2176,2082,0.0,2129.0,94
33355,2139,2122,0.0,2130.5,17
33356,2083,2590,0.0,2336.5,-507
33357,2410,2121,1.0,2265.5,289
33358,2087,2337,0.0,2212.0,-250
33359,2181,1929,1.0,2055.0,252
33360,2125,2164,1.0,2144.5,-39
33361,2056,2081,0.5,2068.5,-25
33362,2120,2087,1.0,2103.5,33
33363,2090,2121,1.0,2105.5,-31
33364,2368,2354,1.0,2361.0,14
33365,2106,2229,1.0,2167.5,-123
33366,2484,2508,0.0,2496.0,-24
33367,2170,2487,0.0,2328.5,-317
33368,2464,2105,1.0,2284.5,359
33369,2145,2500,0.0,2322.5,-355
33370,2068,2216,0.0,2142.0,-148
33371,2106,2070,0.0,2088.0,36
33372,2024,2188,0.5,2106.0,-164
33373,1781,2002,0.5,1891.5,-221
33374,2181,2425,0.0,2303.0,-244
33375,2166,2280,0.5,2223.0,-114
33376,2225,2222,1.0,2223.5,3
33377,2103,2245,1.0,2174.0,-142
33378,2055,2344,0.0,2199.5,-289
33379,2373,1963,1.0,2168.0,410
33380,2024,2252,1.0,2138.0,-228
33381,2581,1854,1.0,2217.5,727
33382,2236,2408,0.0,2322.0,-172
33383,2284,2416,1.0,2350.0,-132
33384,2211,2224,0.0,2217.5,-13
33385,2388,2382,1.0,2385.0,6
33386,2164,2141,0.0,2152.5,23
33387,2155,2279,0.0,2217.0,-124
33388,2093,2154,0.0,2123.5,-61
33389,2251,2317,1.0,2284.0,-66
33390,2405,2169,1.0,2287.0,236
33391,2106,2250,0.0,2178.0,-144
33392,2193,1951,1.0,2072.0,242
33393,2197,2311,0.0,2254.0,-114
33394,2309,2168,1.0,2238.5,141
33395,2187,2143,0.0,2165.0,44
33396,2121,2156,1.0,2138.5,-35
33397,2114,2472,0.0,2293.0,-358
33398,2332,1829,1.0,2080.5,503
33399,1846,2283,0.0,2064.5,-437
33400,2128,1884,0.5,2006.0,244
33401,2272,2489,0.0,2380.5,-217
33402,2382,2125,1.0,2253.5,257
33403,1760,2387,0.0,2073.5,-627
33404,2391,1846,1.0,2118.5,545
33405,2085,2523,0.0,2304.0,-438
33406,2421,1933,1.0,2177.0,488
33407,2032,2418,0.0,2225.0,-386
33408,2453,2020,1.0,2236.5,433
33409,2416,2121,0.5,2268.5,295
33410,2194,2413,0.0,2303.5,-219
33411,2273,2141,1.0,2207.0,132
33412,1986,2266,0.0,2126.0,-280
33413,2448,2341,0.5,2394.5,107
33414,2277,2365,0.0,2321.0,-88
33415,2222,2296,0.0,2259.0,-74
33416,2125,2172,1.0,2148.5,-47
33417,2193,2591,0.0,2392.0,-398
33418,2350,2195,1.0,2272.5,155
33419,2144,2277,1.0,2210.5,-133
33420,1899,2070,0.5,1984.5,-171
33421,2438,2067,1.0,2252.5,371
33422,2081,2333,0.0,2207.0,-252
33423,2311,2157,1.0,2234.0,154
33424,2329,2315,0.5,2322.0,14
33425,2326,2126,1.0,2226.0,200
33426,2258,2226,0.5,2242.0,32
33427,2140,2103,0.0,2121.5,37
33428,2256,2307,1.0,2281.5,-51
33429,2157,2249,0.5,2203.0,-92
33430,2321,2186,1.0,2253.5,135
33431,2170,2352,0.0,2261.0,-182
33432,2317,1920,1.0,2118.5,397
33433,1883,2172,0.5,2027.5,-289
33434,2173,1808,0.0,1990.5,365
33435,1606,2105,0.0,1855.5,-499
33436,2297,2183,1.0,2240.0,114
33437,2253,2350,0.5,2301.5,-97
33438,2231,2014,0.5,2122.5,217
33439,2065,2246,0.0,2155.5,-181
33440,2283,1996,0.0,2139.5,287
33441,2036,2239,1.0,2137.5,-203
33442,2166,2031,1.0,2098.5,135
33443,1920,2202,0.0,2061.0,-282
33444,2137,2064,1.0,2100.5,73
33445,2085,2113,0.0,2099.0,-28
33446,2057,2046,1.0,2051.5,11
33447,2038,2042,1.0,2040.0,-4
33448,2261,2123,0.0,2192.0,138
33449,1951,2299,0.0,2125.0,-348
33450,2244,2036,1.0,2140.0,208
33451,1972,2138,0.5,2055.0,-166
33452,1910,2060,0.0,1985.0,-150
33453,2017,2074,0.5,2045.5,-57
33454,2051,2115,0.0,2083.0,-64
33455,2131,1565,0.0,1848.0,566
33456,2085,2263,1.0,2174.0,-178
33457,2194,1952,0.0,2073.0,242
33458,2272,2246,1.0,2259.0,26
33459,2243,1960,1.0,2101.5,283
33460,2060,2070,0.5,2065.0,-10
33461,2221,2118,1.0,2169.5,103
33462,1884,2070,0.0,1977.0,-186
33463,1937,1883,1.0,1910.0,54
33464,1828,1969,1.0,1898.5,-141
33465,2414,1985,1.0,2199.5,429
33466,1860,2244,0.0,2052.0,-384
33467,2177,1933,1.0,2055.0,244
33468,1977,2125,0.5,2051.0,-148
33469,2055,2236,0.5,2145.5,-181
33470,2110,2063,0.5,2086.5,47
33471,2190,2069,0.0,2129.5,121
33472,2078,1904,0.5,1991.0,174
33473,1751,1830,0.5,1790.5,-79
33474,2048,1828,0.0,1938.0,220
33475,2139,1724,1.0,1931.5,415
33476,1777,2099,0.0,1938.0,-322
33477,2201,2270,1.0,2235.5,-69
33478,2119,1993,0.0,2056.0,126
33479,2026,1976,0.5,2001.0,50
33480,2106,2054,0.5,2080.0,52
33481,1931,1945,0.0,1938.0,-14
33482,2111,1928,1.0,2019.5,183
33483,2154,1878,1.0,2016.0,276
33484,1922,1707,0.0,1814.5,215
33485,2079,2139,1.0,2109.0,-60
33486,1802,1950,0.0,1876.0,-148
33487,1689,1779,0.0,1734.0,-90
33488,1948,1622,0.0,1785.0,326
33489,1987,2011,1.0,1999.0,-24
33490,1844,1952,0.0,1898.0,-108
33491,1817,1899,1.0,1858.0,-82
33492,1944,2039,1.0,1991.5,-95
33493,1833,1841,1.0,1837.0,-8
33494,1875,1312,1.0,1593.5,563
33495,2036,2030,1.0,2033.0,6
33496,1899,1953,1.0,1926.0,-54
33497,1908,1817,0.5,1862.5,91
33498,1729,1909,0.0,1819.0,-180
33499,1645,2180,0.5,1912.5,-535
33500,1845,1580,0.0,1712.5,265
33501,1893,2012,1.0,1952.5,-119
33502,1769,1848,0.0,1808.5,-79
33503,1911,1720,1.0,1815.5,191
33504,2056,2000,0.0,2028.0,56
33505,2034,1917,0.0,1975.5,117
33506,1653,1746,0.5,1699.5,-93
33507,2044,1577,1.0,1810.5,467
33508,1479,2075,0.5,1777.0,-596
33509,2372,2288,0.0,2330.0,84
33510,2357,2329,0.0,2343.0,28
33511,2114,2299,0.0,2206.5,-185
33512,2312,2226,0.5,2269.0,86
33513,1783,1668,0.5,1725.5,115
33514,2718,2743,0.5,2730.5,-25
33515,2724,2742,0.5,2733.0,-18
33516,2668,2649,1.0,2658.5,19
33517,2613,2666,0.0,2639.5,-53
33518,2625,2716,0.5,2670.5,-91
33519,2676,2574,0.5,2625.0,102
33520,2579,2634,0.5,2606.5,-55
33521,2549,2561,0.5,2555.0,-12
33522,2604,2877,0.0,2740.5,-273
33523,2630,2522,1.0,2576.0,108
33524,2503,2628,0.0,2565.5,-125
33525,2528,2473,0.0,2500.5,55
33526,2744,2772,0.5,2758.0,-28
33527,2681,2717,1.0,2699.0,-36
33528,2723,2553,1.0,2638.0,170
33529,2548,2680,0.0,2614.0,-132
33530,2768,2735,0.5,2751.5,33
33531,2659,2720,0.0,2689.5,-61
33532,2680,2576,0.5,2628.0,104
33533,2612,2624,0.5,2618.0,-12
33534,2709,2760,0.5,2734.5,-51
33535,2664,2646,0.5,2655.0,18
33536,2639,2649,0.5,2644.0,-10
33537,2550,2689,0.5,2619.5,-139
33538,2645,2805,0.5,2725.0,-160
33539,2686,2590,0.5,2638.0,96
33540,2669,2672,0.5,2670.5,-3
33541,2655,2619,0.5,2637.0,36
33542,2740,2787,0.5,2763.5,-47
33543,2706,2690,0.5,2698.0,16
33544,2704,2659,1.0,2681.5,45
33545,2624,2676,1.0,2650.0,-52
33546,2745,2570,1.0,2657.5,175
33547,2568,2631,0.0,2599.5,-63
33548,2664,2583,1.0,2623.5,81
33549,2522,2638,0.5,2580.0,-116
33550,2760,2698,0.0,2729.0,62
33551,2624,2795,0.5,2709.5,-171
33552,2786,2620,1.0,2703.0,166
33553,2603,2714,0.5,2658.5,-111
33554,2527,2753,0.5,2640.0,-226
33555,2671,2400,1.0,2535.5,271
33556,2250,2656,0.0,2453.0,-406
33557,2651,2186,1.0,2418.5,465
33558,2678,2671,1.0,2674.5,7
33559,2606,2580,0.5,2593.0,26
33560,2595,2563,0.5,2579.0,32
33561,2608,2532,0.5,2570.0,76
33562,2740,2613,1.0,2676.5,127
33563,2602,2665,1.0,2633.5,-63
33564,2650,2554,0.0,2602.0,96
33565,2539,2653,1.0,2596.0,-114
33566,2574,2659,0.5,2616.5,-85
33567,2618,2574,0.5,2596.0,44
33568,2564,2569,1.0,2566.5,-5
33569,2537,2541,0.5,2539.0,-4
33570,2543,2441,1.0,2492.0,102
33571,2431,2448,0.5,2439.5,-17
33572,2426,2347,1.0,2386.5,79
33573,2349,2555,0.5,2452.0,-206
33574,2700,2513,1.0,2606.5,187
33575,2462,2615,0.5,2538.5,-153
33576,2510,2439,0.5,2474.5,71
33577,2402,2367,0.0,2384.5,35
33578,2500,2387,0.5,2443.5,113
33579,2366,2477,0.5,2421.5,-111
33580,2450,2383,1.0,2416.5,67
33581,2311,2353,0.5,2332.0,-42
33582,2710,2594,1.0,2652.0,116
33583,2598,2634,0.0,2616.0,-36
33584,2439,2499,0.0,2469.0,-60
33585,2490,2507,0.0,2498.5,-17
33586,2578,2627,0.5,2602.5,-49
33587,2487,2473,0.0,2480.0,14
33588,2474,2466,0.5,2470.0,8
33589,2486,2448,0.0,2467.0,38
33590,2709,2801,0.5,2755.0,-92
33591,2565,2650,0.0,2607.5,-85
33592,2572,2560,1.0,2566.0,12
33593,2530,2524,0.5,2527.0,6
33594,2713,2531,0.5,2622.0,182
33595,2461,2618,0.5,2539.5,-157
33596,2581,2470,1.0,2525.5,111
33597,2425,2563,1.0,2494.0,-138
33598,2644,2663,0.0,2653.5,-19
33599,2629,2556,0.5,2592.5,73
33600,2432,2630,0.5,2531.0,-198
33601,2553,2460,1.0,2506.5,93
33602,2589,2525,0.5,2557.0,64
33603,2374,2529,0.0,2451.5,-155
33604,2569,2374,1.0,2471.5,195
33605,2291,2614,0.5,2452.5,-323
33606,2533,2549,0.0,2541.0,-16
33607,2505,2537,0.5,2521.0,-32
33608,2457,2461,0.0,2459.0,-4
33609,2365,2455,1.0,2410.0,-90
33610,2611,2535,0.5,2573.0,76
33611,2508,2433,0.5,2470.5,75
33612,2328,2491,1.0,2409.5,-163
33613,2411,2251,1.0,2331.0,160
33614,2562,2435,1.0,2498.5,127
33615,2346,2522,0.0,2434.0,-176
33616,2525,2275,1.0,2400.0,250
33617,2305,2533,0.0,2419.0,-228
33618,2622,2387,0.5,2504.5,235
33619,2392,2473,0.5,2432.5,-81
33620,2528,2289,1.0,2408.5,239
33621,2277,2458,0.0,2367.5,-181
33622,2344,2571,0.0,2457.5,-227
33623,2549,2373,1.0,2461.0,176
33624,2252,2559,1.0,2405.5,-307
33625,2554,2183,1.0,2368.5,371
33626,2425,2602,0.0,2513.5,-177
33627,2571,2259,1.0,2415.0,312
33628,2166,2586,0.0,2376.0,-420
33629,2487,2103,1.0,2295.0,384
33630,2653,2544,0.5,2598.5,109
33631,2606,2390,1.0,2498.0,216
33632,2318,2435,0.0,2376.5,-117
33633,2402,2313,0.0,2357.5,89
33634,2502,2487,0.5,2494.5,15
33635,2464,2495,0.5,2479.5,-31
33636,2419,2500,0.5,2459.5,-81
33637,2426,2323,0.5,2374.5,103
33638,2590,2388,1.0,2489.0,202
33639,2279,2410,1.0,2344.5,-131
33640,2337,2155,1.0,2246.0,182
33641,2591,2301,1.0,2446.0,290
33642,2081,2063,0.0,2072.0,18
33643,2431,2437,1.0,2434.0,-6
33644,2121,2120,0.0,2120.5,1
33645,2354,2445,1.0,2399.5,-91
33646,2255,2333,0.0,2294.0,-78
33647,2229,2368,1.0,2298.5,-139
33648,2190,2425,0.5,2307.5,-235
33649,2581,2106,1.0,2343.5,475
33650,2390,2513,0.0,2451.5,-123
33651,2284,2416,0.0,2350.0,-132
33652,2501,2411,0.5,2456.0,90
33653,2311,2382,1.0,2346.5,-71
33654,2143,2309,0.5,2226.0,-166
33655,2317,2121,0.0,2219.0,196
33656,2427,2489,1.0,2458.0,-62
33657,2250,2405,0.0,2327.5,-155
33658,2391,2382,1.0,2386.5,9
33659,2523,2193,0.0,2358.0,330
33660,2526,2590,0.5,2558.0,-64
33661,2421,2522,1.0,2471.5,-101
33662,2405,2438,0.5,2421.5,-33
33663,2216,2453,1.0,2334.5,-237
33664,2519,2544,1.0,2531.5,-25
33665,2188,1946,0.0,2067.0,242
33666,2351,2467,1.0,2409.0,-116
33667,2644,1781,1.0,2212.5,863
33668,2406,2469,0.5,2437.5,-63
33669,2544,2608,0.5,2576.0,-64
33670,2303,2384,0.0,2343.5,-81
33671,2654,2526,1.0,2590.0,128
33672,2286,2333,0.0,2309.5,-47
33673,2467,2547,1.0,2507.0,-80
33674,2157,2239,0.5,2198.0,-82
33675,2396,2396,1.0,2396.0,0
33676,2361,2507,1.0,2434.0,-146
33677,2254,2180,1.0,2217.0,74
33678,2322,2320,1.0,2321.0,2
33679,2218,2139,0.0,2178.5,79
33680,2350,2591,0.5,2470.5,-241
33681,2156,2215,1.0,2185.5,-59
33682,1899,2225,0.0,2062.0,-326
33683,2644,2116,1.0,2380.0,528
33684,2365,2449,0.0,2407.0,-84
33685,2455,2602,1.0,2528.5,-147
33686,2320,2316,0.0,2318.0,4
33687,2413,2323,1.0,2368.0,90
33688,2222,2523,0.5,2372.5,-301
33689,2273,2392,0.0,2332.5,-119
33690,2117,2122,0.0,2119.5,-5
33691,2068,2266,0.0,2167.0,-198
33692,2399,2378,1.0,2388.5,21
33693,2024,2070,0.0,2047.0,-46
33694,2236,2333,1.0,2284.5,-97
33695,2521,2002,0.5,2261.5,519
33696,2249,2256,0.0,2252.5,-7
33697,2486,2437,1.0,2461.5,49
33698,2352,2321,0.5,2336.5,31
33699,2471,2427,1.0,2449.0,44
33700,2277,2341,0.5,2309.0,-64
33701,2380,2330,0.5,2355.0,50
33702,2125,2296,0.0,2210.5,-171
33703,2508,2173,1.0,2340.5,335
33704,2121,2083,1.0,2102.0,38
33705,2320,2170,1.0,2245.0,150
33706,1929,2024,0.5,1976.5,-95
33707,1817,2145,0.0,1981.0,-328
33708,2090,2317,1.0,2203.5,-227
33709,1532,1830,0.0,1681.0,-298
33710,2105,2172,1.0,2138.5,-67
33711,2060,2329,0.0,2194.5,-269
33712,2258,2017,1.0,2137.5,241
33713,2115,2165,0.0,2140.0,-50
33714,2164,2056,0.0,2110.0,108
33715,2087,2090,0.5,2088.5,-3
33716,2181,2201,0.5,2191.0,-20
33717,1993,2280,0.0,2136.5,-287
33718,2225,2026,0.0,2125.5,199
33719,2143,2245,1.0,2194.0,-102
33720,1963,2055,0.0,2009.0,-92
33721,2106,2251,1.0,2178.5,-145
33722,1854,1951,1.0,1902.5,-97
33723,2408,2334,1.0,2371.0,74
33724,2299,2236,0.0,2267.5,63
33725,2224,2244,0.0,2234.0,-20
33726,2138,2211,1.0,2174.5,-73
33727,2141,2297,1.0,2219.0,-156
33728,2350,2164,1.0,2257.0,186
33729,2154,2282,0.0,2218.0,-128
33730,2231,2067,1.0,2149.0,164
33731,2263,2236,0.5,2249.5,27
33732,2110,2085,0.0,2097.5,25
33733,2246,2104,1.0,2175.0,142
33734,2078,2272,0.0,2175.0,-194
33735,2137,2243,0.0,2190.0,-106
33736,2261,2113,0.0,2187.0,148
33737,2105,2221,0.0,2163.0,-116
33738,2070,2042,0.5,2056.0,28
33739,2315,2273,0.0,2294.0,42
33740,2197,2326,1.0,2261.5,-129
33741,2226,2168,1.0,2197.0,58
33742,2187,2140,1.0,2163.5,47
33743,2114,2414,0.5,2264.0,-300
33744,2244,1873,1.0,2058.5,371
33745,1846,2210,0.0,2028.0,-364
33746,2125,1884,0.0,2004.5,241
33747,2048,2183,0.5,2115.5,-135
33748,2085,2448,0.5,2266.5,-363
33749,2463,2125,1.0,2294.0,338
33750,1760,2365,0.0,2062.5,-605
33751,2222,1846,1.0,2034.0,376
33752,1950,2222,0.5,2086.0,-272
33753,2195,1802,1.0,1998.5,393
33754,1755,2144,0.0,1949.5,-389
33755,2307,2001,0.0,2154.0,306
33756,1933,2157,0.0,2045.0,-224
33757,2170,2032,1.0,2101.0,138
33758,2020,2160,0.0,2090.0,-140
33759,2106,2283,0.5,2194.5,-177
33760,2239,1945,0.0,2092.0,294
33761,2111,2166,0.0,2138.5,-55
33762,2202,1858,0.5,2030.0,344
33763,2011,2067,1.0,2039.0,-56
33764,1803,1987,0.5,1895.0,-184
33765,1952,2081,0.0,2016.5,-129
33766,2311,1817,1.0,2064.0,494
33767,2121,2154,1.0,2137.5,-33
33768,2139,2218,0.0,2178.5,-79
33769,2141,2084,1.0,2112.5,57
33770,2079,1986,1.0,2032.5,93
33771,1920,1996,1.0,1958.0,-76
33772,2036,1883,0.0,1959.5,153
33773,1808,2031,0.5,1919.5,-223
33774,1920,1606,0.0,1763.0,314
33775,2064,2123,0.0,2093.5,-59
33776,1951,2085,0.0,2018.0,-134
33777,2038,1972,0.0,2005.0,66
33778,1746,1944,1.0,1845.0,-198
33779,1910,2044,0.0,1977.0,-134
33780,2075,2051,0.0,2063.0,24
33781,1880,2055,0.0,1967.5,-175
33782,2190,2056,1.0,2123.0,134
33783,2000,1964,0.0,1982.0,36
33784,1904,1917,0.5,1910.5,-13
33785,1841,2112,0.0,1976.5,-271
33786,2253,1833,1.0,2043.0,420
33787,1985,2014,1.0,1999.5,-29
33788,1630,1828,1.0,1729.0,-198
33789,1977,1860,0.5,1918.5,117
33790,1777,1724,0.0,1750.5,53
33791,2270,2030,0.0,2150.0,240
33792,1828,1937,0.0,1882.5,-109
33793,1976,2119,0.5,2047.5,-143
33794,1892,1969,1.0,1930.5,-77
33795,2054,1889,1.0,1971.5,165
33796,2180,1908,0.5,2044.0,272
33797,1580,1645,0.0,1612.5,-65
33798,2070,1928,1.0,1999.0,142
33799,1953,2036,1.0,1994.5,-83
33800,2012,1899,1.0,1955.5,113
33801,1952,2131,1.0,2041.5,-179
33802,1960,2194,1.0,2077.0,-234
33803,2039,1948,0.5,1993.5,91
33804,1312,1944,1.0,1628.0,-632
33805,1534,1844,0.0,1689.0,-310
33806,1707,1875,1.0,1791.0,-168
33807,1779,1922,0.5,1850.5,-143
33808,1799,1688,0.0,1743.5,111
33809,1689,1685,1.0,1687.0,4
33810,1479,1577,0.5,1528.0,-98
33811,2030,1845,1.0,1937.5,185
33812,1817,1720,0.0,1768.5,97
33813,1723,1909,1.0,1816.0,-186
33814,1668,1783,1.0,1725.5,-115
33815,2068,2372,0.0,2220.0,-304
33816,2329,2061,1.0,2195.0,268
33817,1980,2226,0.5,2103.0,-246
33818,2132,2137,0.0,2134.5,-5
33819,2472,2288,0.0,2380.0,184
33820,2357,2332,0.0,2344.5,25
33821,2283,2299,1.0,2291.0,-16
33822,2312,2150,0.0,2231.0,162
33823,2718,2744,0.5,2731.0,-26
33824,2717,2742,0.5,2729.5,-25
33825,2668,2723,0.5,2695.5,-55
33826,2707,2638,0.5,2672.5,69
33827,2716,2768,0.5,2742.0,-52
33828,2720,2676,1.0,2698.0,44
33829,2634,2708,0.5,2671.0,-74
33830,2680,2530,0.5,2605.0,150
33831,2877,2632,1.0,2754.5,245
33832,2529,2630,1.0,2579.5,-101
33833,2628,2569,0.5,2598.5,59
33834,2614,2528,0.5,2571.0,86
33835,2743,2625,0.5,2684.0,118
33836,2574,2724,0.5,2649.0,-150
33837,2659,2579,0.5,2619.0,80
33838,2554,2613,0.5,2583.5,-59
33839,2753,2740,0.5,2746.5,13
33840,2637,2671,1.0,2654.0,-34
33841,2656,2690,0.5,2673.0,-34
33842,2704,2624,1.0,2664.0,80
33843,2772,2760,1.0,2766.0,12
33844,2664,2681,0.5,2672.5,-17
33845,2553,2649,1.0,2601.0,-96
33846,2603,2548,1.0,2575.5,55
33847,2678,2745,0.5,2711.5,-67
33848,2631,2580,0.5,2605.5,51
33849,2595,2664,0.5,2629.5,-69
33850,2638,2514,0.5,2576.0,124
33851,2574,2645,0.5,2609.5,-71
33852,2590,2574,0.5,2582.0,16
33853,2564,2669,0.5,2616.5,-105
33854,2619,2562,0.5,2590.5,57
33855,2787,2709,0.5,2748.0,78
33856,2646,2706,1.0,2676.0,-60
33857,2653,2639,1.0,2646.0,14
33858,2689,2624,0.5,2656.5,65
33859,2805,2613,0.5,2709.0,192
33860,2602,2686,0.5,2644.0,-84
33861,2672,2554,0.5,2613.0,118
33862,2539,2655,0.5,2597.0,-116
33863,2795,2500,1.0,2647.5,295
33864,2477,2751,0.5,2614.0,-274
33865,2786,2450,0.5,2618.0,336
33866,2440,2714,0.5,2577.0,-274
33867,2698,2709,0.5,2703.5,-11
33868,2650,2624,1.0,2637.0,26
33869,2620,2572,0.5,2596.0,48
33870,2496,2618,0.0,2557.0,-122
33871,2735,2578,1.0,2656.5,157
33872,2473,2576,0.0,2524.5,-103
33873,2640,2448,1.0,2544.0,192
33874,2423,2612,0.5,2517.5,-189
33875,2549,2536,0.5,2542.5,13
33876,2543,2505,0.5,2524.0,38
33877,2461,2426,0.5,2443.5,35
33878,2555,2365,0.5,2460.0,190
33879,2663,2710,0.5,2686.5,-47
33880,2634,2629,1.0,2631.5,5
33881,2630,2501,0.0,2565.5,129
33882,2507,2553,1.0,2530.0,-46
33883,2700,2591,0.5,2645.5,109
33884,2437,2615,0.0,2526.0,-178
33885,2510,2425,1.0,2467.5,85
33886,2445,2471,0.0,2458.0,-26
33887,2562,2740,0.5,2651.0,-178
33888,2665,2525,0.5,2595.0,140
33889,2533,2650,0.0,2591.5,-117
33890,2653,2477,1.0,2565.0,176
33891,2545,2671,0.5,2608.0,-126
33892,2606,2535,0.5,2570.5,71
33893,2508,2563,0.0,2535.5,-55
33894,2608,2411,1.0,2509.5,197
33895,2602,2441,1.0,2521.5,161
33896,2431,2571,1.0,2501.0,-140
33897,2586,2419,0.5,2502.5,167
33898,2349,2453,0.0,2401.0,-104
33899,2531,2659,1.0,2595.0,-128
33900,2618,2559,0.0,2588.5,59
33901,2470,2537,1.0,2503.5,-67
33902,2490,2425,1.0,2457.5,65
33903,2618,2354,0.5,2486.0,264
33904,2368,2581,0.5,2474.5,-213
33905,2542,2229,1.0,2385.5,313
33906,2106,2563,0.0,2334.5,-457
33907,2649,2622,0.5,2635.5,27
33908,2593,2570,0.0,2581.5,23
33909,2568,2528,1.0,2548.0,40
33910,2458,2522,0.0,2490.0,-64
33911,2527,2611,0.5,2569.0,-84
33912,2433,2400,0.5,2416.5,33
33913,2251,2328,1.0,2289.5,-77
33914,2571,2186,1.0,2378.5,385
33915,2416,2581,0.0,2498.5,-165
33916,2549,2595,1.0,2572.0,-46
33917,2061,2382,0.0,2221.5,-321
33918,2544,2554,0.0,2549.0,-10
33919,2332,2472,0.0,2402.0,-140
33920,2435,2606,1.0,2520.5,-171
33921,2128,2283,0.0,2205.5,-155
33922,2311,2402,0.0,2356.5,-91
33923,2410,2590,1.0,2500.0,-180
33924,2143,2309,1.0,2226.0,-166
33925,2301,2337,0.0,2319.0,-36
33926,2471,2121,0.5,2296.0,350
33927,2503,2522,0.5,2512.5,-19
33928,2189,2330,1.0,2259.5,-141
33929,2373,2473,1.0,2423.0,-100
33930,2801,2173,1.0,2487.0,628
33931,2641,2644,0.5,2642.5,-3
33932,2560,2587,0.5,2573.5,-27
33933,2526,2544,0.5,2535.0,-18
33934,2489,2530,0.5,2509.5,-41
33935,2399,2378,1.0,2388.5,21
33936,2382,2427,1.0,2404.5,-45
33937,2289,2333,0.0,2311.0,-44
33938,2594,2387,0.5,2490.5,207
33939,2419,2502,0.0,2460.5,-83
33940,2499,2598,1.0,2548.5,-99
33941,2323,2382,1.0,2352.5,-59
33942,2644,2424,1.0,2534.0,220
33943,2547,2654,1.0,2600.5,-107
33944,2460,2556,0.0,2508.0,-96
33945,2396,2467,0.5,2431.5,-71
33946,2544,2447,0.5,2495.5,97
33947,2296,2525,0.0,2410.5,-229
33948,2519,2517,1.0,2518.0,2
33949,2291,2374,0.0,2332.5,-83
33950,2627,2467,1.0,2547.0,160
33951,2215,2218,1.0,2216.5,-3
33952,2466,2487,1.0,2476.5,-21
33953,2116,2156,0.0,2136.0,-40
33954,2513,2589,0.0,2551.0,-76
33955,2413,2416,0.0,2414.5,-3
33956,2402,2439,1.0,2420.5,-37
33957,2266,2392,0.5,2329.0,-126
33958,2387,2334,0.0,2360.5,53
33959,2455,2602,1.0,2528.5,-147
33960,2383,2366,0.0,2374.5,17
33961,2277,2323,1.0,2300.0,-46
33962,2533,2311,0.5,2422.0,222
33963,2437,2521,0.5,2479.0,-84
33964,2455,2537,0.5,2496.0,-82
33965,2427,2486,1.0,2456.5,-59
33966,2484,2398,0.5,2441.0,86
33967,2392,2387,1.0,2389.5,5
33968,2464,2487,1.0,2475.5,-23
33969,2239,2289,0.0,2264.0,-50
33970,2063,2426,0.5,2244.5,-363
33971,2421,2522,0.5,2471.5,-101
33972,2081,2125,0.0,2103.0,-44
33973,2453,2418,1.0,2435.5,35
33974,2513,2120,0.0,2316.5,393
33975,2448,2653,1.0,2550.5,-205
33976,2501,2411,1.0,2456.0,90
33977,2313,2318,0.5,2315.5,-5
33978,2335,2418,0.5,2376.5,-83
33979,2526,2590,1.0,2558.0,-64
33980,2405,2363,1.0,2384.0,42
33981,2243,2508,0.5,2375.5,-265
33982,2320,2118,0.5,2219.0,202
33983,2261,2105,0.5,2183.0,156
33984,2145,2221,0.5,2183.0,-76
33985,2507,2425,1.0,2466.0,82
33986,2259,2361,0.5,2310.0,-102
33987,2256,2166,0.5,2211.0,90
33988,2103,2322,1.0,2212.5,-219
33989,2317,2396,0.5,2356.5,-79
33990,2082,2090,1.0,2086.0,-8
33991,2172,2254,1.0,2213.0,-82
33992,2139,2173,0.5,2156.0,-34
33993,2344,2143,1.0,2243.5,201
33994,2251,2373,1.0,2312.0,-122
33995,2252,2106,1.0,2179.0,146
33996,1951,2024,0.5,1987.5,-73
33997,2388,2056,0.5,2222.0,332
33998,2087,2279,0.0,2183.0,-192
33999,2155,2024,0.5,2089.5,131
34000,2333,2329,0.0,2331.0,4
34001,2126,2425,0.5,2275.5,-299
34002,2272,2165,0.0,2218.5,107
34003,2103,2190,0.0,2146.5,-87
34004,2350,2414,0.0,2382.0,-64
34005,2244,2282,0.5,2263.0,-38
34006,2231,2210,1.0,2220.5,21
34007,2177,2246,0.0,2211.5,-69
34008,2435,2273,1.0,2354.0,162
34009,2197,2346,1.0,2271.5,-149
34010,2275,2168,0.5,2221.5,107
34011,2187,2305,1.0,2246.0,-118
34012,2317,2263,0.5,2290.0,54
34013,2085,2250,0.0,2167.5,-165
34014,2121,2246,1.0,2183.5,-125
34015,2272,2193,1.0,2232.5,79
34016,2438,2448,1.0,2443.0,-10
34017,2463,2333,1.0,2398.0,130
34018,2286,2365,0.0,2325.5,-79
34019,2222,2157,0.0,2189.5,65
34020,2406,2068,1.0,2237.0,338
34021,2070,2384,0.5,2227.0,-314
34022,2303,2024,1.0,2163.5,279
34023,1802,2224,0.0,2013.0,-422
34024,2216,2323,1.0,2269.5,-107
34025,2236,2106,1.0,2171.0,130
34026,1946,2224,1.0,2085.0,-278
34027,2211,2188,0.0,2199.5,23
34028,2591,2194,1.0,2392.5,397
34029,2218,2350,0.5,2284.0,-132
34030,2277,2141,1.0,2209.0,136
34031,1986,2225,0.0,2105.5,-239
34032,2135,2222,0.0,2178.5,-87
34033,2193,2256,0.5,2224.5,-63
34034,2249,2195,0.0,2222.0,54
34035,2144,2321,0.0,2232.5,-177
34036,2449,2157,1.0,2303.0,292
34037,2186,2318,1.0,2252.0,-132
34038,2316,2170,0.5,2243.0,146
34039,2160,2320,0.5,2240.0,-160
34040,2067,2523,0.5,2295.0,-456
34041,2222,1803,0.5,2012.5,419
34042,2081,2176,0.5,2128.5,-95
34043,2122,2311,0.0,2216.5,-189
34044,2341,2334,1.0,2337.5,7
34045,2261,2277,1.0,2269.0,-16
34046,2296,2299,0.0,2297.5,-3
34047,2138,2125,1.0,2131.5,13
34048,1920,2141,0.0,2030.5,-221
34049,2154,1883,0.5,2018.5,271
34050,1808,2067,1.0,1937.5,-259
34051,2093,1606,1.0,1849.5,487
34052,2055,2283,0.0,2169.0,-228
34053,2239,1963,0.0,2101.0,276
34054,2202,2166,1.0,2184.0,36
34055,2055,2137,0.5,2096.0,-82
34056,2113,2063,0.5,2088.0,50
34057,2190,2105,0.0,2147.5,85
34058,2042,1904,0.5,1973.0,138
34059,2315,2070,0.0,2192.5,245
34060,2226,2326,1.0,2276.0,-100
34061,2123,2140,1.0,2131.5,-17
34062,2061,2068,1.0,2064.5,-7
34063,1972,2036,0.0,2004.0,-64
34064,2137,1980,1.0,2058.5,157
34065,2044,1746,0.0,1895.0,298
34066,2112,2075,1.0,2093.5,37
34067,1830,1817,0.0,1823.5,13
34068,2014,2253,0.0,2133.5,-239
34069,2183,2065,0.0,2124.0,118
34070,2121,2083,1.0,2102.0,38
34071,1929,2024,1.0,1976.5,-95
34072,1952,2139,1.0,2045.5,-187
34073,2017,2060,0.0,2038.5,-43
34074,2236,1960,0.5,2098.0,276
34075,2111,1945,0.0,2028.0,166
34076,2069,2104,1.0,2086.5,-35
34077,1878,1858,1.0,1868.0,20
34078,1937,2078,1.0,2007.5,-141
34079,1873,1829,0.0,1851.0,44
34080,1969,1883,1.0,1926.0,86
34081,1884,1846,1.0,1865.0,38
34082,2054,1892,1.0,1973.0,162
34083,1893,2012,0.0,1952.5,-119
34084,2201,1985,0.5,2093.0,216
34085,1860,1993,0.0,1926.5,-133
34086,1996,1933,0.0,1964.5,63
34087,1977,2026,1.0,2001.5,-49
34088,2039,2272,0.5,2155.5,-233
34089,2085,1944,0.0,2014.5,141
34090,1312,2125,0.0,1718.5,-813
34091,1846,1875,1.0,1860.5,-29
34092,2001,2085,0.0,2043.0,-84
34093,1688,1779,1.0,1733.5,-91
34094,2020,1933,1.0,1976.5,87
34095,1996,1622,0.0,1809.0,374
34096,2084,2154,1.0,2119.0,-70
34097,2031,2036,0.0,2033.5,-5
34098,1979,2079,1.0,2029.0,-100
34099,1950,1920,1.0,1935.0,30
34100,1987,2011,1.0,1999.0,-24
34101,1755,1802,0.0,1778.5,-47
34102,1909,1952,0.0,1930.5,-43
34103,2046,2064,1.0,2055.0,-18
34104,1729,2038,0.0,1883.5,-309
34105,2036,1953,1.0,1994.5,83
34106,1899,1751,0.0,1825.0,148
34107,1908,2119,0.0,2013.5,-211
34108,1976,2180,0.5,2078.0,-204
34109,1645,1889,0.0,1767.0,-244
34110,1910,1580,1.0,1745.0,330
34111,1848,1845,0.0,1846.5,3
34112,2051,2074,1.0,2062.5,-23
34113,1723,1769,0.5,1746.0,-46
34114,1828,1565,0.0,1696.5,263
34115,2000,1880,0.0,1940.0,120
34116,1724,1630,0.5,1677.0,94
34117,1917,2034,1.0,1975.5,-117
34118,1479,1653,1.0,1566.0,-174
34119,1466,1833,1.0,1649.5,-367
34120,1922,1707,1.0,1814.5,215
34121,1685,1799,1.0,1742.0,-114
34122,1899,1534,1.0,1716.5,365
34123,1783,2030,0.0,1906.5,-247
34124,2329,1817,1.0,2073.0,512
34125,2226,2114,1.0,2170.0,112
34126,2288,2132,0.5,2210.0,156
34127,2280,2181,0.5,2230.5,99
34128,2299,2357,1.0,2328.0,-58
34129,2245,2225,0.5,2235.0,20
34130,2352,2312,0.5,2332.0,40
34131,2383,2358,0.0,2370.5,25
34132,2269,2324,1.0,2296.5,-55
34133,2034,2338,0.0,2186.0,-304
34134,2189,2232,0.5,2210.5,-43
34135,2237,2215,1.0,2226.0,22
34136,2213,2166,0.5,2189.5,47
34137,2271,2289,1.0,2280.0,-18
34138,2661,2182,1.0,2421.5,479
34139,2334,2229,0.5,2281.5,105
34140,2468,2559,1.0,2513.5,-91
34141,2263,2274,0.0,2268.5,-11
34142,2396,2453,1.0,2424.5,-57
34143,2453,2490,0.5,2471.5,-37
34144,2206,2397,1.0,2301.5,-191
34145,2313,2275,0.0,2294.0,38
34146,2464,2128,0.0,2296.0,336
34147,2531,2524,1.0,2527.5,7
34148,2301,2364,1.0,2332.5,-63
34149,2479,2484,0.5,2481.5,-5
34150,2391,2318,0.0,2354.5,73
34151,2478,2494,0.0,2486.0,-16
34152,2314,2324,0.5,2319.0,-10
34153,2435,2475,0.5,2455.0,-40
34154,2485,2276,0.5,2380.5,209
34155,2324,2345,0.5,2334.5,-21
34156,2327,2347,1.0,2337.0,-20
34157,2291,2317,0.0,2304.0,-26
34158,2214,2321,0.0,2267.5,-107
34159,2424,2395,1.0,2409.5,29
34160,2098,2205,0.0,2151.5,-107
34161,2314,2385,1.0,2349.5,-71
34162,2505,2055,1.0,2280.0,450
34163,2398,2470,1.0,2434.0,-72
34164,2325,2342,0.5,2333.5,-17
34165,2301,2359,1.0,2330.0,-58
34166,2368,2303,0.0,2335.5,65
34167,2375,2336,1.0,2355.5,39
34168,2186,2210,1.0,2198.0,-24
34169,2252,2333,1.0,2292.5,-81
34170,2521,2168,1.0,2344.5,353
34171,2297,2312,1.0,2304.5,-15
34172,2352,2418,0.0,2385.0,-66
34173,2145,2323,0.5,2234.0,-178
34174,2555,2318,1.0,2436.5,237
34175,2291,2296,0.5,2293.5,-5
34176,2487,2530,0.5,2508.5,-43
34177,2019,2190,0.0,2104.5,-171
34178,2401,2379,0.5,2390.0,22
34179,2261,2407,1.0,2334.0,-146
34180,2016,2120,0.0,2068.0,-104
34181,2023,2032,1.0,2027.5,-9
34182,2385,2095,1.0,2240.0,290
34183,1942,2008,0.0,1975.0,-66
34184,2316,2375,1.0,2345.5,-59
34185,1675,2045,0.0,1860.0,-370
34186,2307,2318,1.0,2312.5,-11
34187,1945,1964,0.0,1954.5,-19
34188,2329,2269,1.0,2299.0,60
34189,1886,1916,1.0,1901.0,-30
34190,2236,2171,1.0,2203.5,65
34191,2001,2147,0.0,2074.0,-146
34192,2169,2153,1.0,2161.0,16
34193,1984,1995,0.5,1989.5,-11
34194,2226,2123,1.0,2174.5,103
34195,2446,2404,1.0,2425.0,42
34196,2026,2222,0.0,2124.0,-196
34197,2327,2354,1.0,2340.5,-27
34198,2107,2000,1.0,2053.5,107
34199,2318,2269,1.0,2293.5,49
34200,1687,1921,0.0,1804.0,-234
34201,2102,2184,1.0,2143.0,-82
34202,2367,1658,1.0,2012.5,709
34203,2205,2294,1.0,2249.5,-89
34204,2218,2282,1.0,2250.0,-64
34205,1815,2027,0.0,1921.0,-212
34206,2293,2235,0.0,2264.0,58
34207,2170,2386,1.0,2278.0,-216
34208,2070,2196,0.5,2133.0,-126
34209,2032,2117,0.0,2074.5,-85
34210,2241,2032,1.0,2136.5,209
34211,2043,2259,1.0,2151.0,-216
34212,2089,2136,0.0,2112.5,-47
34213,2074,2221,1.0,2147.5,-147
34214,2456,2145,0.0,2300.5,311
34215,2235,2500,0.0,2367.5,-265
34216,2135,2189,0.0,2162.0,-54
34217,2000,2257,0.0,2128.5,-257
34218,2085,2083,0.0,2084.0,2
34219,2466,2474,1.0,2470.0,-8
34220,1971,1968,0.0,1969.5,3
34221,2252,2366,1.0,2309.0,-114
34222,2113,1610,0.5,1861.5,503
34223,2281,2327,1.0,2304.0,-46
34224,2061,2089,1.0,2075.0,-28
34225,2042,2074,1.0,2058.0,-32
34226,2052,1982,0.0,2017.0,70
34227,2346,2410,1.0,2378.0,-64
34228,1938,1972,0.0,1955.0,-34
34229,2123,2125,1.0,2124.0,-2
34230,2240,1594,1.0,1917.0,646
34231,2004,2021,1.0,2012.5,-17
34232,2218,2170,1.0,2194.0,48
34233,1785,1698,0.0,1741.5,87
34234,2168,2180,0.5,2174.0,-12
34235,2275,2312,1.0,2293.5,-37
34236,2119,2098,0.0,2108.5,21
34237,2198,2276,1.0,2237.0,-78
34238,2205,2122,0.0,2163.5,83
34239,2076,2188,0.0,2132.0,-112
34240,2068,2094,1.0,2081.0,-26
34241,1715,1922,0.0,1818.5,-207
34242,2207,2216,1.0,2211.5,-9
34243,1982,2273,0.5,2127.5,-291
34244,2118,2096,1.0,2107.0,22
34245,1839,1862,0.0,1850.5,-23
34246,2394,2008,1.0,2201.0,386
34247,2141,2228,0.0,2184.5,-87
34248,1913,2077,0.0,1995.0,-164
34249,2099,2127,1.0,2113.0,-28
34250,2165,1862,1.0,2013.5,303
34251,1782,2024,0.0,1903.0,-242
34252,2048,2044,1.0,2046.0,4
34253,1728,1747,0.0,1737.5,-19
34254,2422,1953,1.0,2187.5,469
34255,2060,2178,1.0,2119.0,-118
34256,1731,1552,0.0,1641.5,179
34257,1873,1944,1.0,1908.5,-71
34258,2278,2027,0.0,2152.5,251
34259,1980,2347,0.0,2163.5,-367
34260,2247,1893,1.0,2070.0,354
34261,1626,2217,0.0,1921.5,-591
34262,2081,1712,1.0,1896.5,369
34263,1738,2016,0.0,1877.0,-278
34264,1698,1939,0.5,1818.5,-241
34265,1859,1869,0.5,1864.0,-10
34266,1689,1981,0.0,1835.0,-292
34267,1734,1657,1.0,1695.5,77
34268,1599,1616,0.0,1607.5,-17
34269,1747,2112,0.0,1929.5,-365
34270,2211,1634,1.0,1922.5,577
34271,1362,1687,0.0,1524.5,-325
34272,1618,1478,1.0,1548.0,140
34273,1899,1991,0.5,1945.0,-92
34274,1756,1920,0.0,1838.0,-164
34275,1846,1805,0.0,1825.5,41
34276,1697,1764,0.5,1730.5,-67
34277,1846,2169,1.0,2007.5,-323
34278,1541,1954,0.0,1747.5,-413
34279,1932,1346,1.0,1639.0,586
34280,2071,1727,1.0,1899.0,344
34281,1576,1781,0.0,1678.5,-205
34282,1693,1534,1.0,1613.5,159
34283,1538,1763,0.0,1650.5,-225
34284,2170,1864,0.5,2017.0,306
34285,1540,2095,0.0,1817.5,-555
34286,2100,1521,1.0,1810.5,579
34287,2158,1801,0.0,1979.5,357
34288,1627,1747,0.0,1687.0,-120
34289,1692,2020,0.0,1856.0,-328
34290,1589,1669,0.5,1629.0,-80
34291,1986,1877,1.0,1931.5,109
34292,1663,1592,0.0,1627.5,71
34293,1899,1877,1.0,1888.0,22
34294,2122,1906,1.0,2014.0,216
34295,2003,1973,0.5,1988.0,30
34296,2019,1969,0.5,1994.0,50
34297,1804,1947,0.0,1875.5,-143
34298,2049,1960,0.5,2004.5,89
34299,1731,1935,0.0,1833.0,-204
34300,2041,1999,1.0,2020.0,42
34301,1795,1830,0.5,1812.5,-35
34302,1941,1943,1.0,1942.0,-2
34303,1972,1844,1.0,1908.0,128
34304,2012,1441,1.0,1726.5,571
34305,1715,1777,0.0,1746.0,-62
34306,1800,2177,0.5,1988.5,-377
34307,1624,1727,1.0,1675.5,-103
34308,1860,1707,0.5,1783.5,153
34309,1974,2010,1.0,1992.0,-36
34310,1839,1831,1.0,1835.0,8
34311,1989,1838,1.0,1913.5,151
34312,1749,1525,0.5,1637.0,224
34313,1487,1421,0.0,1454.0,66
34314,2262,1530,1.0,1896.0,732
34315,1289,1994,0.0,1641.5,-705
34316,1708,1812,0.5,1760.0,-104
34317,2103,2017,1.0,2060.0,86
34318,1797,1975,1.0,1886.0,-178
34319,1794,1851,0.0,1822.5,-57
34320,1481,1663,1.0,1572.0,-182
34321,1844,1874,0.0,1859.0,-30
34322,1677,1778,1.0,1727.5,-101
34323,1752,1723,0.5,1737.5,29
34324,1536,1840,0.0,1688.0,-304
34325,1798,1803,1.0,1800.5,-5
34326,1632,1657,1.0,1644.5,-25
34327,1723,1519,1.0,1621.0,204
34328,1464,1478,0.5,1471.0,-14
34329,1811,1627,0.5,1719.0,184
34330,1454,1501,1.0,1477.5,-47
34331,1461,1579,0.5,1520.0,-118
34332,1981,1690,0.0,1835.5,291
34333,1511,2033,0.0,1772.0,-522
34334,1519,1594,1.0,1556.5,-75
34335,1832,1881,0.0,1856.5,-49
34336,1918,1833,1.0,1875.5,85
34337,1774,1769,1.0,1771.5,5
34338,2064,1938,0.5,2001.0,126
34339,1833,2017,1.0,1925.0,-184
34340,1874,1947,1.0,1910.5,-73
34341,1920,1633,1.0,1776.5,287
34342,1472,1628,1.0,1550.0,-156
34343,1680,1536,1.0,1608.0,144
34344,1305,1483,0.0,1394.0,-178
34345,2029,1710,1.0,1869.5,319
34346,1681,1724,0.0,1702.5,-43
34347,1607,1723,1.0,1665.0,-116
34348,1537,1622,0.0,1579.5,-85
34349,1664,1726,1.0,1695.0,-62
34350,1603,1762,1.0,1682.5,-159
34351,2396,2661,0.0,2528.5,-265
34352,2559,2397,1.0,2478.0,162
34353,2206,2508,0.5,2357.0,-302
34354,2468,2128,1.0,2298.0,340
34355,1627,2216,0.0,1921.5,-589
34356,2166,1454,1.0,1810.0,712
34357,1579,2213,0.0,1896.0,-634
34358,2182,1364,1.0,1773.0,818
34359,2485,2352,1.0,2418.5,133
34360,2324,2347,0.5,2335.5,-23
34361,2327,2269,0.5,2298.0,58
34362,2147,2274,0.5,2210.5,-127
34363,2540,2550,0.5,2545.0,-10
34364,2494,2524,0.0,2509.0,-30
34365,2531,2478,0.5,2504.5,53
34366,2475,2479,0.5,2477.0,-4
34367,2395,2391,1.0,2393.0,4
34368,2324,2424,1.0,2374.0,-100
34369,2385,2317,0.5,2351.0,68
34370,2314,2314,1.0,2314.0,0
34371,2425,2555,0.5,2490.0,-130
34372,2530,2312,0.0,2421.0,218
34373,2297,2487,1.0,2392.0,-190
34374,2468,2323,0.5,2395.5,145
34375,2470,2336,0.5,2403.0,134
34376,2375,2398,0.5,2386.5,-23
34377,2380,2333,1.0,2356.5,47
34378,2289,2301,0.0,2295.0,-12
34379,2480,2464,0.5,2472.0,16
34380,2369,2385,0.5,2377.0,-16
34381,2375,2364,1.0,2369.5,11
34382,2301,2316,0.0,2308.5,-15
34383,2407,2422,0.5,2414.5,-15
34384,2446,2261,0.0,2353.5,185
34385,2032,2354,0.0,2193.0,-322
34386,2327,2020,1.0,2173.5,307
34387,2334,2474,1.0,2404.0,-140
34388,2466,2286,0.5,2376.0,180
34389,2274,2366,0.0,2320.0,-92
34390,2315,2263,1.0,2289.0,52
34391,2269,2236,0.5,2252.5,33
34392,2169,2318,0.5,2243.5,-149
34393,2184,2129,0.5,2156.5,55
34394,2123,2113,1.0,2118.0,10
34395,2345,2215,0.5,2280.0,130
34396,2237,2270,0.5,2253.5,-33
34397,2317,2289,0.5,2303.0,28
34398,2271,2291,0.0,2281.0,-20
34399,2312,2358,0.5,2335.0,-46
34400,2383,2275,1.0,2329.0,108
34401,2276,2338,0.5,2307.0,-62
34402,2214,2198,1.0,2206.0,16
34403,2367,2299,0.0,2333.0,68
34404,2240,2282,0.0,2261.0,-42
34405,2218,2218,0.0,2218.0,0
34406,2180,2121,1.0,2150.5,59
34407,2386,2490,0.5,2438.0,-104
34408,2453,2170,1.0,2311.5,283
34409,2160,2275,0.0,2217.5,-115
34410,2313,2117,0.5,2215.0,196
34411,2410,2307,1.0,2358.5,103
34412,2269,2346,1.0,2307.5,-77
34413,2109,2329,1.0,2219.0,-220
34414,2331,2125,1.0,2228.0,206
34415,2327,2207,1.0,2267.0,120
34416,2076,2281,0.0,2178.5,-205
34417,2291,2118,0.5,2204.5,173
34418,2008,2042,0.5,2025.0,-34
34419,2251,2205,0.0,2228.0,46
34420,2094,2259,0.0,2176.5,-165
34421,2043,2068,0.5,2055.5,-25
34422,2216,2074,1.0,2145.0,142
34423,2112,2210,0.5,2161.0,-98
34424,2210,2211,1.0,2210.5,-1
34425,1791,2186,0.5,1988.5,-395
34426,2168,1687,1.0,1927.5,481
34427,2189,2521,0.0,2355.0,-332
34428,2392,2135,1.0,2263.5,257
34429,2131,2352,0.0,2241.5,-221
34430,2318,2083,1.0,2200.5,235
34431,2505,2214,1.0,2359.5,291
34432,2205,2342,0.0,2273.5,-137
34433,2325,2098,0.5,2211.5,227
34434,2055,2279,0.0,2167.0,-224
34435,2296,2394,0.0,2345.0,-98
34436,2077,2291,1.0,2184.0,-214
34437,2190,1913,1.0,2051.5,277
34438,2027,2156,0.0,2091.5,-129
34439,2278,2182,0.5,2230.0,96
34440,2165,2347,0.5,2256.0,-182
34441,2247,2044,0.5,2145.5,203
34442,2048,2217,0.0,2132.5,-169
34443,2500,2081,1.0,2290.5,419
34444,2016,2235,0.5,2125.5,-219
34445,2257,1939,1.0,2098.0,318
34446,1950,1933,0.0,1941.5,17
34447,2178,1859,1.0,2018.5,319
34448,1981,2060,0.5,2020.5,-79
34449,1944,1994,0.0,1969.0,-50
34450,1734,1873,0.0,1803.5,-139
34451,2228,2226,0.5,2227.0,2
34452,2222,2141,0.0,2181.5,81
34453,2127,2000,1.0,2063.5,127
34454,1991,2044,0.0,2017.5,-53
34455,2188,2071,0.5,2129.5,117
34456,1890,2076,0.5,1983.0,-186
34457,1922,1781,0.0,1851.5,141
34458,1693,1715,0.5,1704.0,-22
34459,1519,2294,0.0,1906.5,-775
34460,2205,1723,1.0,1964.0,482
34461,1478,2127,0.0,1802.5,-649
34462,2169,1892,1.0,2030.5,277
34463,1840,2065,0.0,1952.5,-225
34464,1954,1798,0.0,1876.0,156
34465,1627,1932,1.0,1779.5,-305
34466,1899,1986,0.0,1942.5,-87
34467,1831,1974,0.5,1902.5,-143
34468,1698,1906,0.0,1802.0,-208
34469,1964,1839,0.5,1901.5,125
34470,2070,2293,1.0,2181.5,-223
34471,1886,1916,1.0,1901.0,-30
34472,2132,2032,0.0,2082.0,100
34473,2147,1860,0.0,2003.5,287
34474,1982,2273,0.5,2127.5,-291
34475,1964,1995,0.0,1979.5,-31
34476,1862,1915,0.0,1888.5,-53
34477,2229,1984,1.0,2106.5,245
34478,2074,2122,0.0,2098.0,-48
34479,1942,2008,0.5,1975.0,-66
34480,1960,1969,1.0,1964.5,-9
34481,1991,2045,0.0,2018.0,-54
34482,2136,2241,1.0,2188.5,-105
34483,1732,1756,0.0,1744.0,-24
34484,2109,2089,1.0,2099.0,20
34485,2107,1697,0.5,1902.0,410
34486,1941,2112,0.5,2026.5,-171
34487,1709,1921,0.0,1815.0,-212
34488,1972,1844,1.0,1908.0,128
34489,1899,1687,0.5,1793.0,212
34490,2095,2170,1.0,2132.5,-75
34491,1764,1920,0.0,1842.0,-156
34492,1801,2100,1.0,1950.5,-299
34493,1747,1715,0.0,1731.0,32
34494,2177,2012,1.0,2094.5,165
34495,1669,1627,0.0,1648.0,42
34496,1800,1859,1.0,1829.5,-59
34497,2021,1759,1.0,1890.0,262
34498,1999,2049,0.5,2024.0,-50
34499,1698,2004,1.0,1851.0,-306
34500,1895,2041,1.0,1968.0,-146
34501,1811,1785,0.0,1798.0,26
34502,2171,2401,0.5,2286.0,-230
34503,1972,2052,0.5,2012.0,-80
34504,2095,2016,0.0,2055.5,79
34505,1981,1938,0.0,1959.5,43
34506,2173,2168,1.0,2170.5,5
34507,1759,2033,0.5,1896.0,-274
34508,2122,2098,0.0,2110.0,24
34509,1874,1881,0.5,1877.5,-7
34510,1567,1989,0.5,1778.0,-422
34511,1487,1525,0.0,1506.0,-38
34512,1833,1752,0.0,1792.5,81
34513,1968,2085,1.0,2026.5,-117
34514,1769,1918,0.0,1843.5,-149
34515,1920,1971,0.5,1945.5,-51
34516,2422,1774,1.0,2098.0,648
34517,2017,1552,0.0,1784.5,465
34518,1731,2017,0.5,1874.0,-286
34519,1808,1550,1.0,1679.0,258
34520,2102,1712,1.0,1907.0,390
34521,1738,2027,0.0,1882.5,-289
34522,1698,1626,0.0,1662.0,72
34523,1938,2024,0.0,1981.0,-86
34524,1747,2064,1.0,1905.5,-317
34525,1787,1768,0.0,1777.5,19
34526,1728,1874,0.0,1801.0,-146
34527,1862,1747,0.0,1804.5,115
34528,1634,1869,0.0,1751.5,-235
34529,1689,1362,1.0,1525.5,327
34530,1478,1657,0.0,1567.5,-179
34531,1749,1565,0.0,1657.0,184
34532,1727,2158,0.0,1942.5,-431
34533,2020,1576,0.0,1798.0,444
34534,1534,1903,0.0,1718.5,-369
34535,1877,1538,1.0,1707.5,339
34536,2262,2113,1.0,2187.5,149
34537,2089,1994,0.5,2041.5,95
34538,1708,1982,0.0,1845.0,-274
34539,1882,1849,1.0,1865.5,33
34540,2017,1726,1.0,1871.5,291
34541,1664,1797,1.0,1730.5,-133
34542,1851,1762,0.5,1806.5,89
34543,1603,1481,1.0,1542.0,122
34544,1727,1715,1.0,1721.0,12
34545,1729,1624,1.0,1676.5,105
34546,1464,1860,1.0,1662.0,-396
34547,1526,1540,0.5,1533.0,-14
34548,1521,1680,0.0,1600.5,-159
34549,1483,1844,0.0,1663.5,-361
34550,1778,1762,0.0,1770.0,16
34551,1723,2029,0.0,1876.0,-306
34552,1676,1803,0.0,1739.5,-127
34553,1724,1681,0.0,1702.5,43
34554,1507,1632,0.0,1569.5,-125
34555,1904,1975,0.5,1939.5,-71
34556,1289,1530,0.0,1409.5,-241
34557,1663,1794,1.0,1728.5,-131
34558,1811,1501,1.0,1656.0,310
34559,1461,1467,0.0,1464.0,-6
34560,1633,1690,0.5,1661.5,-57
34561,1511,1660,0.5,1585.5,-149
34562,1920,1594,0.0,1757.0,326
34563,1592,1846,0.0,1719.0,-254
34564,1820,1771,1.0,1795.5,49
34565,1663,1541,0.0,1602.0,122
34566,1973,1737,0.5,1855.0,236
34567,1723,2003,0.0,1863.0,-280
34568,1950,1537,1.0,1743.5,413
34569,1622,1947,0.0,1784.5,-325
34570,1935,1410,1.0,1672.5,525
34571,1731,1734,1.0,1732.5,-3
34572,1546,1628,0.0,1587.0,-82
34573,1536,1472,0.0,1504.0,64
34574,2661,2485,1.0,2573.0,176
34575,2347,2559,0.5,2453.0,-212
34576,2508,2327,1.0,2417.5,181
34577,2321,2468,0.5,2394.5,-147
34578,2207,2216,0.0,2211.5,-9
34579,2189,2076,1.0,2132.5,113
34580,2096,2213,0.0,2154.5,-117
34581,2182,2118,1.0,2150.0,64
34582,2425,2540,0.0,2482.5,-115
34583,2524,2312,0.5,2418.0,212
34584,2297,2531,0.0,2414.0,-234
34585,2484,2323,1.0,2403.5,161
34586,2324,2470,0.0,2397.0,-146
34587,2398,2317,1.0,2357.5,81
34588,2314,2380,1.0,2347.0,-66
34589,2359,2276,1.0,2317.5,83
34590,2358,2480,0.0,2419.0,-122
34591,2385,2383,1.0,2384.0,2
34592,2338,2316,0.5,2327.0,22
34593,2318,2214,0.5,2266.0,104
34594,2352,2299,0.5,2325.5,53
34595,2240,2324,0.0,2282.0,-84
34596,2269,2170,0.5,2219.5,99
34597,2180,2232,1.0,2206.0,-52
34598,2327,2396,0.0,2361.5,-69
34599,2397,2281,0.5,2339.0,116
34600,2291,2206,1.0,2248.5,85
34601,2128,2042,1.0,2085.0,86
34602,2474,2205,0.5,2339.5,269
34603,2094,2466,0.0,2280.0,-372
34604,2366,2068,0.5,2217.0,298
34605,2216,2252,0.0,2234.0,-36
34606,2422,2236,1.0,2329.0,186
34607,2153,2404,0.0,2278.5,-251
34608,2354,2129,1.0,2241.5,225
34609,2123,2327,0.0,2225.0,-204
34610,2490,2324,1.0,2407.0,166
34611,2270,2453,0.0,2361.5,-183
34612,2275,2317,0.0,2296.0,-42
34613,2291,2313,0.5,2302.0,-22
34614,2550,2278,1.0,2414.0,272
34615,2347,2478,0.0,2412.5,-131
34616,2475,2247,1.0,2361.0,228
34617,2217,2435,1.0,2326.0,-218
34618,2368,2178,0.5,2273.0,190
34619,2060,2210,0.0,2135.0,-150
34620,2210,1944,1.0,2077.0,266
34621,1873,2168,0.0,2020.5,-295
34622,2521,2395,1.0,2458.0,126
34623,2424,2392,1.0,2408.0,32
34624,2352,2385,0.0,2368.5,-33
34625,2258,2318,0.0,2288.0,-60
34626,2555,2505,0.5,2530.0,50
34627,2342,2530,0.0,2436.0,-188
34628,2468,2325,1.0,2396.5,143
34629,2279,2379,0.5,2329.0,-100
34630,2307,2500,0.0,2403.5,-193
34631,2235,2269,0.0,2252.0,-34
34632,2329,2257,0.0,2293.0,72
34633,1933,2171,0.0,2052.0,-238
34634,2336,2410,0.5,2373.0,-74
34635,2346,2375,0.5,2360.5,-29
34636,2333,2109,0.5,2221.0,224
34637,2125,2252,0.0,2188.5,-127
34638,2241,2407,0.0,2324.0,-166
34639,2261,2136,1.0,2198.5,125
34640,2089,2032,1.0,2060.5,57
34641,2023,2109,1.0,2066.0,-86
34642,2273,2275,0.0,2274.0,-2
34643,2276,1982,1.0,2129.0,294
34644,1915,2198,0.0,2056.5,-283
34645,2200,1839,0.5,2019.5,361
34646,2215,2296,0.0,2255.5,-81
34647,2291,2237,1.0,2264.0,54
34648,2289,2190,1.0,2239.5,99
34649,2156,2174,0.5,2165.0,-18
34650,2251,2168,0.5,2209.5,83
34651,2173,2259,0.5,2216.0,-86
34652,2043,2098,1.0,2070.5,-55
34653,2119,2221,0.5,2170.0,-102
34654,1874,2367,0.0,2120.5,-493
34655,2282,1677,1.0,1979.5,605
34656,2121,2235,1.0,2178.0,-114
34657,2229,1752,1.0,1990.5,477
34658,2318,2269,1.0,2293.5,49
34659,1942,2008,0.0,1975.0,-66
34660,2113,2184,0.0,2148.5,-71
34661,2369,2045,1.0,2207.0,324
34662,1945,1964,0.0,1954.5,-19
34663,2301,2364,1.0,2332.5,-63
34664,1860,1886,0.5,1873.0,-26
34665,2085,2318,0.5,2201.5,-233
34666,2127,2228,0.5,2177.5,-101
34667,1971,1968,0.0,1969.5,3
34668,2099,2044,1.0,2071.5,55
34669,2294,1920,0.5,2107.0,374
34670,2077,2394,0.5,2235.5,-317
34671,2127,2205,0.5,2166.0,-78
34672,2027,1913,1.0,1970.0,114
34673,2113,2027,0.5,2070.0,86
34674,2010,2089,1.0,2049.5,-79
34675,2061,1974,1.0,2017.5,87
34676,1839,1882,1.0,1860.5,-43
34677,2170,2112,1.0,2141.0,58
34678,1941,2095,0.5,2018.0,-154
34679,2100,1844,1.0,1972.0,256
34680,1972,1801,0.5,1886.5,171
34681,2386,2021,0.0,2203.5,365
34682,2004,2170,0.5,2087.0,-166
34683,2117,1698,1.0,1907.5,419
34684,1785,2032,0.0,1908.5,-247
34685,2071,2012,0.5,2041.5,59
34686,2177,1890,1.0,2033.5,287
34687,1781,1859,0.0,1820.0,-78
34688,1800,1763,1.0,1781.5,37
34689,2182,2081,1.0,2131.5,101
34690,2016,2165,0.5,2090.5,-149
34691,2044,1997,1.0,2020.5,47
34692,1950,1953,0.0,1951.5,-3
34693,2401,2422,0.5,2411.5,-21
34694,1552,2120,0.5,1836.0,-568
34695,2171,1731,1.0,1951.0,440
34696,1981,2095,0.0,2038.0,-114
34697,1972,2052,1.0,2012.0,-80
34698,1734,1994,0.5,1864.0,-260
34699,1594,1938,0.0,1766.0,-344
34700,2214,1616,1.0,1915.0,598
34701,1869,1862,0.0,1865.5,7
34702,2098,2205,1.0,2151.5,-107
34703,1657,1689,0.0,1673.0,-32
34704,2169,2165,0.0,2167.0,4
34705,2189,2456,0.0,2322.5,-267
34706,1954,2065,0.5,2009.5,-111
34707,2083,2135,0.0,2109.0,-52
34708,2024,1932,0.0,1978.0,92
34709,2211,2112,1.0,2161.5,99
34710,1747,1782,0.0,1764.5,-35
34711,1618,1791,0.5,1704.5,-173
34712,1892,1768,1.0,1830.0,124
34713,1980,2102,1.0,2041.0,-122
34714,1798,1840,1.0,1819.0,-42
34715,1626,1893,0.0,1759.5,-267
34716,1986,1627,1.0,1806.5,359
34717,1906,1877,1.0,1891.5,29
34718,2293,1698,1.0,1995.5,595
34719,2003,1973,1.0,1988.0,30
34720,2032,2070,0.5,2051.0,-38
34721,1947,1950,1.0,1948.5,-3
34722,2074,2132,1.0,2103.0,-58
34723,1669,1747,0.5,1708.0,-78
34724,2019,1969,0.0,1994.0,50
34725,1589,1759,0.0,1674.0,-170
34726,1935,1960,0.0,1947.5,-25
34727,2076,2188,0.5,2132.0,-112
34728,1830,1734,0.0,1782.0,96
34729,1715,1922,0.0,1818.5,-207
34730,1860,1795,0.0,1827.5,65
34731,1921,2107,1.0,2014.0,-186
34732,1658,1709,0.5,1683.5,-51
34733,2049,1899,0.0,1974.0,150
34734,1920,1999,0.0,1959.5,-79
34735,2041,1846,0.0,1943.5,195
34736,1764,1943,0.0,1853.5,-179
34737,2147,1519,1.0,1833.0,628
34738,1723,2001,1.0,1862.0,-278
34739,1995,1478,1.0,1736.5,517
34740,1989,1984,0.5,1986.5,5
34741,1759,2033,0.5,1896.0,-274
34742,1487,1567,1.0,1527.0,-80
34743,1881,1519,1.0,1700.0,362
34744,1991,1421,1.0,1706.0,570
34745,1918,1833,0.0,1875.5,85
34746,1732,1756,0.0,1744.0,-24
34747,1769,1713,1.0,1741.0,56
34748,1844,1805,0.5,1824.5,39
34749,1762,1735,1.0,1748.5,27
34750,2158,1723,1.0,1940.5,435
34751,1749,1838,0.0,1793.5,-89
34752,1692,1903,1.0,1797.5,-211
34753,1565,1877,0.0,1721.0,-312
34754,1690,2103,0.0,1896.5,-413
34755,1975,1511,1.0,1743.0,464
34756,1594,1904,0.5,1749.0,-310
34757,2226,2262,1.0,2244.0,-36
34758,1994,2026,0.0,2010.0,-32
34759,2000,1708,0.0,1854.0,292
34760,1812,1991,0.5,1901.5,-179
34761,1777,1964,1.0,1870.5,-187
34762,2017,1715,0.0,1866.0,302
34763,1624,1797,0.0,1710.5,-173
34764,1851,1729,0.0,1790.0,122
34765,1846,1627,1.0,1736.5,219
34766,1454,1820,0.0,1637.0,-366
34767,1541,1579,1.0,1560.0,-38
34768,1364,1346,1.0,1355.0,18
34769,1947,2064,1.0,2005.5,-117
34770,1526,1787,1.0,1656.5,-261
34771,1874,1680,1.0,1777.0,194
34772,1803,1536,1.0,1669.5,267
34773,1632,1676,1.0,1654.0,-44
34774,1712,2017,0.0,1864.5,-305
34775,2017,1738,1.0,1877.5,279
34776,1808,1833,1.0,1820.5,-25
34777,2029,1449,1.0,1739.0,580
34778,1747,1724,1.0,1735.5,23
34779,1634,1747,1.0,1690.5,-113
34780,1710,1362,1.0,1536.0,348
34781,1727,1576,0.0,1651.5,151
34782,1534,1538,0.0,1536.0,-4
34783,1501,1811,0.0,1656.0,-310
34784,1410,1461,0.0,1435.5,-51
34785,1540,1864,0.5,1702.0,-324
34786,1607,1521,1.0,1564.0,86
34787,1920,1660,0.0,1790.0,260
34788,1723,1737,1.0,1730.0,-14
34789,1663,1592,0.0,1627.5,71
34790,1507,1667,1.0,1587.0,-160
34791,1628,1530,1.0,1579.0,98
34792,1472,1546,1.0,1509.0,-74
34793,1726,1536,1.0,1631.0,190
34794,2334,2229,1.0,2281.5,105
34795,1454,1664,0.0,1559.0,-210
34796,2274,2286,1.0,2280.0,-12
34797,2540,1762,1.0,2151.0,778
34798,2559,2661,0.5,2610.0,-102
34799,2531,2524,0.5,2527.5,7
34800,2468,2508,0.0,2488.0,-40
34801,2216,2484,0.5,2350.0,-268
34802,2269,2307,1.0,2288.0,-38
34803,2166,2189,0.0,2177.5,-23
34804,2171,2329,1.0,2250.0,-158
34805,2470,2182,0.0,2326.0,288
34806,2385,2480,0.5,2432.5,-95
34807,2359,2380,1.0,2369.5,-21
34808,2316,2375,0.5,2345.5,-59
34809,2485,2301,0.5,2393.0,184
34810,2404,2422,0.5,2413.0,-18
34811,2321,2347,1.0,2334.0,-26
34812,2354,2446,0.5,2400.0,-92
34813,2490,2274,1.0,2382.0,216
34814,2466,2474,0.5,2470.0,-8
34815,2275,2453,0.5,2364.0,-178
34816,2252,2366,1.0,2309.0,-114
34817,2396,2313,1.0,2354.5,83
34818,2324,2352,1.0,2338.0,-28
34819,2206,2397,1.0,2301.5,-191
34820,2147,2269,1.0,2208.0,-122
34821,2550,2128,0.5,2339.0,422
34822,2312,2425,0.0,2368.5,-113
34823,2478,2494,1.0,2486.0,-16
34824,2323,2297,0.5,2310.0,26
34825,2299,2475,0.5,2387.0,-176
34826,2210,2368,0.5,2289.0,-158
34827,2218,2170,0.0,2194.0,48
34828,2168,2186,1.0,2177.0,-18
34829,2336,2180,0.0,2258.0,156
34830,2530,2555,0.5,2542.5,-25
34831,2333,2375,0.0,2354.0,-42
34832,2468,2487,0.5,2477.5,-19
34833,2391,2252,0.5,2321.5,139
34834,2418,2521,1.0,2469.5,-103
34835,2314,2324,0.0,2319.0,-10
34836,2318,2352,1.0,2335.0,-34
34837,2358,2276,0.0,2317.0,82
34838,2261,2407,1.0,2334.0,-146
34839,2338,2383,1.0,2360.5,-45
34840,2023,2020,0.0,2021.5,3
34841,2345,2034,0.5,2189.5,311
34842,2275,2312,0.5,2293.5,-37
34843,2270,2324,0.5,2297.0,-54
34844,2198,2276,0.0,2237.0,-78
34845,2236,2317,0.5,2276.5,-81
34846,2385,2395,1.0,2390.0,-10
34847,2129,2169,0.0,2149.0,-40
34848,2258,2314,0.0,2286.0,-56
34849,2500,2123,0.5,2311.5,377
34850,2170,2386,1.0,2278.0,-216
34851,2257,2235,1.0,2246.0,22
34852,2032,2117,0.5,2074.5,-85
34853,2296,2000,0.5,2148.0,296
34854,2369,2464,1.0,2416.5,-95
34855,2156,2291,0.0,2223.5,-135
34856,2318,2301,1.0,2309.5,17
34857,2229,2019,1.0,2124.0,210
34858,2291,2281,0.5,2286.0,10
34859,2286,2334,0.0,2310.0,-48
34860,2042,2074,0.0,2058.0,-32
34861,2205,2274,0.0,2239.5,-69
34862,2282,2367,1.0,2324.5,-85
34863,2216,2068,0.0,2142.0,148
34864,2235,2218,1.0,2226.5,17
34865,2228,1999,1.0,2113.5,229
34866,2010,2141,0.0,2075.5,-131
34867,2044,1974,1.0,2009.0,70
34868,1831,2099,0.0,1965.0,-268
34869,2394,2251,1.0,2322.5,143
34870,2259,2077,1.0,2168.0,182
34871,1913,2043,0.0,1978.0,-130
34872,2221,2027,1.0,2124.0,194
34873,2012,2170,0.0,2091.0,-158
34874,2095,2177,0.0,2136.0,-82
34875,1859,2100,0.0,1979.5,-241
34876,1801,1800,0.0,1800.5,1
34877,2178,2505,0.0,2341.5,-327
34878,2325,2060,1.0,2192.5,265
34879,1944,2303,0.5,2123.5,-359
34880,2279,1873,1.0,2076.0,406
34881,2410,2112,1.0,2261.0,298
34882,2211,2346,0.0,2278.5,-135
34883,2109,1791,0.0,1950.0,318
34884,1687,2123,0.0,1905.0,-436
34885,2318,1892,1.0,2105.0,426
34886,1798,2184,0.0,1991.0,-386
34887,2113,1627,1.0,1870.0,486
34888,1657,2102,0.0,1879.5,-445
34889,2401,2165,0.0,2283.0,236
34890,2044,2120,0.0,2082.0,-76
34891,2016,2048,0.0,2032.0,-32
34892,1953,2095,0.5,2024.0,-142
34893,2214,2169,0.0,2191.5,45
34894,2065,2205,0.0,2135.0,-140
34895,2098,1954,1.0,2026.0,144
34896,1782,2165,0.0,1973.5,-383
34897,1811,2229,0.0,2020.0,-418
34898,2008,2052,1.0,2030.0,-44
34899,1972,1942,1.0,1957.0,30
34900,2045,1938,0.5,1991.5,107
34901,2278,2215,0.0,2246.5,63
34902,2237,2247,1.0,2242.0,-10
34903,2217,2289,1.0,2253.0,-72
34904,2271,2200,1.0,2235.5,71
34905,2188,1986,1.0,2087.0,202
34906,1877,2076,1.0,1976.5,-199
34907,1922,1899,1.0,1910.5,23
34908,1906,1874,1.0,1890.0,32
34909,2294,2147,0.0,2220.5,147
34910,2001,2205,0.0,2103.0,-204
34911,2027,1995,1.0,2011.0,32
34912,1984,1815,0.5,1899.5,169
34913,2021,2122,0.5,2071.5,-101
34914,2074,2004,1.0,2039.0,70
34915,1698,2019,0.0,1858.5,-321
34916,1960,1785,0.0,1872.5,175
34917,2273,2113,1.0,2193.0,160
34918,2089,1982,0.5,2035.5,107
34919,1862,2061,0.0,1961.5,-199
34920,1982,1839,0.0,1910.5,143
34921,1844,2071,0.0,1957.5,-227
34922,1890,1735,1.0,1812.5,155
34923,1762,1693,1.0,1727.5,69
34924,1763,1723,1.0,1743.0,40
34925,2107,1820,1.0,1963.5,287
34926,1687,1921,0.0,1804.0,-234
34927,1346,1541,0.0,1443.5,-195
34928,1777,1658,0.0,1717.5,119
34929,2222,2226,1.0,2224.0,-4
34930,1624,1727,0.0,1675.5,-103
34931,1991,2026,0.0,2008.5,-35
34932,2112,1729,0.5,1920.5,383
34933,1968,2085,1.0,2026.5,-117
34934,1844,1941,0.5,1892.5,-97
34935,1610,1971,1.0,1790.5,-361
34936,2168,1441,0.0,1804.5,727
34937,1677,1874,0.0,1775.5,-197
34938,2098,2173,1.0,2135.5,-75
34939,2207,2119,0.5,2163.0,88
34940,2020,2158,0.5,2089.0,-138
34941,2118,2096,1.0,2107.0,22
34942,1692,1903,0.0,1797.5,-211
34943,2103,2008,1.0,2055.5,95
34944,1950,2003,1.0,1976.5,-53
34945,1904,1975,1.0,1939.5,-71
34946,1804,1947,1.0,1875.5,-143
34947,1945,1794,1.0,1869.5,151
34948,1994,1859,0.0,1926.5,135
34949,1886,1916,1.0,1901.0,-30
34950,1616,1734,0.5,1675.0,-118
34951,2135,2189,1.0,2162.0,-54
34952,1833,2017,0.0,1925.0,-184
34953,2083,2131,0.0,2107.0,-48
34954,2422,1808,1.0,2115.0,614
34955,1999,2049,0.0,2024.0,-50
34956,1550,1552,0.0,1551.0,-2
34957,1943,1895,1.0,1919.0,48
34958,2016,1567,0.5,1791.5,449
34959,1525,1997,0.0,1761.0,-472
34960,1939,1487,1.0,1713.0,452
34961,1421,1950,0.0,1685.5,-529
34962,2102,1747,0.5,1924.5,355
34963,1747,2027,0.0,1887.0,-280
34964,1980,1634,1.0,1807.0,346
34965,1362,1893,0.0,1627.5,-531
34966,1862,1899,0.0,1880.5,-37
34967,1846,1689,0.5,1767.5,157
34968,1657,1764,0.0,1710.5,-107
34969,1715,1599,0.0,1657.0,116
34970,2033,1981,1.0,2007.0,52
34971,1676,1536,0.0,1606.0,140
34972,1881,1759,1.0,1820.0,122
34973,1938,1632,0.5,1785.0,306
34974,1756,1991,1.0,1873.5,-235
34975,1787,1947,0.0,1867.0,-160
34976,1697,1805,0.5,1751.0,-108
34977,1833,1874,0.0,1853.5,-41
34978,1782,2024,1.0,1903.0,-242
34979,1769,1713,1.0,1741.0,56
34980,1728,1768,0.0,1748.0,-40
34981,1519,1774,0.0,1646.5,-255
34982,2070,2196,1.0,2133.0,-126
34983,1478,1723,0.0,1600.5,-245
34984,2132,2032,0.5,2082.0,100
34985,2262,1994,0.5,2128.0,268
34986,1708,1849,0.0,1778.5,-141
34987,1964,1607,1.0,1785.5,357
34988,1737,1797,0.5,1767.0,-60
34989,1851,1723,1.0,1787.0,128
34990,1537,1481,1.0,1509.0,56
34991,1464,1860,1.0,1662.0,-396
34992,1747,1627,0.5,1687.0,120
34993,1669,1759,0.0,1714.0,-90
34994,1526,1454,1.0,1490.0,72
34995,1579,1680,1.0,1629.5,-101
34996,1483,1364,0.0,1423.5,119
34997,1690,1734,1.0,1712.0,-44
34998,1731,1511,1.0,1621.0,220
34999,1594,1830,0.0,1712.0,-236
35000,1727,1507,1.0,1617.0,220
35001,1530,1576,0.0,1553.0,-46
35002,1534,1289,0.0,1411.5,245
35003,1838,1538,1.0,1688.0,300
35004,1501,1811,0.0,1656.0,-310
35005,1832,1565,0.5,1698.5,267
35006,1864,2029,1.0,1946.5,-165
35007,1521,1540,0.5,1530.5,-19
35008,1724,1681,1.0,1702.5,43
35009,1712,1710,1.0,1711.0,2
35010,1628,1449,1.0,1538.5,179
35011,1633,1536,1.0,1584.5,97
35012,1771,1592,0.0,1681.5,179
35013,1678,1660,1.0,1669.0,18
35014,1667,1663,0.0,1665.0,4
35015,1664,1410,0.0,1537.0,254
35016,2089,2241,1.0,2165.0,-152
35017,1762,1454,0.0,1608.0,308
35018,2145,2109,1.0,2127.0,36
35019,2540,1603,0.5,2071.5,937
35020,2347,2485,0.0,2416.0,-138
35021,2531,2524,1.0,2527.5,7
35022,2321,2327,0.0,2324.0,-6
35023,2296,2479,0.5,2387.5,-183
35024,2189,2216,1.0,2202.5,-27
35025,2156,2190,1.0,2173.0,-34
35026,2213,2166,1.0,2189.5,47
35027,2661,2019,1.0,2340.0,642
35028,2398,2470,0.5,2434.0,-72
35029,2508,2559,0.5,2533.5,-51
35030,2301,2359,0.0,2330.0,-58
35031,2480,2453,0.5,2466.5,27
35032,2366,2466,1.0,2416.0,-100
35033,2375,2385,1.0,2380.0,-10
35034,2252,2315,0.0,2283.5,-63
35035,2555,2318,0.0,2436.5,237
35036,2494,2550,0.5,2522.0,-56
35037,2487,2530,1.0,2508.5,-43
35038,2475,2478,0.0,2476.5,-3
35039,2368,2468,0.0,2418.0,-100
35040,2453,2490,1.0,2471.5,-37
35041,2210,2210,0.5,2210.0,0
35042,2313,2275,1.0,2294.0,38
35043,2521,2186,0.5,2353.5,335
35044,2397,2396,0.5,2396.5,1
35045,2352,2418,1.0,2385.0,-66
35046,2029,2206,0.0,2117.5,-177
35047,2345,2318,0.5,2331.5,27
35048,2364,2464,0.5,2414.0,-100
35049,2270,2324,0.5,2297.0,-54
35050,2318,2301,1.0,2309.5,17
35051,2307,2317,0.5,2312.0,-10
35052,2324,2352,0.5,2338.0,-28
35053,2171,2329,1.0,2250.0,-158
35054,2147,2232,0.5,2189.5,-85
35055,2422,2331,0.5,2376.5,91
35056,2334,2229,0.0,2281.5,105
35057,2354,2404,0.0,2379.0,-50
35058,2263,2274,0.0,2268.5,-11
35059,2395,2327,1.0,2361.0,68
35060,2141,2228,0.5,2184.5,-87
35061,2385,2424,0.5,2404.5,-39
35062,2099,2127,0.0,2113.0,-28
35063,2367,2314,0.5,2340.5,53
35064,2043,2259,0.5,2151.0,-216
35065,2218,2282,0.5,2250.0,-64
35066,2074,2221,0.0,2147.5,-147
35067,2182,2235,1.0,2208.5,-53
35068,2312,2425,1.0,2368.5,-113
35069,2044,2165,0.0,2104.5,-121
35070,2145,2297,1.0,2221.0,-152
35071,2505,2048,1.0,2276.5,457
35072,2177,2012,0.0,2094.5,165
35073,2303,2342,1.0,2322.5,-39
35074,1800,1859,0.0,1829.5,-59
35075,2407,2279,1.0,2343.0,128
35076,2240,2299,1.0,2269.5,-59
35077,2020,2261,0.5,2140.5,-241
35078,2180,2218,0.0,2199.0,-38
35079,2386,2023,0.5,2204.5,363
35080,2318,2269,1.0,2293.5,49
35081,2117,2160,0.5,2138.5,-43
35082,2102,2184,0.5,2143.0,-82
35083,2500,2032,1.0,2266.0,468
35084,2375,2336,1.0,2355.5,39
35085,2257,2235,0.0,2246.0,22
35086,2289,2333,0.5,2311.0,-44
35087,2170,1933,1.0,2051.5,237
35088,2317,2391,0.5,2354.0,-74
35089,2100,2095,1.0,2097.5,5
35090,2276,2314,1.0,2295.0,-38
35091,2410,1801,1.0,2105.5,609
35092,2205,2214,0.0,2209.5,-9
35093,2125,2346,0.0,2235.5,-221
35094,2165,2098,0.0,2131.5,67
35095,2229,2123,0.0,2176.0,106
35096,2383,2358,1.0,2370.5,25
35097,1942,2008,0.0,1975.0,-66
35098,2034,2338,1.0,2186.0,-304
35099,2312,1675,0.0,1993.5,637
35100,2094,2205,0.5,2149.5,-111
35101,2276,2275,1.0,2275.5,1
35102,1999,2068,1.0,2033.5,-69
35103,2215,2200,1.0,2207.5,15
35104,1982,2273,0.5,2127.5,-291
35105,2289,2237,1.0,2263.0,52
35106,1839,1915,0.0,1877.0,-76
35107,2327,2271,0.5,2299.0,56
35108,1913,2394,0.0,2153.5,-481
35109,2074,2291,1.0,2182.5,-217
35110,1862,2027,1.0,1944.5,-165
35111,2236,2042,1.0,2139.0,194
35112,1921,2107,0.0,2014.0,-186
35113,2169,2153,1.0,2161.0,16
35114,1687,1709,0.0,1698.0,-22
35115,2241,2123,0.0,2182.0,118
35116,2096,2207,0.0,2151.5,-111
35117,2089,2136,0.0,2112.5,-47
35118,2008,2118,0.0,2063.0,-110
35119,2085,2145,1.0,2115.0,-60
35120,2205,2294,0.0,2249.5,-89
35121,1971,1968,0.0,1969.5,3
35122,2027,2127,1.0,2077.0,-100
35123,2074,2122,0.5,2098.0,-48
35124,1831,2010,0.5,1920.5,-179
35125,2019,1969,0.5,1994.0,50
35126,2226,1839,1.0,2032.5,387
35127,2173,2168,0.0,2170.5,5
35128,2026,2222,0.0,2124.0,-196
35129,2119,2098,0.5,2108.5,21
35130,2071,2000,0.5,2035.5,71
35131,1916,1945,0.5,1930.5,-29
35132,1781,1890,0.0,1835.5,-109
35133,1860,1886,1.0,1873.0,-26
35134,1973,1763,0.0,1868.0,210
35135,2120,2401,0.5,2260.5,-281
35136,1950,2003,1.0,1976.5,-53
35137,2016,2171,1.0,2093.5,-155
35138,1981,1804,0.5,1892.5,177
35139,1877,1986,1.0,1931.5,-109
35140,1759,2033,0.5,1896.0,-274
35141,1906,1899,0.5,1902.5,7
35142,2169,1881,1.0,2025.0,288
35143,2060,2178,0.0,2119.0,-118
35144,1954,2065,1.0,2009.5,-111
35145,1873,1944,1.0,1908.5,-71
35146,2081,1932,0.5,2006.5,149
35147,2347,2278,1.0,2312.5,69
35148,1939,1997,0.0,1968.0,-58
35149,2217,2247,0.5,2232.0,-30
35150,2112,1950,0.5,2031.0,162
35151,2052,1811,0.0,1931.5,241
35152,1791,2211,0.0,2001.0,-420
35153,1938,1972,0.5,1955.0,-34
35154,1892,1618,1.0,1755.0,274
35155,2076,2188,0.5,2132.0,-112
35156,1627,1840,0.0,1733.5,-213
35157,1874,1922,1.0,1898.0,-48
35158,2456,1657,1.0,2056.5,799
35159,2027,2102,0.5,2064.5,-75
35160,2131,2135,0.5,2133.0,-4
35161,1893,1980,0.5,1936.5,-87
35162,1899,2083,0.0,1991.0,-184
35163,1904,2103,0.5,2003.5,-199
35164,1846,1920,1.0,1883.0,-74
35165,1663,1794,0.0,1728.5,-131
35166,2113,1764,1.0,1938.5,349
35167,1732,1756,0.0,1744.0,-24
35168,2061,2089,1.0,2075.0,-28
35169,1697,1805,0.0,1751.0,-108
35170,2021,1982,0.5,2001.5,39
35171,1785,1698,1.0,1741.5,87
35172,1464,1685,0.0,1574.5,-221
35173,2196,1935,1.0,2065.5,261
35174,1731,2070,0.0,1900.5,-339
35175,2032,1830,0.5,1931.0,202
35176,1795,2132,1.0,1963.5,-337
35177,2049,1844,1.0,1946.5,205
35178,1778,1999,0.0,1888.5,-221
35179,1895,1735,0.0,1815.0,160
35180,1762,1943,0.5,1852.5,-181
35181,2024,1777,1.0,1900.5,247
35182,1715,1782,0.0,1748.5,-67
35183,1747,1727,0.5,1737.0,20
35184,1729,1768,1.0,1748.5,-39
35185,1874,1747,0.5,1810.5,127
35186,1627,1677,0.0,1652.0,-50
35187,1759,1669,0.5,1714.0,90
35188,1838,1752,0.0,1795.0,86
35189,1552,2422,0.5,1987.0,-870
35190,1550,1731,1.0,1640.5,-181
35191,2158,1565,1.0,1861.5,593
35192,1454,1627,0.0,1540.5,-173
35193,1692,2020,1.0,1856.0,-328
35194,1364,1579,0.0,1471.5,-215
35195,1820,1877,1.0,1848.5,-57
35196,1540,1864,1.0,1702.0,-324
35197,1541,1521,1.0,1531.0,20
35198,1859,1346,1.0,1602.5,513
35199,1734,1981,1.0,1857.5,-247
35200,1467,1616,0.0,1541.5,-149
35201,1803,1530,1.0,1666.5,273
35202,1289,1676,0.0,1482.5,-387
35203,1833,2262,0.0,2047.5,-429
35204,1994,1918,0.5,1956.0,76
35205,1769,1708,0.5,1738.5,61
35206,1812,1774,0.5,1793.0,38
35207,1964,2112,0.0,2038.0,-148
35208,1844,2017,0.0,1930.5,-173
35209,1797,1972,0.0,1884.5,-175
35210,1441,1851,0.0,1646.0,-410
35211,1989,1712,1.0,1850.5,277
35212,1738,1567,0.5,1652.5,171
35213,1698,1421,1.0,1559.5,277
35214,2017,1869,0.5,1943.0,148
35215,1689,2017,0.0,1853.0,-328
35216,1833,1657,1.0,1745.0,176
35217,1599,1808,0.5,1703.5,-209
35218,1576,1727,1.0,1651.5,-151
35219,1538,1534,0.5,1536.0,4
35220,1747,1938,0.0,1842.5,-191
35221,2064,1747,1.0,1905.5,317
35222,1634,1947,0.5,1790.5,-313
35223,1874,1478,1.0,1676.0,396
35224,1607,1860,0.0,1733.5,-253
35225,1537,1737,1.0,1637.0,-200
35226,1811,1622,1.0,1716.5,189
35227,1461,1501,1.0,1481.0,-40
35228,1511,1690,0.0,1600.5,-179
35229,1723,1519,1.0,1621.0,204
35230,1483,1526,0.0,1504.5,-43
35231,2029,1633,1.0,1831.0,396
35232,1681,1678,0.5,1679.5,3
35233,1546,1628,0.0,1587.0,-82
35234,1305,1472,0.0,1388.5,-167
35235,1592,1663,0.0,1627.5,-71
35236,2147,1726,1.0,1936.5,421
35237,1664,1995,1.0,1829.5,-331
35238,1964,1762,0.0,1863.0,202
35239,1603,1984,0.5,1793.5,-381
35240,2490,2540,1.0,2515.0,-50
35241,2524,2453,1.0,2488.5,71
35242,2275,2484,0.5,2379.5,-209
35243,2479,2313,1.0,2396.0,166
35244,2205,2216,1.0,2210.5,-11
35245,2166,2094,1.0,2130.0,72
35246,2068,2213,0.5,2140.5,-145
35247,2182,2216,1.0,2199.0,-34
35248,2480,2661,0.5,2570.5,-181
35249,2559,2385,1.0,2472.0,174
35250,2375,2468,0.0,2421.5,-93
35251,2453,2318,1.0,2385.5,135
35252,2521,2555,0.5,2538.0,-34
35253,2530,2418,1.0,2474.0,112
35254,2392,2487,0.5,2439.5,-95
35255,2468,2352,0.5,2410.0,116
35256,2395,2367,1.0,2381.0,28
35257,2282,2424,0.5,2353.0,-142
35258,2385,2218,1.0,2301.5,167
35259,2235,2314,0.0,2274.5,-79
35260,2422,2307,0.5,2364.5,115
35261,2269,2404,0.0,2336.5,-135
35262,2354,2329,1.0,2341.5,25
35263,2171,2327,1.0,2249.0,-156
35264,2464,2485,1.0,2474.5,-21
35265,2347,2369,1.0,2358.0,-22
35266,2364,2327,0.5,2345.5,37
35267,2321,2318,0.0,2319.5,3
35268,2470,2410,0.0,2440.0,60
35269,2346,2398,0.0,2372.0,-52
35270,2380,2109,1.0,2244.5,271
35271,2123,2359,0.5,2241.0,-236
35272,2396,2550,0.0,2473.0,-154
35273,2494,2397,0.5,2445.5,97
35274,2128,2478,0.0,2303.0,-350
35275,2435,2029,1.0,2232.0,406
35276,2474,2170,0.0,2322.0,304
35277,2095,2466,0.0,2280.5,-371
35278,2366,2100,0.0,2233.0,266
35279,1801,2315,0.0,2058.0,-514
35280,2425,2358,1.0,2391.5,67
35281,2383,2312,1.0,2347.5,71
35282,2297,2338,0.5,2317.5,-41
35283,2214,2323,1.0,2268.5,-109
35284,2269,2407,1.0,2338.0,-138
35285,2032,2318,0.5,2175.0,-286
35286,2184,2020,0.0,2102.0,164
35287,2023,2113,0.0,2068.0,-90
35288,2505,2210,1.0,2357.5,295
35289,2210,2342,1.0,2276.0,-132
35290,2325,2186,1.0,2255.5,139
35291,2168,2303,0.0,2235.5,-135
35292,2352,2375,0.0,2363.5,-23
35293,2333,2324,0.0,2328.5,9
35294,2269,2289,0.5,2279.0,-20
35295,2252,2147,1.0,2199.5,105
35296,2228,2345,0.5,2286.5,-117
35297,2324,2141,0.0,2232.5,183
35298,2127,2270,0.5,2198.5,-143
35299,2291,2044,0.5,2167.5,247
35300,2122,2215,1.0,2168.5,-93
35301,2237,2074,1.0,2155.5,163
35302,1969,2289,0.0,2129.0,-320
35303,2271,1960,1.0,2115.5,311
35304,1945,2236,0.0,2090.5,-291
35305,2169,1916,1.0,2042.5,253
35306,1886,2129,1.0,2007.5,-243
35307,2123,1860,1.0,1991.5,263
35308,2229,2226,1.0,2227.5,3
35309,2222,2334,0.5,2278.0,-112
35310,2286,2000,1.0,2143.0,286
35311,1991,2274,0.0,2132.5,-283
35312,2259,2327,0.5,2293.0,-68
35313,2281,2043,0.5,2162.0,238
35314,2221,2291,0.0,2256.0,-70
35315,2074,2074,0.0,2074.0,0
35316,2299,2207,1.0,2253.0,92
35317,2076,2240,0.0,2158.0,-164
35318,2170,2096,1.0,2133.0,74
35319,2118,2218,0.0,2168.0,-100
35320,2401,2500,0.0,2450.5,-99
35321,2257,2120,1.0,2188.5,137
35322,2016,1933,1.0,1974.5,83
35323,2000,2095,0.0,2047.5,-95
35324,2205,2391,0.0,2298.0,-186
35325,2324,2127,1.0,2225.5,197
35326,2027,2317,0.0,2172.0,-290
35327,2276,1815,1.0,2045.5,461
35328,2177,2182,1.0,2179.5,-5
35329,2165,1859,0.5,2012.0,306
35330,1800,2044,0.0,1922.0,-244
35331,1953,1707,0.0,1830.0,246
35332,2085,2386,0.0,2235.5,-301
35333,2170,1968,1.0,2069.0,202
35334,1971,2160,0.0,2065.5,-189
35335,2032,1610,1.0,1821.0,422
35336,2188,2241,0.5,2214.5,-53
35337,2089,2076,0.5,2082.5,13
35338,1922,2109,0.0,2015.5,-187
35339,2145,1874,0.5,2009.5,271
35340,2278,2169,0.5,2223.5,109
35341,2065,2347,0.0,2206.0,-282
35342,2247,1954,1.0,2100.5,293
35343,1932,2217,0.0,2074.5,-285
35344,2205,1899,1.0,2052.0,306
35345,1920,2098,0.5,2009.0,-178
35346,2165,1846,1.0,2005.5,319
35347,1764,2055,0.0,1909.5,-291
35348,1986,2456,1.0,2221.0,-470
35349,2189,1877,1.0,2033.0,312
35350,1899,2131,0.5,2015.0,-232
35351,2083,1906,1.0,1994.5,177
35352,2312,2229,1.0,2270.5,83
35353,1942,2275,0.0,2108.5,-333
35354,2276,2045,1.0,2160.5,231
35355,1675,2198,0.0,1936.5,-523
35356,2113,2296,0.0,2204.5,-183
35357,2291,2089,1.0,2190.0,202
35358,2061,2190,0.0,2125.5,-129
35359,2156,1982,1.0,2069.0,174
35360,2422,2293,0.5,2357.5,129
35361,2196,1552,1.0,1874.0,644
35362,1550,2032,0.0,1791.0,-482
35363,2107,2021,0.0,2064.0,86
35364,2004,1921,1.0,1962.5,83
35365,1709,1698,0.0,1703.5,11
35366,1785,1658,1.0,1721.5,127
35367,2168,2394,0.0,2281.0,-226
35368,2077,2173,1.0,2125.0,-96
35369,2098,1913,0.5,2005.5,185
35370,1862,2119,0.0,1990.5,-257
35371,1811,2071,0.5,1941.0,-260
35372,1890,2052,0.5,1971.0,-162
35373,1972,1781,1.0,1876.5,191
35374,1693,1938,0.5,1815.5,-245
35375,2010,2049,0.0,2029.5,-39
35376,1999,1974,1.0,1986.5,25
35377,1831,2041,1.0,1936.0,-210
35378,1943,1839,1.0,1891.0,104
35379,1874,2158,1.0,2016.0,-284
35380,2020,1677,1.0,1848.5,343
35381,1692,1903,1.0,1797.5,-211
35382,2024,1752,1.0,1888.0,272
35383,1820,1846,1.0,1833.0,-26
35384,1747,1782,1.0,1764.5,-35
35385,1346,1768,0.0,1557.0,-422
35386,1973,1981,1.0,1977.0,-8
35387,1994,2003,1.0,1998.5,-9
35388,1950,1734,1.0,1842.0,216
35389,1616,1947,0.5,1781.5,-331
35390,1941,1892,0.0,1916.5,49
35391,1840,1844,1.0,1842.0,-4
35392,1972,1798,0.5,1885.0,174
35393,1627,1441,0.5,1534.0,186
35394,2027,2178,0.0,2102.5,-151
35395,2060,1980,1.0,2020.0,80
35396,1893,1944,0.5,1918.5,-51
35397,1873,1626,1.0,1749.5,247
35398,1727,2081,1.0,1904.0,-354
35399,2016,1534,1.0,1775.0,482
35400,1538,1997,0.0,1767.5,-459
35401,1950,1511,1.0,1730.5,439
35402,2017,1975,0.5,1996.0,42
35403,1904,2017,1.0,1960.5,-113
35404,1808,1794,1.0,1801.0,14
35405,2064,1938,1.0,2001.0,126
35406,1803,1536,0.0,1669.5,267
35407,1874,1787,0.0,1830.5,87
35408,1991,1632,1.0,1811.5,359
35409,1669,1627,1.0,1648.0,42
35410,1805,1732,1.0,1768.5,73
35411,1589,1759,0.5,1674.0,-170
35412,1777,1697,0.0,1737.0,80
35413,1525,1989,0.0,1757.0,-464
35414,1727,1715,1.0,1721.0,12
35415,1421,1487,0.0,1454.0,-66
35416,1864,1624,0.0,1744.0,240
35417,2001,2147,1.0,2074.0,-146
35418,1521,1540,0.0,1530.5,-19
35419,1964,1995,1.0,1979.5,-31
35420,1713,1918,1.0,1815.5,-205
35421,1774,1769,1.0,1771.5,5
35422,1778,1607,1.0,1692.5,171
35423,1723,1735,0.5,1729.0,-12
35424,1762,1537,0.5,1649.5,225
35425,1622,1723,0.5,1672.5,-101
35426,2262,2273,0.0,2267.5,-11
35427,1982,1994,1.0,1988.0,-12
35428,1708,1915,0.0,1811.5,-207
35429,1862,1849,1.0,1855.5,13
35430,1981,1964,0.5,1972.5,17
35431,2017,1759,0.0,1888.0,258
35432,1519,1797,1.0,1658.0,-278
35433,1851,1881,0.0,1866.0,-30
35434,1935,1734,0.0,1834.5,201
35435,1731,1464,0.0,1597.5,267
35436,1712,1795,0.5,1753.5,-83
35437,1724,1681,0.5,1702.5,43
35438,1627,1698,1.0,1662.5,-71
35439,1749,1838,1.0,1793.5,-89
35440,1579,1454,0.0,1516.5,125
35441,1832,1364,0.0,1598.0,468
35442,1723,1519,1.0,1621.0,204
35443,1467,1478,0.5,1472.5,-11
35444,1862,1869,0.0,1865.5,-7
35445,1689,1599,0.0,1644.0,90
35446,1811,1507,1.0,1659.0,304
35447,1289,1501,0.0,1395.0,-212
35448,1690,1747,1.0,1718.5,-57
35449,1747,1511,0.5,1629.0,236
35450,1594,1634,0.5,1614.0,-40
35451,1633,1660,1.0,1646.5,-27
35452,1920,1678,0.0,1799.0,242
35453,1771,1592,1.0,1681.5,179
35454,1680,1526,1.0,1603.0,154
35455,1628,1483,1.0,1555.5,145
35456,1536,1472,0.0,1504.0,64
35457,1710,1305,1.0,1507.5,405
35458,1726,2211,0.0,1968.5,-485
35459,1791,1664,0.5,1727.5,127
35460,1762,1687,1.0,1724.5,75
35461,1618,1603,0.5,1610.5,15
35462,2330,2163,1.0,2246.5,167
35463,2411,2398,0.0,2404.5,13
35464,2250,2575,0.0,2412.5,-325
35465,2544,2420,1.0,2482.0,124
35466,2312,2592,1.0,2452.0,-280
35467,2361,2421,0.0,2391.0,-60
35468,2449,2430,1.0,2439.5,19
35469,2334,2372,0.5,2353.0,-38
35470,2316,2382,0.0,2349.0,-66
35471,2318,2294,1.0,2306.0,24
35472,2211,2259,0.5,2235.0,-48
35473,2495,2190,0.0,2342.5,305
35474,2765,2816,0.5,2790.5,-51
35475,2853,2814,0.5,2833.5,39
35476,2771,2731,0.5,2751.0,40
35477,2793,2808,0.5,2800.5,-15
35478,2779,2816,0.5,2797.5,-37
35479,2816,2765,0.5,2790.5,51
35480,2816,2853,0.5,2834.5,-37
35481,2731,2793,0.5,2762.0,-62
35482,2814,2771,1.0,2792.5,43
35483,2808,2779,0.5,2793.5,29
35484,1812,2504,0.0,2158.0,-692
35485,2844,2701,0.5,2772.5,143
35486,2732,2748,0.5,2740.0,-16
35487,2722,2767,0.5,2744.5,-45
35488,2797,2751,1.0,2774.0,46
35489,2726,2764,0.5,2745.0,-38
35490,2764,2706,0.5,2735.0,58
35491,1880,1867,1.0,1873.5,13
35492,2813,2304,1.0,2558.5,509
35493,2340,2796,0.0,2568.0,-456
35494,2341,2785,0.0,2563.0,-444
35495,2772,2371,1.0,2571.5,401
35496,2434,2772,0.0,2603.0,-338
35497,2764,2470,1.0,2617.0,294
35498,2484,2741,0.5,2612.5,-257
35499,2775,2489,1.0,2632.0,286
35500,2487,2757,0.0,2622.0,-270
35501,2756,2492,1.0,2624.0,264
35502,2500,2747,0.5,2623.5,-247
35503,2746,2500,1.0,2623.0,246
35504,2512,2740,0.5,2626.0,-228
35505,2744,2519,1.0,2631.5,225
35506,2524,2739,1.0,2631.5,-215
35507,2719,2539,1.0,2629.0,180
35508,2556,2737,0.0,2646.5,-181
35509,2731,2534,0.5,2632.5,197
35510,2569,2733,0.5,2651.0,-164
35511,2716,2535,0.5,2625.5,181
35512,2567,2720,0.5,2643.5,-153
35513,2719,2546,1.0,2632.5,173
35514,2551,2723,0.5,2637.0,-172
35515,2715,2561,1.0,2638.0,154
35516,2567,2714,0.0,2640.5,-147
35517,2710,2567,0.5,2638.5,143
35518,2565,2724,0.0,2644.5,-159
35519,2702,2571,1.0,2636.5,131
35520,2574,2709,0.0,2641.5,-135
35521,2707,2584,1.0,2645.5,123
35522,2588,2706,0.5,2647.0,-118
35523,2710,2584,1.0,2647.0,126
35524,2584,2708,0.0,2646.0,-124
35525,2700,2586,0.5,2643.0,114
35526,2578,2706,0.0,2642.0,-128
35527,2702,2607,0.5,2654.5,95
35528,2595,2701,0.5,2648.0,-106
35529,2699,2594,1.0,2646.5,105
35530,2605,2699,0.5,2652.0,-94
35531,2696,2609,0.5,2652.5,87
35532,2609,2696,1.0,2652.5,-87
35533,2696,2607,1.0,2651.5,89
35534,2625,2691,1.0,2658.0,-66
35535,2698,2626,0.5,2662.0,72
35536,2623,2688,1.0,2655.5,-65
35537,2693,2628,0.5,2660.5,65
35538,2644,2680,1.0,2662.0,-36
35539,2693,2632,0.5,2662.5,61
35540,2632,2664,0.5,2648.0,-32
35541,2678,2643,0.0,2660.5,35
35542,2635,2672,0.5,2653.5,-37
35543,2668,2636,0.5,2652.0,32
35544,2624,2669,1.0,2646.5,-45
35545,2667,2660,1.0,2663.5,7
35546,2623,2676,0.5,2649.5,-53
35547,2655,2645,0.5,2650.0,10
35548,2630,2651,0.5,2640.5,-21
35549,2660,2652,0.0,2656.0,8
35550,2634,2660,0.5,2647.0,-26
35551,2659,2654,0.5,2656.5,5
35552,2651,2653,0.5,2652.0,-2
35553,2662,2651,0.5,2656.5,11
35554,2646,2648,0.0,2647.0,-2
35555,2304,2813,0.0,2558.5,-509
35556,2796,2340,0.5,2568.0,456
35557,2785,2784,1.0,2784.5,1
35558,2371,2341,0.5,2356.0,30
35559,2772,2772,1.0,2772.0,0
35560,2470,2434,0.5,2452.0,36
35561,2741,2764,0.5,2752.5,-23
35562,2489,2484,0.5,2486.5,5
35563,2757,2775,1.0,2766.0,-18
35564,2492,2487,0.5,2489.5,5
35565,2747,2756,1.0,2751.5,-9
35566,2500,2500,1.0,2500.0,0
35567,2740,2746,0.5,2743.0,-6
35568,2519,2512,0.5,2515.5,7
35569,2739,2744,1.0,2741.5,-5
35570,2539,2524,0.0,2531.5,15
35571,2737,2719,0.5,2728.0,18
35572,2534,2556,0.0,2545.0,-22
35573,2733,2731,0.5,2732.0,2
35574,2535,2569,0.5,2552.0,-34
35575,2720,2716,0.5,2718.0,4
35576,2546,2567,0.0,2556.5,-21
35577,2723,2719,0.0,2721.0,4
35578,2561,2551,0.5,2556.0,10
35579,2714,2715,1.0,2714.5,-1
35580,2567,2567,0.5,2567.0,0
35581,2724,2710,1.0,2717.0,14
35582,2571,2565,0.0,2568.0,6
35583,2709,2702,0.5,2705.5,7
35584,2584,2574,0.5,2579.0,10
35585,2706,2707,0.5,2706.5,-1
35586,2584,2588,0.5,2586.0,-4
35587,2708,2710,0.5,2709.0,-2
35588,2586,2584,0.5,2585.0,2
35589,2706,2700,1.0,2703.0,6
35590,2607,2578,0.0,2592.5,29
35591,2701,2702,0.5,2701.5,-1
35592,2594,2595,0.0,2594.5,-1
35593,2699,2699,0.5,2699.0,0
35594,2609,2605,0.5,2607.0,4
35595,2696,2696,0.5,2696.0,0
35596,2607,2609,1.0,2608.0,-2
35597,2691,2696,0.5,2693.5,-5
35598,2626,2625,0.5,2625.5,1
35599,2688,2698,0.0,2693.0,-10
35600,2628,2623,0.5,2625.5,5
35601,2680,2693,1.0,2686.5,-13
35602,2632,2644,0.5,2638.0,-12
35603,2664,2693,0.5,2678.5,-29
35604,2643,2632,0.0,2637.5,11
35605,2672,2678,0.5,2675.0,-6
35606,2636,2635,0.5,2635.5,1
35607,2669,2668,0.0,2668.5,1
35608,2660,2624,0.5,2642.0,36
35609,2676,2667,1.0,2671.5,9
35610,2645,2623,0.5,2634.0,22
35611,2651,2655,0.0,2653.0,-4
35612,2652,2630,0.0,2641.0,22
35613,2660,2660,0.5,2660.0,0
35614,2654,2634,0.5,2644.0,20
35615,2653,2659,0.5,2656.0,-6
35616,2651,2651,0.5,2651.0,0
35617,2648,2662,0.5,2655.0,-14
35618,2580,2333,0.5,2456.5,247
35619,2802,2804,0.5,2803.0,-2
35620,2792,2771,0.5,2781.5,21
35621,2804,2802,0.5,2803.0,2
35622,2771,2792,0.5,2781.5,-21
35623,2804,2802,1.0,2803.0,2
35624,2792,2771,0.5,2781.5,21
35625,2802,2804,1.0,2803.0,-2
35626,2771,2792,0.5,2781.5,-21
35627,2802,2804,0.5,2803.0,-2
35628,2792,2771,0.0,2781.5,21
35629,2804,2802,0.5,2803.0,2
35630,2771,2792,0.5,2781.5,-21
35631,2802,2804,0.5,2803.0,-2
35632,2804,2802,0.5,2803.0,2
35633,2802,2804,1.0,2803.0,-2
35634,2802,2771,0.5,2786.5,31
35635,2771,2802,0.5,2786.5,-31
35636,2802,2771,0.5,2786.5,31
35637,1156,2119,0.0,1637.5,-963
35638,2075,2535,0.0,2305.0,-460
35639,2456,2073,0.5,2264.5,383
35640,2044,2325,0.5,2184.5,-281
35641,2305,2044,0.0,2174.5,261
35642,2025,2259,0.5,2142.0,-234
35643,2231,2020,0.5,2125.5,211
35644,2015,2229,0.0,2122.0,-214
35645,2216,2003,1.0,2109.5,213
35646,2002,2190,0.0,2096.0,-188
35647,2179,1981,1.0,2080.0,198
35648,1980,2164,0.0,2072.0,-184
35649,2161,1980,0.5,2070.5,181
35650,2535,2143,1.0,2339.0,392
35651,2229,2134,0.5,2181.5,95
35652,2097,2216,0.5,2156.5,-119
35653,2190,2100,0.0,2145.0,90
35654,2083,2179,0.5,2131.0,-96
35655,2164,2090,0.5,2127.0,74
35656,2078,2161,0.5,2119.5,-83
35657,2044,2456,0.0,2250.0,-412
35658,2325,2025,1.0,2175.0,300
35659,2259,1948,1.0,2103.5,311
35660,2073,2231,0.5,2152.0,-158
35661,2126,2044,1.0,2085.0,82
35662,2100,2535,0.0,2317.5,-435
35663,2456,2126,1.0,2291.0,330
35664,2161,2325,0.0,2243.0,-164
35665,2134,2259,0.5,2196.5,-125
35666,2090,2229,0.5,2159.5,-139
35667,2216,2083,0.5,2149.5,133
35668,2179,2097,0.5,2138.0,82
35669,1873,2164,0.0,2018.5,-291
35670,2231,2078,1.0,2154.5,153
35671,1980,2190,0.5,2085.0,-210
35672,2143,1974,0.0,2058.5,169
35673,2080,1978,0.5,2029.0,102
35674,2535,2325,1.0,2430.0,210
35675,2164,2456,0.0,2310.0,-292
35676,2259,2100,1.0,2179.5,159
35677,2097,2231,0.5,2164.0,-134
35678,2229,1929,1.0,2079.0,300
35679,2090,2216,0.0,2153.0,-126
35680,1974,2179,0.5,2076.5,-205
35681,2083,2134,0.5,2108.5,-51
35682,2190,2025,1.0,2107.5,165
35683,2020,2161,1.0,2090.5,-141
35684,2126,2002,1.0,2064.0,124
35685,2080,1980,1.0,2030.0,100
35686,2456,2535,0.5,2495.5,-79
35687,2216,2259,1.0,2237.5,-43
35688,2190,2229,1.0,2209.5,-39
35689,2325,2083,1.0,2204.0,242
35690,2231,2080,0.5,2155.5,151
35691,2179,2078,1.0,2128.5,101
35692,2073,2164,0.0,2118.5,-91
35693,2134,2020,1.0,2077.0,114
35694,1974,2126,1.0,2050.0,-152
35695,1873,2097,0.5,1985.0,-224
35696,2100,2044,0.5,2072.0,56
35697,1929,2090,0.5,2009.5,-161
35698,1628,1723,0.5,1675.5,-95
35699,2563,2403,0.5,2483.0,160
35700,2507,2590,0.5,2548.5,-83
35701,2401,2396,1.0,2398.5,5
35702,2428,2346,0.5,2387.0,82
35703,2273,2387,0.5,2330.0,-114
35704,2399,2410,0.0,2404.5,-11
35705,2416,2294,0.0,2355.0,122
35706,2279,2233,1.0,2256.0,46
35707,2291,2288,1.0,2289.5,3
35708,2153,2301,0.5,2227.0,-148
35709,2437,2341,0.5,2389.0,96
35710,2607,2402,1.0,2504.5,205
35711,2446,2497,1.0,2471.5,-51
35712,2374,2462,0.0,2418.0,-88
35713,2514,2422,0.5,2468.0,92
35714,2339,2400,0.5,2369.5,-61
35715,2446,2347,1.0,2396.5,99
35716,2295,2342,0.5,2318.5,-47
35717,2408,2201,1.0,2304.5,207
35718,2147,2408,0.5,2277.5,-261
35719,2027,2199,1.0,2113.0,-172
35720,2674,2297,1.0,2485.5,377
35721,2622,2578,0.5,2600.0,44
35722,2444,2352,1.0,2398.0,92
35723,2447,2347,1.0,2397.0,100
35724,2202,2454,0.5,2328.0,-252
35725,2405,2266,1.0,2335.5,139
35726,2511,2346,0.0,2428.5,165
35727,2480,2467,1.0,2473.5,13
35728,2435,2264,1.0,2349.5,171
35729,2386,2397,0.5,2391.5,-11
35730,2350,2551,0.0,2450.5,-201
35731,2502,2615,0.0,2558.5,-113
35732,2485,2534,0.5,2509.5,-49
35733,2331,2499,0.5,2415.0,-168
35734,2325,2184,0.5,2254.5,141
35735,2359,2417,0.0,2388.0,-58
35736,2338,2283,1.0,2310.5,55
35737,2250,2312,0.0,2281.0,-62
35738,2296,2506,0.5,2401.0,-210
35739,2234,1925,1.0,2079.5,309
35740,2592,2492,1.0,2542.0,100
35741,2459,2552,1.0,2505.5,-93
35742,2538,2325,1.0,2431.5,213
35743,2373,2368,0.0,2370.5,5
35744,2527,2290,1.0,2408.5,237
35745,2404,2362,1.0,2383.0,42
35746,2344,2374,0.5,2359.0,-30
35747,2393,2159,1.0,2276.0,234
35748,2259,2202,0.5,2230.5,57
35749,2179,2213,0.0,2196.0,-34
35750,2406,2428,0.5,2417.0,-22
35751,2234,2536,0.5,2385.0,-302
35752,2517,2182,1.0,2349.5,335
35753,1991,2452,0.0,2221.5,-461
35754,2329,1849,1.0,2089.0,480
35755,2573,2146,1.0,2359.5,427
35756,1805,2526,0.0,2165.5,-721
35757,2479,2134,1.0,2306.5,345
35758,2091,1998,0.5,2044.5,93
35759,2046,2441,0.0,2243.5,-395
35760,2417,2039,1.0,2228.0,378
35761,2037,2408,0.0,2222.5,-371
35762,2328,1755,1.0,2041.5,573
35763,2453,1860,1.0,2156.5,593
35764,2158,2345,0.0,2251.5,-187
35765,2342,1696,1.0,2019.0,646
35766,1556,2160,0.0,1858.0,-604
35767,1836,2412,0.0,2124.0,-576
35768,2362,1864,1.0,2113.0,498
35769,1818,2250,0.0,2034.0,-432
35770,1807,1594,1.0,1700.5,213
35771,2406,2029,1.0,2217.5,377
35772,1975,2254,0.5,2114.5,-279
35773,2359,1693,1.0,2026.0,666
35774,1131,2315,0.0,1723.0,-1184
35775,1506,2174,0.0,1840.0,-668
35776,2331,1704,1.0,2017.5,627
35777,1724,2394,0.5,2059.0,-670
35778,2293,1373,1.0,1833.0,920
35779,2377,1833,0.0,2105.0,544
35780,1694,2258,0.0,1976.0,-564
35781,2239,1626,1.0,1932.5,613
35782,1583,2179,0.0,1881.0,-596
35783,1658,2294,0.0,1976.0,-636
35784,2268,1704,1.0,1986.0,564
35785,1686,2227,0.0,1956.5,-541
35786,1615,1510,1.0,1562.5,105
35787,2330,1541,1.0,1935.5,789
35788,1573,2388,0.0,1980.5,-815
35789,2221,1446,1.0,1833.5,775
35790,1517,2145,0.0,1831.0,-628
35791,2245,2325,1.0,2285.0,-80
35792,1468,1606,0.0,1537.0,-138
35793,2170,2215,1.0,2192.5,-45
35794,2303,1566,1.0,1934.5,737
35795,1513,1039,0.0,1276.0,474
35796,2134,2335,1.0,2234.5,-201
35797,1644,1633,0.0,1638.5,11
35798,1552,1842,0.0,1697.0,-290
35799,2232,2350,1.0,2291.0,-118
35800,1960,2201,1.0,2080.5,-241
35801,2242,1407,1.0,1824.5,835
35802,2070,2247,1.0,2158.5,-177
35803,2309,2365,0.0,2337.0,-56
35804,2724,2723,0.5,2723.5,1
35805,2740,2671,1.0,2705.5,69
35806,2733,2731,1.0,2732.0,2
35807,2723,2733,0.5,2728.0,-10
35808,2671,2724,0.0,2697.5,-53
35809,2731,2740,1.0,2735.5,-9
35810,2724,2731,0.0,2727.5,-7
35811,2740,2733,0.5,2736.5,7
35812,2671,2723,0.0,2697.0,-52
35813,2731,2671,1.0,2701.0,60
35814,2733,2724,0.5,2728.5,9
35815,2723,2740,0.0,2731.5,-17
35816,2627,2639,0.0,2633.0,-12
35817,2649,2569,0.5,2609.0,80
35818,2586,2622,0.5,2604.0,-36
35819,2567,2619,0.5,2593.0,-52
35820,2562,2610,0.5,2586.0,-48
35821,2710,2628,0.5,2669.0,82
35822,2631,2483,1.0,2557.0,148
35823,2498,2582,0.5,2540.0,-84
35824,2547,2385,1.0,2466.0,162
35825,2405,2662,0.5,2533.5,-257
35826,2607,2436,1.0,2521.5,171
35827,2475,2567,0.5,2521.0,-92
35828,2557,2467,1.0,2512.0,90
35829,2544,2416,0.5,2480.0,128
35830,2531,2405,0.0,2468.0,126
35831,2397,2520,0.0,2458.5,-123
35832,2513,2361,1.0,2437.0,152
35833,2511,2136,1.0,2323.5,375
35834,2448,2228,1.0,2338.0,220
35835,2421,1974,0.0,2197.5,447
35836,2639,2649,0.5,2644.0,-10
35837,2619,2631,1.0,2625.0,-12
35838,2569,2627,0.0,2598.0,-58
35839,2622,2567,1.0,2594.5,55
35840,2610,2586,0.5,2598.0,24
35841,2710,2562,0.5,2636.0,148
35842,2628,2513,1.0,2570.5,115
35843,2520,2607,0.5,2563.5,-87
35844,2582,2511,0.5,2546.5,71
35845,2498,2557,1.0,2527.5,-59
35846,2405,2547,1.0,2476.0,-142
35847,2662,2448,1.0,2555.0,214
35848,2567,1974,1.0,2270.5,593
35849,2385,2544,0.0,2464.5,-159
35850,2483,2405,0.0,2444.0,78
35851,2416,2475,0.5,2445.5,-59
35852,2311,2531,0.0,2421.0,-220
35853,2467,2317,0.0,2392.0,150
35854,2436,2292,0.5,2364.0,144
35855,2192,2397,0.0,2294.5,-205
35856,2622,2639,0.5,2630.5,-17
35857,2627,2619,0.0,2623.0,8
35858,2649,2405,0.5,2527.0,244
35859,2586,2628,0.5,2607.0,-42
35860,2562,2498,1.0,2530.0,64
35861,2607,2610,0.5,2608.5,-3
35862,2405,2710,0.0,2557.5,-305
35863,2544,2662,0.5,2603.0,-118
35864,2631,2567,1.0,2599.0,64
35865,2567,2582,1.0,2574.5,-15
35866,2511,2569,0.0,2540.0,-58
35867,2557,2520,1.0,2538.5,37
35868,2547,2416,1.0,2481.5,131
35869,2397,2531,0.0,2464.0,-134
35870,2513,2320,0.5,2416.5,193
35871,2475,2361,1.0,2418.0,114
35872,2448,2317,1.0,2382.5,131
35873,2323,2483,0.0,2403.0,-160
35874,2208,2436,0.5,2322.0,-228
35875,2421,2326,0.5,2373.5,95
35876,2619,2622,0.5,2620.5,-3
35877,2639,2562,0.5,2600.5,77
35878,2610,2710,0.5,2660.0,-100
35879,2567,2649,0.5,2608.0,-82
35880,2628,2631,0.0,2629.5,-3
35881,2405,2627,0.0,2516.0,-222
35882,2569,2586,1.0,2577.5,-17
35883,2662,2498,1.0,2580.0,164
35884,2607,2544,0.0,2575.5,63
35885,2531,2557,1.0,2544.0,-26
35886,2475,2547,1.0,2511.0,-72
35887,2320,2582,0.5,2451.0,-262
35888,2567,2367,1.0,2467.0,200
35889,2520,2448,0.5,2484.0,72
35890,2483,2513,0.0,2498.0,-30
35891,2385,2511,1.0,2448.0,-126
35892,2467,2405,0.5,2436.0,62
35893,2317,2436,0.0,2376.5,-119
35894,2313,2421,0.5,2367.0,-108
35895,2416,2292,1.0,2354.0,124
35896,2619,2639,0.5,2629.0,-20
35897,2631,2569,0.5,2600.0,62
35898,2627,2622,1.0,2624.5,5
35899,2562,2662,0.0,2612.0,-100
35900,2710,2531,0.5,2620.5,179
35901,2649,2475,1.0,2562.0,174
35902,2544,2610,0.5,2577.0,-66
35903,2586,2567,0.5,2576.5,19
35904,2405,2628,0.0,2516.5,-223
35905,2513,2567,0.5,2540.0,-54
35906,2582,2385,1.0,2483.5,197
35907,2448,2607,1.0,2527.5,-159
35908,2557,2416,0.5,2486.5,141
35909,2547,2320,1.0,2433.5,227
35910,2405,2520,0.5,2462.5,-115
35911,2498,2361,0.0,2429.5,137
35912,2436,2483,0.5,2459.5,-47
35913,2511,2340,1.0,2425.5,171
35914,1974,2467,0.0,2220.5,-493
35915,2421,2079,1.0,2250.0,342
35916,2626,2227,0.0,2426.5,399
35917,2767,2842,0.5,2804.5,-75
35918,2801,2822,0.5,2811.5,-21
35919,2779,2780,0.5,2779.5,-1
35920,2777,2766,0.0,2771.5,11
35921,2773,2768,0.5,2770.5,5
35922,2768,2842,0.5,2805.0,-74
35923,2801,2767,0.5,2784.0,34
35924,2822,2777,1.0,2799.5,45
35925,2766,2779,0.5,2772.5,-13
35926,2780,2773,0.5,2776.5,7
35927,2842,2780,0.5,2811.0,62
35928,2779,2822,0.5,2800.5,-43
35929,2777,2801,0.5,2789.0,-24
35930,2767,2768,0.5,2767.5,-1
35931,2773,2766,0.5,2769.5,7
35932,2766,2842,0.5,2804.0,-76
35933,2801,2779,0.5,2790.0,22
35934,2822,2773,1.0,2797.5,49
35935,2777,2767,0.5,2772.0,10
35936,2780,2768,0.5,2774.0,12
35937,2842,2822,0.5,2832.0,20
35938,2767,2780,0.5,2773.5,-13
35939,2768,2766,0.5,2767.0,2
35940,2773,2801,0.5,2787.0,-28
35941,2779,2777,0.5,2778.0,2
35942,2822,2768,0.5,2795.0,54
35943,2801,2842,0.5,2821.5,-41
35944,2779,2767,0.5,2773.0,12
35945,2766,2780,0.5,2773.0,-14
35946,2777,2773,0.5,2775.0,4
